[
  {
    "type": "mapgen",
    "om_terrain": [ [ "microlab_generic_isolated_downstairs" ] ],
    "method": "json",
    "object": {
      "fill_ter": "t_strconc_floor",
      "rows": [
        "#####|            |#####",
        "#####|====    ====|#####",
        "#####|XXX=    =XXX|#####",
        "#####|XXX=|22|=XXX|#####",
        "#####|====    ====|#####",
        "##||||  YY    YY  ||||##",
        "##|XX=    PPPP    =XX|##",
        "##|XX=    PPPP    =XX|##",
        "##|XX=    PPPP    =XX|##",
        "##||||^ YYPPPPYY ^||||##",
        "###|>2            2>|###",
        "###|||||22||||22|||||###",
        "#####|--22-``-22--|#####",
        "#####|-eee-``-eee-|#####",
        "#####|-eee-``-eee-|#####",
        "#####|-----``-----|#####",
        "#####||||||||||||||#####",
        "########################",
        "########################",
        "########################",
        "########################",
        "########################",
        "########################",
        "########################"
      ],
      "palettes": [ "microlab" ],
      "terrain": {
        "X": "t_region_shrub_decorative",
        "P": "t_carpet_red"
        }
        }
        
  },
  {
    "type": "mapgen",
    "om_terrain": [ [ "microlab_generic_isolated_stairs_odd" ] ],
    "method": "json",
    "object": {
      "fill_ter": "t_strconc_floor",
      "rows": [
        "########################",
        "########################",
        "########################",
        "########################",
        "########################",
        "########################",
        "########################",
        "########################",
        "###|||############|||###",
        "###|>||||||||||||||>|###",
        "###|<=            =<|###",
        "###||||=||||||||=||||###",
        "#####|````````````|#####",
        "#####|````````````|#####",
        "#####|````````````|#####",
        "#####|````````````|#####",
        "#####||||||||||||||#####",
        "########################",
        "########################",
        "########################",
        "########################",
        "########################",
        "########################",
        "########################"
      ],
      "palettes": [ "microlab" ],
      "terrain": {
        "X": "t_region_shrub_decorative",
        "P": "t_carpet_red"
        }
        }
        
  },
  {
    "type": "mapgen",
    "om_terrain": [ [ "microlab_generic_isolated_stairs_even" ] ],
    "method": "json",
    "object": {
      "fill_ter": "t_strconc_floor",
      "rows": [
        "########################",
        "########################",
        "########################",
        "########################",
        "########################",
        "########################",
        "########################",
        "########################",
        "###|||############|||###",
        "###|>||||||||||||||>|###",
        "###|<=            =<|###",
        "###||||=||||||||=||||###",
        "#####|````````````|#####",
        "#####|````````````|#####",
        "#####|````````````|#####",
        "#####|````````````|#####",
        "#####||||||||||||||#####",
        "########################",
        "########################",
        "########################",
        "########################",
        "########################",
        "########################",
        "########################"
      ],
      "palettes": [ "microlab" ],
      "terrain": {
        "X": "t_region_shrub_decorative",
        "P": "t_carpet_red"
        }
        }
        
  },
  {
    "type": "mapgen",
    "om_terrain": [ [ "microlab_generic_isolated_upstairs" ] ],
    "method": "json",
    "object": {
      "fill_ter": "t_strconc_floor",
      "rows": [
        "#####|            |#####",
        "#####|====    ====|#####",
        "#####|XXX=    =XXX|#####",
        "#####|XXX=|22|=XXX|#####",
        "#####|====    ====|#####",
        "##||||  YY    YY  ||||##",
        "##|XX=    PPPP    =XX|##",
        "##|XX=    PPPP    =XX|##",
        "##||||    PPPP    ||||##",
        "###|<2  YYPPPPYY  2<|###",
        "###|||^          ^|||###",
        "#####|||22||||22|||#####",
        "#####|`   >``>   `|#####",
        "#####|````````````|#####",
        "#####|````````````|#####",
        "#####|````````````|#####",
        "#####||||||||||||||#####",
        "########################",
        "########################",
        "########################",
        "########################",
        "########################",
        "########################",
        "########################"
      ],
      "palettes": [ "microlab" ],
      "terrain": {
        "X": "t_region_shrub_decorative",
        "P": "t_carpet_red"
        }
  },
  {
    "type": "mapgen",
    "om_terrain": [ [ "microlab_generic_isolated_elevator_pit" ] ],
    "method": "json",
    "object": {
      "fill_ter": "t_strconc_floor",
      "rows": [
        "########################",
        "########################",
        "########################",
        "########################",
        "########################",
        "########################",
        "########################",
        "########################",
        "########################",
        "########################",
        "########################",
        "#####|||#||||||#|||#####",
        "#####| |||<  <||| |#####",
        "#####|            |#####",
        "#####|            |#####",
        "#####|            |#####",
        "#####||||||||||||||#####",
        "########################",
        "########################",
        "########################",
        "########################",
        "########################",
        "########################",
        "########################"
      ],
      "palettes": [ "microlab" ],
      "terrain": {
        "X": "t_region_shrub_decorative",
        "P": "t_carpet_red"
        }
  },
]