[
  {
    "type": "mapgen",
    "om_terrain": "iso_first_elevator",
    "method": "json",
    "object": {
      "fill_ter": "t_strconc_floor",
      "place_nested": [ { "chunks": [ "iso_elevator" ], "x": 0, "y": 0 } ],
      "place_zones": [ { "type": "ZONE_START_POINT", "faction": "your_followers", "x": 9, "y": 14 } ]
    }
  },
  {
    "type": "mapgen",
    "om_terrain": "iso_elevator",
    "method": "json",
    "object": { "fill_ter": "t_strconc_floor", "place_nested": [ { "chunks": [ "iso_elevator" ], "x": 0, "y": 0 } ] }
  },
  {
    "type": "mapgen",
    "om_terrain": "iso_elevator_safe",
    "method": "json",
    "object": { "fill_ter": "t_strconc_floor", "place_nested": [ { "chunks": [ "iso_elevator" ], "x": 0, "y": 0 } ] }
  },
  {
    "type": "mapgen",
    "om_terrain": "iso_next_level_elevator",
    "method": "json",
    "object": { "fill_ter": "t_strconc_floor", "place_nested": [ { "chunks": [ "iso_elevator_next" ], "x": 0, "y": 0 } ] }
  },
  {
    "type": "mapgen",
    "method": "json",
    "nested_mapgen_id": "iso_elevator",
    "object": {
      "mapgensize": [ 24, 24 ],
      "rows": [
        "#####|            |#####",
        "#####|====    ====|#####",
        "#####|XXX=    =XXX|#####",
        "#####||||||22||||||#####",
        "#####|XXX|    |XXX|#####",
        "##||||===|    |===||||##",
        "##|XX=  YYPPPPYY  =XX|##",
        "##|XX=    PPPP    =XX|##",
        "##|XX=    PPPP    =XX|##",
        "##||||^ YYPPPPYY ^||||##",
        "####|N            N|####",
        "####||||  ||||  ||||####",
        "#####|--22-##-22--|#####",
        "#####|-Eee-##-eeE-|#####",
        "#####|-eee-##-eee-|#####",
        "#####|-----##-----|#####",
        "#####||||||||||||||#####",
        "########################",
        "########################",
        "########################",
        "########################",
        "########################",
        "########################",
        "########################"
      ],
      "palettes": [ "microlab_generic" ],
      "terrain": { "`": "t_open_air", "E": "t_elevator_control_off" }
    }
  },
  {
    "type": "mapgen",
    "method": "json",
    "nested_mapgen_id": "iso_elevator_next",
    "object": {
      "mapgensize": [ 24, 24 ],
      "rows": [
        "#####|            |#####",
        "#####|====    ====|#####",
        "#####|XXX=    =XXX|#####",
        "#####||||||22||||||#####",
        "#####|XXX|    |XXX|#####",
        "##||||===|    |===||||##",
        "##|XX=  YYPPPPYY  =XX|##",
        "##|XX=    PPPP    =XX|##",
        "##|XX=    PPPP    =XX|##",
        "##||||^ YYPPPPYY ^||||##",
        "####|N            N|####",
        "####||||  ||||  ||||####",
        "#####|--22-##-22--|#####",
        "#####|-Eee-##-eeE-|#####",
        "#####|-eee-##-eee-|#####",
        "#####|-----##-----|#####",
        "#####||||||||||||||#####",
        "########################",
        "########################",
        "########################",
        "########################",
        "########################",
        "########################",
        "########################"
      ],
      "palettes": [ "microlab_generic" ],
      "terrain": { "`": "t_open_air", "E": "t_elevator_control_iso" }
    }
  },
  {
    "type": "mapgen",
    "method": "json",
    "om_terrain": "iso_elevator_microlab_embed",
    "object": {
      "fill_ter": "t_strconc_floor",
      "rows": [
        "|||||||||||  |||||||||||",
        "|####|XXX=    =XXX|####|",
        "|####|XXX=    =XXX|####|",
        "|####|XXX=    =XXX|####|",
        "|####|XXX=    =XXX|####|",
        "|#||||====    ====||||#|",
        "|#|XX=  YYPPPPYY  =XX|#|",
        "|#|XX=    PPPP    =XX|#|",
        "|#|XX=    PPPP    =XX|#|",
        "|#||||^ YYPPPPYY ^||||#|",
        "||||||            ||||||",
        "        YYPPPPYY        ",
        "        YYPPPPYY        ",
        "||||||||  ||||  ||||||||",
        "|####|--22-##-22--|####|",
        "|####|-Eee-##-eeE-|####|",
        "|####|-eee-##-eee-|####|",
        "|####|--22-##-22--|####|",
        "|#||||||  ||||  ||||||#|",
        "|#|XXX=    YY    =XXX|#|",
        "|#|XXX=YPPPPPPPPY=XXX|#|",
        "|#|XXX=YPPPPPPPPY=XXX|#|",
        "|#|XXX=    YY    =XXX|#|",
        "|||||||||||  |||||||||||"
      ],
      "palettes": [ "microlab" ],
      "terrain": { "`": "t_open_air", "E": "t_elevator_control_off" }
    }
  },
  {
    "type": "mapgen",
    "method": "json",
    "om_terrain": "iso_elevator_microlab_embed_next",
    "object": {
      "fill_ter": "t_strconc_floor",
      "rows": [
        "|||||||||||  |||||||||||",
        "|####|XXX=    =XXX|####|",
        "|####|XXX=    =XXX|####|",
        "|####|XXX=    =XXX|####|",
        "|####|XXX=    =XXX|####|",
        "|#||||====    ====||||#|",
        "|#|XX=  YYPPPPYY  =XX|#|",
        "|#|XX=    PPPP    =XX|#|",
        "|#|XX=    PPPP    =XX|#|",
        "|#||||^ YYPPPPYY ^||||#|",
        "||||||            ||||||",
        "        YYPPPPYY        ",
        "        YYPPPPYY        ",
        "||||||||  ||||  ||||||||",
        "|####|--22-##-22--|####|",
        "|####|-Eee-##-eeE-|####|",
        "|####|-eee-##-eee-|####|",
        "|####|--22-##-22--|####|",
        "|#||||||  ||||  ||||||#|",
        "|#|XXX=    YY    =XXX|#|",
        "|#|XXX=YPPPPPPPPY=XXX|#|",
        "|#|XXX=YPPPPPPPPY=XXX|#|",
        "|#|XXX=    YY    =XXX|#|",
        "|||||||||||  |||||||||||"
      ],
      "palettes": [ "microlab" ],
      "terrain": { "`": "t_open_air", "E": "t_elevator_control_iso" }
    }
  },
  {
    "type": "mapgen",
    "om_terrain": [ [ "iso_elevator_office" ] ],
    "method": "json",
    "object": {
      "fill_ter": "t_strconc_floor",
      "rows": [
        "((((((((((((((((((((((((",
        "(    =  =    |      dh (",
        "( :  [  =    +         (",
        "( : :=  =    |ddd   ddd(",
        "( : :=rr=BB  | h     h (",
        "(|||||rr|||++||||||||||(",
        "(  h =rr        rr| h  (",
        "(htt [rr h   tt rr|ddd (",
        "( tth=rrdd   tt rr|h h (",
        "(^h ^=rr h      rr+    (",
        "(|||||rrdd dd ddrr|||||(",
        "(hd^ =rr h  h  hrr|rhr|(",
        "(    =rrdd dd ddrr|rtr|(",
        "(hd  =rr        rr|rhr|(",
        "( d  =rr^^nFcc^^rr|rrr|(",
        "(|||+|rr||||||||rr|+==|(",
        "( t   rr        rr     (",
        "(                      (",
        "(|||||  |||  ||||  ||||(",
        "( d  =  |--22-##-22--|||",
        "(hdh =  |-Eee-##-eeE-|||",
        "( d  +  |-eee-##-eee-|||",
        "(   &= ^|-----##-----|||",
        "(((((((((((((((((((((((("
      ],
      "terrain": { "`": "t_open_air", "E": "t_elevator_control_off" },
      "place_nested": [
        {
          "chunks": [ "office_up_ew" ],
          "x": 0,
          "y": 0,
          "neighbors": { "north": [ "iso_office", "iso_elevator_office_next", "iso_elevator_office" ] }
        },
        {
          "chunks": [ "office_left_ns" ],
          "x": 0,
          "y": 0,
          "neighbors": { "west": [ "iso_office", "iso_elevator_office_next", "iso_elevator_office" ] }
        },
        {
          "chunks": [ "office_bottom_ew" ],
          "x": 0,
          "y": 0,
          "neighbors": { "south": [ "iso_office", "iso_elevator_office_next", "iso_elevator_office" ] }
        },
        {
          "chunks": [ "office_right_ns" ],
          "x": 0,
          "y": 0,
          "neighbors": { "east": [ "iso_office", "iso_elevator_office_next", "iso_elevator_office" ] }
        }
      ],
      "palettes": [ "iso_office" ]
    }
  },
  {
    "type": "mapgen",
    "om_terrain": [ [ "iso_elevator_office_next" ] ],
    "method": "json",
    "object": {
      "fill_ter": "t_strconc_floor",
      "rows": [
        "((((((((((((((((((((((((",
        "(    =  =    |      dh (",
        "( :  [  =    +         (",
        "( : :=  =    |ddd   ddd(",
        "( : :=rr=BB  | h     h (",
        "(|||||rr|||++||||||||||(",
        "(  h =rr        rr| h  (",
        "(htt [rr h   tt rr|ddd (",
        "( tth=rrdd   tt rr|h h (",
        "(^h ^=rr h      rr+    (",
        "(|||||rrdd dd ddrr|||||(",
        "(hd^ =rr h  h  hrr|rhr|(",
        "(    =rrdd dd ddrr|rtr|(",
        "(hd  =rr        rr|rhr|(",
        "( d  =rr^^nFcc^^rr|rrr|(",
        "(|||+|rr||||||||rr|+==|(",
        "( t   rr        rr     (",
        "(                      (",
        "(|||||  |||  ||||  |||=(",
        "( d  =  |--22-##-22--|||",
        "(hdh =  |-Eee-##-eeE-|||",
        "( d  +  |-eee-##-eee-|||",
        "(   &= ^|-----##-----|||",
        "(((((((((((((((((((((((("
      ],
      "terrain": { "`": "t_open_air", "E": "t_elevator_control_iso" },
      "place_nested": [
        {
          "chunks": [ "office_up_ew" ],
          "x": 0,
          "y": 0,
          "neighbors": { "north": [ "iso_office", "iso_elevator_office_next", "iso_elevator_office" ] }
        },
        {
          "chunks": [ "office_left_ns" ],
          "x": 0,
          "y": 0,
          "neighbors": { "west": [ "iso_office", "iso_elevator_office_next", "iso_elevator_office" ] }
        },
        {
          "chunks": [ "office_bottom_ew" ],
          "x": 0,
          "y": 0,
          "neighbors": { "south": [ "iso_office", "iso_elevator_office_next", "iso_elevator_office" ] }
        },
        {
          "chunks": [ "office_right_ns" ],
          "x": 0,
          "y": 0,
          "neighbors": { "east": [ "iso_office", "iso_elevator_office_next", "iso_elevator_office" ] }
        }
      ],
      "palettes": [ "iso_office" ]
    }
  }
]
