[
  {
    "type": "mapgen",
    "om_terrain": "mlb_generic_subhallway",
    "object": {
      "fill_ter": "t_strconc_floor",
      "rows": [
        "##########|  |##########",
        "#######||||YY||||#######",
        "#######|XX=  =XX|#######",
        "#######|XX=  =XX|#######",
        "#######|XX=  =XX|#######",
        "#######|XX=  =XX|#######",
        "#######||||YY||||#######",
        "#######|XX=  =XX|#######",
        "#######|XX=  =XX|#######",
        "#######|XX=  =XX|#######",
        "#######|XX=  =XX|#######",
        "#######||||YY||||#######",
        "#######|XX=  =XX|#######",
        "#######|XX=  =XX|#######",
        "#######|XX=  =XX|#######",
        "#######|XX=  =XX|#######",
        "#######||||YY||||#######",
        "#######|XX=  =XX|#######",
        "#######|XX=  =XX|#######",
        "#######|XX=  =XX|#######",
        "#######|XX=  =XX|#######",
        "#######||||  ||||#######",
        "##########|YY|##########",
        "##########|  |##########"
      ],
      "palettes": [ "microlab" ],
      "place_nested": [ { "chunks": [ { "param": "unique_foe", "fallback": "mnm_more_density" } ], "x": 0, "y": 0 } ]
    }
  },
  {
    "type": "mapgen",
    "om_terrain": "mlb_generic_subhallway",
    "object": {
      "fill_ter": "t_strconc_floor",
      "rows": [
        "##########|  |##########",
        "##########|YY||#########",
        "##########|   |#########",
        "##########|   |#########",
        "##########|   |#########",
        "##########|   |#########",
        "##########|   |#########",
        "####|||||||   |#########",
        "####|i i  |   |#########",
        "####|     |   |#########",
        "####|2|2| |   |#########",
        "####|;|;|  Y  |#########",
        "####|||||  Y  |#########",
        "####|;|;|  Y  |#########",
        "####|2|2| |   |#########",
        "####|     |   |#########",
        "####|i i  |   |#########",
        "####|||||||   |#########",
        "##########|   |#########",
        "##########|   |#########",
        "##########|   |#########",
        "##########|   |#########",
        "##########|YY||#########",
        "##########|  |##########"
      ],
      "palettes": [ "microlab" ],
      "place_nested": [ { "chunks": [ { "param": "unique_foe", "fallback": "mnm_more_density" } ], "x": 0, "y": 0 } ]
    }
  },
  {
    "type": "mapgen",
    "om_terrain": "mlb_generic_subhallway",
    "object": {
      "fill_ter": "t_strconc_floor",
      "rows": [
        "##########|  |##########",
        "##########|YY|##########",
        "##########|  |##########",
        "##########|  |##########",
        "##########|  |##########",
        "##########|  |##########",
        "##########|  |##########",
        "##########|  |##########",
        "##########|  |##########",
        "##########|  |##########",
        "##########|  |##########",
        "##########|YY|##########",
        "##########|YY|##########",
        "##########|  |##########",
        "##########|  |##########",
        "##########|  |##########",
        "##########|  |##########",
        "##########|  |##########",
        "##########|  |##########",
        "##########|  |##########",
        "##########|  |##########",
        "##########|  |##########",
        "##########|YY|##########",
        "##########|  |##########"
      ],
      "palettes": [ "microlab" ],
      "place_nested": [ { "chunks": [ { "param": "unique_foe", "fallback": "mnm_more_density" } ], "x": 0, "y": 0 } ]
    }
  }
]
