[
  {
    "type": "mapgen",
    "method": "json",
    "om_terrain": [
      [ "campus_commons_0_0_1", "campus_commons_1_0_1" ],
      [ "campus_commons_0_1_1", "campus_commons_1_1_1" ],
      [ "campus_commons_0_2_1", "campus_commons_1_2_1" ],
      [ "campus_commons_0_3_1", "campus_commons_1_3_1" ]
    ],
    "weight": 250,
    "object": {
      "fill_ter": "t_open_air",
      "rows": [
        "                                                ",
        "                                                ",
        "                                                ",
        "                                                ",
        "                                                ",
        "                                                ",
        "                                                ",
        "                                                ",
        "                                  ||||||||||    ",
        "                             ||||||,,,,,,,,|    ",
        "                             |,,,,,,,,,,,,,|    ",
        "                       |||||||,,,,,,,,,,,,,|    ",
        "                       |,,,,,,,,,,,,,,,,,,,|    ",
        "                       |,,,,,,,,,,,,,,,,,,,|    ",
        "                       |,,,,,,,,,,,,,,,,,,,|    ",
        "                       |,,,,,,,,,,,,,,,,,,,|    ",
        "                       |,,,,,,,,,,,,,,,,,,,|    ",
        "                       |,,,,,,,,,,,,,,,,,,,|    ",
        "                       |,,,,,,,,,,,,,,,,,,,|    ",
        "                       |,,,,,,,,,,,,,,,,,,,|    ",
        "                       |,,,,,,,,,,,,,,,,,,,|    ",
        "                       |,,,,,,,,,,,,,,,,,,,|    ",
        "                       |,,,,,,,,,,,,,,,,,,,|    ",
        "                       |,,,,,,,,,,,,,,,,,,,|    ",
        "                       |,,,,,,,,,,,,,,,,,,,|    ",
        "                       |,,,,,,,,,,,,,,,,,,,|    ",
        "                       |,,,,,,,,,,,,,,,,,,,|    ",
        "                       |,,,,,,,,,,,,,,,,,,,|    ",
        "                       |,,,,,,,,,,,,,,,,,,,|    ",
        "                       |,,,,,,,,,,,,,,,,,,,|    ",
        "                       |,,,,,,,,,,,,,,,,,,,|    ",
        "                       |,,,,,,,,,,,,,,,,,,,|    ",
        "                       |,,,,,,,,,,,,,,,,,,,|    ",
        "                       |,,,,,,,,,,,,,,,,,,,|    ",
        "                       |,,,,,,,,,,,,,|||||||    ",
        "                       |,,,,,,,,,,,,,|          ",
        "                       |,,,,,,,,,,,,,|          ",
        "                       |,,,,,,,,,,,,,|          ",
        "                       |,,,,,,,,,,,,,|          ",
        "                       |||||||,,,,,,,|          ",
        "                             |,,,,,,,|          ",
        "                             |,,,,,,,|          ",
        "                             |,,,,,,,|          ",
        "                             |,,,,,,,|||||      ",
        "                      ||||||||,,,,,,,,,,,||||   ",
        "                      |,,,,,,,,,,,,,,,,,,,,,|   ",
        "                      |,,,,,,,,,,,,,,,,,,,,,|   ",
        "                      |,,,,,,,,,,,,,,,,,,,,,|   ",
        "                      |,,,,,,,,,,,,,,,,,,,,,|   ",
        "                      |,,,,,,,,,,,,,,,,,,,,,|   ",
        "                      |,,,,,,,,,,,,,,,,,,,,,|   ",
        "                      |||,,,,,,,,,,,,,,,,,|||   ",
        "                        |,,,,,,,,,,,,,,,,,|     ",
        "                        |,,,,,,,,,,,,,,,,,|     ",
        "                      |||,,,,,,,,,,,,,,,,,|||   ",
        "                      |,,,,,,,,,,,,,,,,,,,,,|   ",
        "                      |,,,,,,,,,,,,,,,,,,,,,|   ",
        "                      |,,,,,,,,,,,,,,,,,,,,,|   ",
        "                      |,,,,,,,,,,,,,,,,,,,,,|   ",
        "                      |,,,,,,,,,,,,,,,,,,,,,|   ",
        "                      |||,,,,,,,,,,,,,,,,,|||   ",
        "                        |,,,,,,,,,,,,,,,,,|     ",
        "                        |,,,,,,,,,,,,,,,,,|     ",
        "                      |||,,,,,,,,,,,,,,,,,|||   ",
        "                      |,,,,,,,,,,,,,,,,,,,,,|   ",
        "                      |,,,,,,,,,,,,,,,,,,,,,|   ",
        "                      |,,,,,,,,,,,,,,,,,,,,,|   ",
        "                  |||||,,,,,,,,,,,,,,,,,,,,,|   ",
        "                  |,,,,,,,,,,,,,,,,,,,,,,,,,|   ",
        "                  |,,,,,,,,,,,,,,,,,,,,,,,,,|   ",
        "                  |,,,,,,,,,,,,,,,,,,,,,,,|||   ",
        "                  |,,,,,,,,,,,,,,,,,,,,,,,|     ",
        "                  |,,,,,,,,,,,,,,,,,,,,,,,|     ",
        "                  |,,,,,,,,,,,,,,,,,,,,,,,|||   ",
        "                  |,,,,,,,,,,,,,,,,,,,,,,,,,|   ",
        "                  |,,,,,,,,,,,,,,,,,,,,,,,,,|   ",
        "                  |||||,,,,,,,,,,,,,,,,,,,,,|   ",
        "                      |,,,,,,,,,,,,,,,,,,,,,|   ",
        "                      |,,,,,,,,,,,,,,,,,,,,,|   ",
        "                      |||,,,,,,,,,,,,,,,,,|||   ",
        "                        |,,,,,,,,,,,,,,,,,|     ",
        "                        |,,,,,,,,,,,,,,,,,|     ",
        "                      |||,,,,,,,,,,,,,,,,,|||   ",
        "                      |,,,,,,,,,,,,,,,,,,,,,|   ",
        "                      |,,,,,,,,,,,,,,,,,,,,,|   ",
        "                      |,,,,,,,,,,,,,,,,,,,,,|   ",
        "                      |,,,,,,,,,,,,,,,,,,,,,|   ",
        "                      |,,,,,,,,,,,,,,,,,,,,,|   ",
        "                      |,,,,,,,,,,,,,,,,,,,,,|   ",
        "                      |||,,,,,,,,,,,,,,,,,|||   ",
        "                        |,,,,,,,,,,,,,,,,,|     ",
        "                        ||||||,,,,,,,,,,|||     ",
        "                             |,,,,,,,,,,|       ",
        "                             |,,,,,,|||||       ",
        "                             ||||||||           ",
        "                                                "
      ],
      "terrain": {  },
      "furniture": {  },
      "palettes": [ "campus_common" ]
    }
  }
]
