[
  {
    "type": "mapgen",
    "om_terrain": [ [ "campus_lecture_0_0_2" ], [ "campus_lecture_0_1_2" ], [ "campus_lecture_0_2_2" ], [ "campus_lecture_0_3_2" ] ],
    "method": "json",
    "weight": 250,
    "object": {
      "fill_ter": "t_open_air",
      "rows": [
        "                        ",
        "                        ",
        "                        ",
        "                        ",
        "                        ",
        "                        ",
        "                        ",
        "                        ",
        "                        ",
        "                        ",
        "        ||||||||||      ",
        "      |||,,,,,,,,|      ",
        "      |,,,,,,,,,,|      ",
        "      |,,,,,,,,,,|      ",
        "      |,,,,,,,,,,||||||R",
        "      |,,,,,,,,,,,,,,,|R",
        "      |,,,,,,,,,,,,,,,|R",
        "      |,,,,,,,,,,,,,,,|R",
        "    |||,,,,,,,,,,,,,,,|R",
        "    |,,,,,,,,,,,,,,,,,|R",
        "    |,,,,,,,,,,,,,,,,,| ",
        "    |,,,,,,,,,,,,,,,,,| ",
        "    |,,,,,,,,,,,,,,,,,| ",
        "    |,,,,,,,,,,,,,,,,,| ",
        "    |,,,,,,,,,,,,,,,,,| ",
        " ||||,,,,,,,,,,,,,,,,,||",
        " |,,,,,,,,,,,,,,,,,,,,,|",
        " |,,,,,,,,,,,,,,,,,,,,,|",
        " |,,,,,,,,,,,,,,,,,,,,,|",
        " |,,,,,,,,,,,,,,,,,,,,,|",
        " |,,,,,,,,,,,,,,,|||||||",
        " |,,,,,,,,,,,,,,,|      ",
        " |,,,,,,,,,,,,,,,|      ",
        " |,,,,,,,,,,,,,,,|      ",
        " |,,,,,,,,,,,,,,,|      ",
        " |,,,,,,,,,,,,,,,|      ",
        " |,,,,,,,,,,,,,,,|||||| ",
        " |,,,,,,,,,,,,,,,,,,,,| ",
        " |,,,,,,,,,,,,,,,,,,,,| ",
        " |,,,,,,,,,,,,,,,,,,,,||",
        " |,,,,,,,,,,,,,,,,,,,,,|",
        " |,,,,,,,,,,,,,,,,,,,,,|",
        " |,,,,,,,,,,,,,,,,,,,,,|",
        " |,,,,,,,,,,,,,,,,,,,,,|",
        " |,,,,,,,,,,,,,,,,,,,,,|",
        " |,,,,,,,,,,,,,,,,,,,,,|",
        " |,,,,,,,,,,,,,,,,,,,,,|",
        " |,,,,,,,,,,,,,,,,,,,,,|",
        " |,,,,,,,,,,,,,,,,,,,,,|",
        " |,,,,,,,,,,,,,,,,,,,,,|",
        " |,,,,,,,,,,,,,,,,,,,,,|",
        " |,,,,,,,,,,,,,,,,,,,,,|",
        " |,,,,,,,,,,,,,,,,,,,,,|",
        " |,,,,,,,,,,,,,,,,,,,,,|",
        " |,,,,,,,,,,,,,,,,,,,,,|",
        " |,,,,,,,,,,,,,,,,,,,,,|",
        " |,,,,,,,,,,,,,,,,,,,,,|",
        " |,,,,,,,,,,,,,,,,,,,,,|",
        " |,,,,,,,,,,,,,,,,,,,,,|",
        " |,,,,,,,,,,,,,,,,,,,,,|",
        " |,,,,,,,,,,,,,,,,,,,,,|",
        " |,,,,,,,,,,,,,,,,,,,,,|",
        " |,,,,,,,,,,,,,,,,,,,,||",
        " |,,,,,,,,,,,,,,,,,,,,| ",
        " |,,,,,,,,,,,,,,,,,,,,| ",
        " |||||,,,,,,,,,,,,,,||| ",
        "     |,,,,,,,,,,,,,,|   ",
        "    ||,,,,,,,,,,,,,,|   ",
        "    |,,,,,,,,,,,,,,,|   ",
        "    |,,,,,,,,,,,,,,,|   ",
        "    |,,,,,,,,,,,,,,,|   ",
        "    |||||||,,,,,,,|||   ",
        "          |,,,,,,,|     ",
        "          |,,,,,,,|     ",
        "          |,,,,,,,|     ",
        "          |,,,,,,,|     ",
        "          |||||||||     ",
        "                        ",
        "                        ",
        "                        ",
        "                        ",
        "                        ",
        "                        ",
        "                        ",
        "                        ",
        "                        ",
        "                        ",
        "                        ",
        "                        ",
        "                        ",
        "                        ",
        "                        ",
        "                        ",
        "                        ",
        "                        ",
        "                        "
      ],
      "terrain": {  },
      "furniture": {  },
      "palettes": [ "campus_common" ]
    }
  }
]
