[
  {
    "type": "mapgen",
    "method": "json",
    "om_terrain": [ [ "campus_media_0_0_0", "campus_media_1_0_0" ], [ "campus_media_0_1_0", "campus_media_1_1_0" ] ],
    "weight": 250,
    "object": {
      "fill_ter": "t_open_air",
      "rows": [
        "________________________________________________",
        "________________________________________________",
        "________________________________________________",
        "____|||||||||||||||||||||||_____________________",
        "____|,,,,,,,,,,,,,,,,,,,,,|_____________________",
        "____|,,,,,,,,,,,,,,,,,,,,,|_____________________",
        "____|,,,,,,,,,,,,,,,,,,,,,|_____________________",
        "____|,,,,,,,,,,,,,,,,,,,,,|_____________________",
        "|||||,,,,,,,,,,,,,,,,,,,,,|||||||||__|||||||____",
        ",,,,,,,,,,,,,,,,,,,,,,,,,,,,,,,,,,||||,,,,,|____",
        ",,,,,,,,,,,,,,,,,,,,,,,,,,,,,,,,,,,,,,,,,,,|||__",
        ",,,,,,,,,,,,,,,,,,,,,,,,,,,,,,,,,,,,,,,,,,,,,|__",
        ",,,,,,,,,,,,,,,,,,,,,,,,,,,,,,,,,,,,,,,,,,,,,|||",
        ",,,,,,,,,,,,,,,,,,,,,,,,,,,,,,,,,,,,,,,,,,,,,,,|",
        ",,,,,,,,,,,,,,,,,,,,,,,,,,,,,,,,,,,,,,,,,,,,,,||",
        ",,,,,,,,,,,,,,,,,,,,,,,,,,,,,,,,,,,,,,,,,,,,,,|_",
        ",,,,,,,,,,,,,,,,,,,,,,,,,,,,,,,,,,,,,,,,,,,,,,|_",
        ",,,,,,,,,,,,,,,,,,,,,,,,,,,,,,,,,,,,,,,,,,,,,,|_",
        ",,,,,,,,,,,,,,,,,,,,,,,,,,,,,,,,,,,,,,,,,,,,,||_",
        ",,,,,,,,,,,,,,,,,,,,,,,,,,,,,,,,,,,,,,,,,,,,,|__",
        ",,,,,,,,,,,,,,,,,,,,,,,,,,,,,,,,,,,,,,,,,,,|||__",
        ",,,,,,,,,,,,,,,,,,,,,,,,,,,,,,,,,,||||,,,,,|____",
        ",,,,,,,,,,,,,,,,,,,,,,,,,,,,|||||||__|||||||____",
        "||||||,,,,,,,,,,,,,,,,,,,,,,|_________________bb",
        "_____|,,,,,,,,,,,,,,,,,,,,,||________________bb'",
        "__||||,,,,,,,,,,,,,,,,,,,,,|________________bb''",
        "__|,,,,,,,,,,,,,,,,,,,,,,,,|_______________bb'''",
        "__|,,,,,,,,,,,,,,,,,,,,,,,,|_______________b''''",
        "__|,,,,,,,,,,,,,,,,,,,,,,,,|_______________b''''",
        "__|,,,,,,,,,,,,,,,,,,,,,,,,|_____bbbbbbbbbbb''''",
        "__|,,,,,,,,,,,,,,,,,,,,,,,,|_____b''''''''''''''",
        "__|,,,,,,,,,,,,,,,,,,,,,,,,|_____b''''''''''''''",
        "__|,,,,,,,,,,,,,,,,,,,,,,,,|_____b''''''''''''''",
        "__|,,,,,,,,,,,,,,,,,,,,,,,,|_____b''''''''''''''",
        "__|,,,,,,,,,,,,,,,,,,,,,,,,|_____b''''''''''''''",
        "__|,,,,,,,,,,,,,,,,,,,,,,,,|_____b''''''''''''''",
        "__|,,,,,,,,,,,,,,,,,,,,,,,,|_____b''''''''''''''",
        "__|,,,,,,,,,,,,,,,,,,,,,,,,|_____b''''''''''''''",
        "__|,,,,,,,,,,,,,,,,,,,,,,,,|_____b''''''''''''''",
        "__|,,,,,,,,,,,,,,,,,,,,,,,,|_____b''''''''''''''",
        "__|,,,,,,,,,,,,,,,,,,,,,,,,|_____b''''''''''''''",
        "__|,,,,,,,,,,,,,,,,,,,,,,,,|_____b''''''''''''''",
        "__|,,,,,,,,,,,,,,,,,,,,,,,,|_____b''''''''''''''",
        "__||||||||||||||||||||||||||_____b''''''''''''''",
        "________________________________________________",
        "________________________________________________",
        "________________________________________________",
        "________________________________________________",
        "________________________________________________"
      ],
      "terrain": { " ": "t_open_air" },
      "furniture": {  },
      "palettes": [ "campus_common" ]
    }
  }
]
