[
  {
    "type": "palette",
    "id": "abwarehouse_palette",
    "parameters": {
      "wall_type": {
        "type": "ter_str_id",
        "default": {
          "distribution": [ [ "t_concrete_wall", 5 ], [ "t_brick_wall", 3 ], [ "t_adobe_brick_wall", 1 ], [ "t_strconc_wall", 1 ] ]
        }
      },
      "lawn_type": {
        "type": "ter_str_id",
        "default": {
          "distribution": [
            [ "t_region_soil", 1 ],
            [ "t_region_groundcover_forest", 1 ],
            [ "t_region_groundcover", 1 ],
            [ "t_region_groundcover_urban", 1 ]
          ]
        }
      }
    },
    "terrain": {
      "6": "t_gates_mech_control",
      "<": "t_ladder_up",
      "a": [ [ "t_concrete", 15 ], "t_region_groundcover_barren" ],
      "+": [ "t_door_metal_c", "t_door_metal_locked", "t_door_metal_locked" ],
      "-": "t_door_metal_locked",
      "4": "t_gutter_downspout",
      ".": "t_thconc_floor",
      "d": "t_region_groundcover_barren",
      "^": [ [ "t_thconc_floor", 10 ], "t_region_soil" ],
      " ": { "param": "lawn_type", "fallback": "t_region_groundcover_forest" },
      "|": { "param": "wall_type", "fallback": "t_concrete_wall" }
    },
    "furniture": {
      "d": [ [ "f_null", 3 ], "f_rubble" ],
      "^": [ [ "f_null", 5 ], "f_rubble" ],
      ".": [ [ "f_null", 20 ], "f_rubble" ],
      "{": "f_locker"
    },
    "items": {
      "^": [
        { "item": "SUS_trash_floor", "chance": 25, "repeat": 2 },
        { "item": "road", "chance": 1 },
        { "item": "allclothes_damaged", "chance": 3 },
        { "item": "stoner", "chance": 1 },
        { "item": "wheels", "chance": 1 },
        { "item": "creepy", "chance": 1 },
        { "item": "misc_smoking", "chance": 1 }
      ]
    },
    "nested": { "|": { "chunks": [ [ "shelter_graffiti", 5 ], [ "general_graffiti", 20 ], [ "null", 75 ] ] } }
  },
  {
    "type": "mapgen",
    "method": "json",
    "om_terrain": "abandonedwarehouse",
    "object": {
      "fill_ter": "t_thconc_floor",
      "rotation": [ 1, 1 ],
      "rows": [
        "                        ",
        "                        ",
        "           aaa          ",
        "        dddaaadddddddd  ",
        "        d|||+||||||||d  ",
        "        6|6.........|d  ",
        "aaaaaaaaa-.......^..|d  ",
        "aaaaaaaaa-..........|d  ",
        "aaaaaaaaa-...^....^.|d  ",
        "aaaaaaaaa-..........|d  ",
        "aaaaaaaaa-..........|d  ",
        "aaaaaaaaa-..........|d  ",
        "        d|..........|d  ",
        "aaaaaaaaa-..........|d  ",
        "aaaaaaaaa-......^...|d  ",
        "aaaaaaaaa-..........|d  ",
        "aaaaaaaaa-....^..^.^|d  ",
        "aaaaaaaaa-......^^.#|d  ",
        "aaaaaaaaa-.....^^^^.|d  ",
        "       d6|6...^.^^..|d  ",
        "       dd||||||||||||d  ",
        "        dddddddddd4ddd  ",
        "                        ",
        "                        "
      ],
      "palettes": [ "abwarehouse_palette" ],
      "furniture": { "#": "f_makeshift_bed" }
    }
  },
  {
    "type": "mapgen",
    "method": "json",
    "om_terrain": "abandonedwarehouse_roof",
    "object": {
      "fill_ter": "t_flat_roof",
      "rotation": [ 1, 1 ],
      "rows": [
        "                        ",
        "                        ",
        "                        ",
        "                        ",
        "         ---------5--   ",
        "         ...........-   ",
        "         ...........-   ",
        "         ...........-   ",
        "         ...........-   ",
        "         ...........-   ",
        "         ...........-   ",
        "         ........=..-   ",
        "         ........&..-   ",
        "         ...........-   ",
        "         ...........-   ",
        "         ...........-   ",
        "         ...........-   ",
        "         ...........-   ",
        "         ...........-   ",
        "         ...........-   ",
        "         ---------5--   ",
        "                        ",
        "                        ",
        "                        "
      ],
      "palettes": [ "roof_palette" ],
      "terrain": { ".": "t_flat_roof" },
      "place_items": [ { "item": "SUS_trash_roof", "x": [ 10, 19 ], "y": [ 5, 18 ], "chance": 50, "repeat": [ 1, 3 ] } ],
      "place_nested": [ { "chunks": [ [ "null", 40 ], [ "roof_4x4_utility", 60 ] ], "x": 13, "y": 6 } ]
    }
  },
  {
    "type": "mapgen",
    "method": "json",
    "om_terrain": "abandonedwarehouse_1",
    "object": {
      "fill_ter": "t_thconc_floor",
      "rows": [
        "          aaaaaa        ",
        "          aaaaaa        ",
        "          aaaaaa        ",
        "          aaaaaa        ",
        "          aaaaaa        ",
        "    ddddddaaaaaa6ddddd  ",
        "    d|||||------||+||d  ",
        "    d|...^......6...|d  ",
        "    d|..............|d  ",
        "    d|..............|d  ",
        "    d|.............<|d  ",
        "    d|^.............|d  ",
        "    d|..^...........|d  ",
        "    d|...^.^....||o||d  ",
        "    d|^..^......w#..|d  ",
        "    d|O.O..^....w#..|d  ",
        "    d|.^..^..^..w#..|d  ",
        "    d|O.O.O.X.X.|&.{|d  ",
        "    d||||||||||||||||4  ",
        "    dddddddddddddddddd  ",
        "                        ",
        "                        ",
        "                        ",
        "                        "
      ],
      "palettes": [ "abwarehouse_palette" ],
      "terrain": { "o": "t_door_o", "w": "t_window" },
      "furniture": { "#": "f_desk", "&": "f_trashcan", "O": "f_crate_o", "X": "f_crate_c" },
      "items": {
        "#": { "item": "SUS_trash_floor", "chance": 20 },
        "&": { "item": "SUS_trash_floor", "chance": 55, "repeat": 2 },
        "{": { "item": "SUS_trash_floor", "chance": 20 }
      },
      "place_vehicles": [ { "chance": 60, "fuel": 0, "rotation": 180, "status": -1, "vehicle": "forklift_vehicles", "x": 16, "y": 10 } ]
    }
  },
  {
    "type": "mapgen",
    "method": "json",
    "om_terrain": "abandonedwarehouse_1_roof",
    "object": {
      "fill_ter": "t_flat_roof",
      "rows": [
        "                        ",
        "                        ",
        "                        ",
        "                        ",
        "                        ",
        "                        ",
        "     -..............-   ",
        "     -..............-   ",
        "     -...........:..-   ",
        "     -..............-   ",
        "     -.............v-   ",
        "     -..............-   ",
        "     -..............-   ",
        "     -..............-   ",
        "     -..............-   ",
        "     -..............-   ",
        "     -............N.-   ",
        "     -...........&..-   ",
        "     ---------------5   ",
        "                        ",
        "                        ",
        "                        ",
        "                        ",
        "                        "
      ],
      "palettes": [ "roof_palette" ],
      "place_items": [ { "item": "SUS_trash_roof", "x": [ 6, 19 ], "y": [ 6, 17 ], "chance": 50, "repeat": [ 1, 3 ] } ],
      "place_nested": [
        {
          "chunks": [ [ "null", 30 ], [ "roof_4x4_party", 10 ], [ "roof_4x4_utility", 40 ], [ "roof_5x5_coop", 5 ] ],
          "x": [ 7, 10 ],
          "y": [ 8, 11 ]
        }
      ]
    }
  },
  {
    "type": "mapgen",
    "method": "json",
    "om_terrain": "abandonedwarehouse_2",
    "object": {
      "fill_ter": "t_thconc_floor",
      "rows": [
        "      aaa               ",
        "      aaa               ",
        "      aaa               ",
        "      aaa               ",
        "      aaa               ",
        "      aaa               ",
        "   dddaaadddddddddd     ",
        "   d|||+||||||||||d     ",
        "   d|....^...^..{|d     ",
        "   d|......^....{|d     ",
        "   d|..^..^...^..|d     ",
        "   d|.......^....|d     ",
        "   d|.X.X.X^X.X..|d     ",
        "   d|.........^..|d     ",
        "   d|.X^X.X.X.X..|aa    ",
        "   d|...........^|aa    ",
        "   d|.X.X.X.X.X..Daa    ",
        "   d|....^.......|aa    ",
        "   d|.X.X.X.X.X..|aa    ",
        "   4|........^...|d     ",
        "   d||||||||||||||d     ",
        "   dddddddddddddddd     ",
        "                        ",
        "                        "
      ],
      "palettes": [ "abwarehouse_palette" ],
      "terrain": { "D": "t_door_metal_c" },
      "furniture": { "X": "f_crate_c" },
      "items": {
        "{": [
          { "item": "clothing_work_mask", "chance": 1 },
          { "item": "clothing_work_boots", "chance": 1 },
          { "item": "clothing_work_torso", "chance": 1 },
          { "item": "clothing_work_glasses", "chance": 1 },
          { "item": "clothing_work_gloves", "chance": 1 },
          { "item": "clothing_work_hat", "chance": 1 }
        ],
        "X": [
          { "item": "crate_sports", "chance": 4 },
          { "item": "crate_kitchen", "chance": 4 },
          { "item": "crate_toys", "chance": 4 },
          { "item": "crate_parts", "chance": 4 },
          { "item": "crate_creepy", "chance": 1 },
          { "item": "crate_wine", "chance": 1 }
        ]
      }
    }
  },
  {
    "type": "mapgen",
    "method": "json",
    "om_terrain": "abandonedwarehouse_2_roof",
    "object": {
      "fill_ter": "t_tar_flat_roof",
      "rows": [
        "                        ",
        "                        ",
        "                        ",
        "                        ",
        "                        ",
        "                        ",
        "                        ",
        "    -.............      ",
        "    -.............      ",
        "    -.............      ",
        "    -.............      ",
        "    -.............      ",
        "    -.............      ",
        "    -.............      ",
        "    -.............      ",
        "    -........&....      ",
        "    -.............      ",
        "    -.............      ",
        "    -........:....      ",
        "    -.............      ",
        "    --------------      ",
        "                        ",
        "                        ",
        "                        "
      ],
      "palettes": [ "roof_palette" ],
      "terrain": { ".": "t_tar_flat_roof" },
      "place_items": [ { "item": "SUS_trash_roof", "x": [ 5, 17 ], "y": [ 7, 19 ], "chance": 50, "repeat": [ 1, 3 ] } ],
      "place_nested": [ { "chunks": [ [ "null", 50 ], [ "roof_4x4_utility", 50 ] ], "x": 6, "y": 8 } ]
    }
  },
  {
    "type": "mapgen",
    "method": "json",
    "om_terrain": "abandonedwarehouse_3",
    "object": {
      "fill_ter": "t_thconc_floor",
      "rows": [
        "           aaddddddd    ",
        "           aa|w||w|4    ",
        "           aaw..#.wd    ",
        "           aa+..#c|d    ",
        "  dddddddddaa|^...|d    ",
        "  d||||||||||||D|||d    ",
        "  d|.X^X.X.X......|d    ",
        "  d|.X.X.X.X...^..|d    ",
        "  d|.............{|d    ",
        "  d|............^{|d    ",
        "  d|....-....-....|d    ",
        "  d|.......^......|aa   ",
        "  d|..........^...+aa   ",
        "  d|.......^...^..|aa   ",
        "  d|..OO..........|d    ",
        "  d||||||||||||||||d    ",
        "  ddddddddddddddd<dd    ",
        "                        ",
        "                        ",
        "                        ",
        "                        ",
        "                        ",
        "                        ",
        "                        "
      ],
      "palettes": [ "abwarehouse_palette" ],
      "terrain": { "-": "t_support_l", "D": "t_door_c", "w": "t_window" },
      "furniture": { "#": "f_desk", "O": "f_standing_tank", "X": "f_crate_c", "c": "f_chair", "{": "f_dumpster" },
      "items": { "{": { "item": "SUS_trash_floor", "chance": 35, "repeat": 2 }, "X": { "item": "crate_parts", "chance": 30 } }
    }
  },
  {
    "type": "mapgen",
    "method": "json",
    "om_terrain": "abandonedwarehouse_3_roof",
    "object": {
      "fill_ter": "t_tile_flat_roof",
      "rows": [
        "                        ",
        "             5----5     ",
        "             -....-     ",
        "             -....-     ",
        "             -....-     ",
        "   -----------....-     ",
        "   -.X............-     ",
        "   -..............-     ",
        "   -..............-     ",
        "   -..............-     ",
        "   -..............-     ",
        "   -..............-     ",
        "   -..............-     ",
        "   -.......&......-     ",
        "   -............:.##    ",
        "   -------------####    ",
        "                #v##    ",
        "                        ",
        "                        ",
        "                        ",
        "                        ",
        "                        ",
        "                        ",
        "                        "
      ],
      "palettes": [ "roof_palette" ],
      "terrain": { ".": "t_tile_flat_roof" },
      "place_items": [
        { "item": "SUS_trash_roof", "x": [ 4, 17 ], "y": [ 12, 20 ], "chance": 50, "repeat": [ 1, 3 ] },
        { "item": "SUS_trash_roof", "x": [ 14, 17 ], "y": [ 7, 11 ], "chance": 50, "repeat": [ 1, 3 ] }
      ],
      "place_nested": [
        {
          "chunks": [
            [ "null", 40 ],
            [ "roof_4x4_party", 20 ],
            [ "roof_4x4_holdout", 10 ],
            [ "roof_4x4_utility", 10 ],
            [ "roof_5x5_coop", 15 ]
          ],
          "x": 5,
          "y": 9
        }
      ]
    }
  },
  {
    "type": "mapgen",
    "method": "json",
    "om_terrain": "abandonedwarehouse_4",
    "object": {
      "fill_ter": "t_thconc_floor",
      "rows": [
        "              aaa       ",
        "              aaa       ",
        "              aaa       ",
        "              aaa       ",
        "      ddddddddaaaddddd  ",
        "      d||||||||+|||||d  ",
        "      d|............|d  ",
        "      d|...........^|d  ",
        "    aaa|......^.....|d  ",
        "    aaa|..^.........|d  ",
        "    aaa|.........^.^|d  ",
        "    aaa+......^.....|d  ",
        "    aaa|..{.........|d  ",
        "    aaa|.{..{...{.{.|d  ",
        "    aaa|......{.{.{.|d  ",
        "      d|..{^..{.{.{.|d  ",
        "      d|{..{........|d  ",
        "      d||||||||||||||d  ",
        "      ddddDdDddddd4ddd  ",
        "                        ",
        "                        ",
        "                        ",
        "                        ",
        "                        "
      ],
      "palettes": [ "abwarehouse_palette" ],
      "terrain": { "D": "t_region_groundcover_barren" },
      "furniture": { "D": "f_dumpster", "{": "f_warehouse_shelf" },
      "items": { "D": { "item": "SUS_trash_floor", "chance": 45, "repeat": 2 } },
      "place_items": [
        { "chance": 25, "item": "stash_food", "x": 16, "y": [ 14, 15 ] },
        { "chance": 20, "item": "stash_water", "x": 18, "y": [ 14, 15 ] }
      ]
    }
  },
  {
    "type": "mapgen",
    "method": "json",
    "om_terrain": "abandonedwarehouse_4_roof",
    "object": {
      "fill_ter": "t_tile_flat_roof",
      "rows": [
        "                        ",
        "                        ",
        "                        ",
        "                        ",
        "                        ",
        "       --------------   ",
        "       -X:..........-   ",
        "       -............-   ",
        "       -............-   ",
        "       -............-   ",
        "       -............-   ",
        "       -............-   ",
        "       -............-   ",
        "       -............-   ",
        "       -............-   ",
        "       -.&..........-   ",
        "       -............-   ",
        "       -----------5--   ",
        "                        ",
        "                        ",
        "                        ",
        "                        ",
        "                        ",
        "                        "
      ],
      "palettes": [ "roof_palette" ],
      "terrain": { ".": "t_tile_flat_roof" },
      "place_items": [ { "item": "SUS_trash_roof", "x": [ 8, 19 ], "y": [ 7, 16 ], "chance": 50, "repeat": [ 1, 3 ] } ],
      "place_nested": [ { "chunks": [ [ "null", 50 ], [ "roof_4x4_utility", 50 ] ], "x": 8, "y": [ 10, 12 ] } ]
    }
  }
]
