[
  {
    "type": "mapgen",
    "method": "json",
    "om_terrain": [
      [ "airliner_1a", "airliner_2a", "airliner_3a" ],
      [ "airliner_1b", "airliner_2b", "airliner_3b" ],
      [ "airliner_1c", "airliner_2c", "airliner_3c" ],
      [ "airliner_1d", "airliner_2d", "airliner_3d" ],
      [ "airliner_1e", "airliner_2e", "airliner_3e" ]
    ],
    "weight": 250,
    "object": {
      "fill_ter": "t_dirt",
      "rows": [
        "                                   dd d                                 ",
        "                                  ddddd*                                ",
        "                                dddmmmddd                               ",
        "                               dddmmmmmddd                              ",
        "                              d*dmmmmmmmddd                             ",
        "                              ddmmgggggmmddd *                          ",
        "                             dddmggxxxggmddd                            ",
        "                              ddmgxa.axgmddd                            ",
        "                              ddmMlz.ZlMmddd                            ",
        "                        *     ddMMMM+MMMMddd                            ",
        "                              ddD.......Ddd                             ",
        "                              d*MMMM.MMMMdd *                           ",
        "                             dddM.......Mdd                             ",
        "                             dddsaaa.aaasd*                             ",
        "                             dddM.......Md                              ",
        "                             dddsaaa.aaasdd                             ",
        "                              d*M.......Mdd d      *                    ",
        "                             *d**..a.aaasdd                             ",
        "                             dd**.......Mdd                             ",
        "                            *d***.aa.aaasdd*                            ",
        "                              d*MMMM.MMMMddd                            ",
        "                            *ddmM..+....Mm*dd                           ",
        "                            ddmmsTSM.aaasmm*d                           ",
        "                        dddddmmmMMMM....Mmmmd *                         ",
        "                         dddmmmmsaaa.aaasmmmmd                          ",
        "                      * dddmmmmmM.......Mmmmm*d    *                    ",
        "                       dddmmmmmmsaaa.aaasmmmmddd                        ",
        "                     d ddmmmmmmmM.......Mmmmmm*dd                       ",
        "                      ddmmmmmmmmsaaa.aaasmmmmmdd                        ",
        "                   ddddmmmmmmmmmD.......Dmmmmmd*d   *                   ",
        "                  ddddmmmmmmmmmmMaaa.aaaMmmmm*dd                        ",
        "                   ddmmmmmmmmmmmD.......Dmmmmmdd  *                     ",
        "                d ddmmmmmmmmmmmmsaaa.aaasmmmmd*  **                     ",
        "                 ddmmmmmmmmmmmmmM.......Mmmmm*                          ",
        "                ddmmmmmmmmmmmmmmsaaa.aaasmmmd  d                        ",
        "              dddmmmmmmmmmmmmmmmM.......Mmmd*   d                       ",
        "       *      ddmmmmmmmmmmmmmmddsaaa.aaasdddd*                          ",
        "             ddmmmmmmmmmmmmmddddM.......Mddddd                          ",
        "           dddmmmmmmmmmmmmddd*ddsaaa.aaasdddd   *   d                   ",
        "           ddmmmmmmmmmmmdd*dd ddM........*dd   d                        ",
        "         dddmmmmmmmmmmdddd*d  ddsaaa.aa.dd*dd                           ",
        "        dddmmmmmmmmmdd  *dd  dddM.......*dddd d  *                      ",
        "      *dddmmmmmmmmddd   d*dd  ddsaaa.a.d**dd                            ",
        "       ddmmmmmmmdddd   d**d * ddM......dddd   *   d                     ",
        "     dddmmmmmmdddd    ddddd  dddsaaa.a>>*d*d                            ",
        "     ddmmmmmdddd     ddddd*   ddM.....>>**dd  *                         ",
        "    ddmmmmdddd   *    d*dd    *dMMMM.a.dd**d       **                   ",
        "  dddmmmmdddd          dd    *ddMTSM....dddd* * ddddd *                 ",
        " dddmmmmdddd            d    ddds..+.aa.*dd**   dMMMdd                  ",
        " ddmmmmdddd                  *ddMMMM.MMM.dd* d ddMMMMdd*                ",
        "  dmmmdddd             *      dds..+.+...*d    *ddMMMMddd               ",
        " dddd*dddd *            d   * d*MTSM.MSTM*d  *   *dMMMMd                ",
        " ddddd*dd                    dddMMMM.MMMMd*       ddddddd               ",
        " ddddddd              *   *   ddD.......D*d  d *  *dddddd *             ",
        "ddddd*d                  d   *ddMMMM+MMMMddd *     ddddd                ",
        " *ddddd      *     d   d     ddddMaa.alMddd     d  *ddd *               ",
        "  ddd*dd                   *  dddM....lMd*dd   *    ddd                 ",
        " ddddddd              *      * ddMfccclMdd*d d      dd                  ",
        " dddddd*             *   d *  dddMMMMMMM*ddd   *    d                   ",
        " *dddddd                 *    d*ddMMMMMddd*   *                         ",
        " dddd*dd            d *   d  d dddMMMMMddd*     d                       ",
        " ddddddd                *     ddddMMMMMdd*dd*      d                    ",
        "  ddddd*                     *dd*dMMMMMdddd*d    *                      ",
        "  ddddd               * d    ddddddMMMdd*ddd    **           *          ",
        " d dddd *                 d   dd*ddMMMddd*ddd                    * *    ",
        "   ddd            *    *     ddddd*MMMdd*ddddd  *      *     dd     d   ",
        "    d                      d *dd*ddMMMdddd*dd              ddddddd      ",
        "        d           *  *  d  dd*ddddMddd* dd      *     * ddddMMMdd*  d ",
        "                            dddddd*ddd*dddddd  *         dddMMMMMMdd    ",
        "      d              *      ddd*dddddd*d*dddd*  *      *dddMMMMMMMMdd   ",
        "                *            d*dddddd*ddddd*dd           dddMMMMMMMdd   ",
        "                        d     dd*dddddd*dddd*             d*dMMMMMdd  d ",
        "                             ddddddddddddddd d      *     ddddMMMdd     ",
        "                    *         ddddddddddddddd           d *dddddddd d   ",
        "                       d     dddd*dddddddddd   d           dddd*ddd     ",
        "                              ddddddddddddddd            * ddddddd  *   ",
        "                  *     *    ddd*ddddd*ddd*d         *      dddddd      ",
        "                          d dddddddddddddd        *         ddddd       ",
        "                               ddddddddddddd  d              dddd*      ",
        "                      *       *dddddd*ddddd           *      ddd        ",
        "                            d  ddddddddddd*dd                 dd        ",
        "                *               dd*ddddd*ddd                  d         ",
        "                          d     ddddddddddd* d      *                   ",
        "                               d*dddd*ddddd                             ",
        "                      d       dddddddddddddd                            ",
        "                      *        ddddd*ddd*dd   d                         ",
        "                                dddddddddd*d                            ",
        "                       *       ddddd*ddd*dd    *      *                 ",
        "                             d  ddddddddddd      d                      ",
        "                  *     d      ddddd*dddddd       *                     ",
        "                              d dddddddd*d   d                          ",
        "        *              *        *dddd*dddd    *                         ",
        "           d                  ddddddddddddd                             ",
        "                               ddddddddddd   d          *               ",
        "     d           d         *    ddddddd*ddd        d                    ",
        "             d * dd            ddddddddddddd    *                       ",
        "            ddddddddd     d  dddddddddddddd  d      *                   ",
        "        * dddMMMMMMMdd  *     dddddddddddd                              ",
        "         ddMMMMMMMMMMd  d    dddd*dddddddddd   d                        ",
        "         ddMMMMMMMMM.dd       dddddddddddddd                            ",
        "         ddMMMMMMMMMMdd* *    dd*ddddd*ddd*d         *                  ",
        "    *     dddMMMMMMMdd    d d  ddddddddddd        *                     ",
        "            ddd*ddddd          ddddddddddddd  d                         ",
        "            ddddddddd *   *   * ddddd*ddddd           *                 ",
        "           * ddddddd        d  ddddddddddd*dd                           ",
        "              dddddd *          dd*ddddd***d                            ",
        "              ddddd     d d     ddddddd*ddd* d      *                   ",
        "           d   dddd            d*dddd*ddddd                             ",
        "                ddd  d d       dddd*dd*d*dd*d      *                    ",
        "                dd    *      * ddddd*ddd*dd   d          d              ",
        "                 d        d     *dd*dd*ddd*d*      *                    ",
        "    d      *         d *      * dd*d*dd**d*    *      *     d           ",
        "                           * d   ddd*dd*d*d      d      d               ",
        "                  *     d       dd*d*dddddd *     *     *               ",
        "          *  d             *  d  ddddd*d*d   d      *    *              ",
        "                    *  *        * dd**ddd     *   *         d           ",
        "                       *   *  d   ddddddd *         d                   ",
        "                 *   d             *d*dd     d          *               ",
        "                         *      d   ddd*   *       d  d                 ",
        "                                     dd         *                       "
      ],
      "palettes": [ "airliner_palette" ],
      "items": {
        "d": [ { "item": "airliner_debris", "chance": 15 } ],
        "*": [ { "item": "airliner_debris" } ],
        "a": [ { "item": "snacks", "chance": 5 } ],
        "f": [ { "item": "fridgesnacks", "chance": 80, "repeat": [ 15, 20 ] } ]
      },
      "place_loot": [
        { "group": "airliner_cockpit", "x": 34, "y": 8 },
        { "group": "office_supplies", "repeat": [ 3, 5 ], "x": 38, "y": 8 },
        { "group": "airliner_galley", "x": 38, "y": 55 },
        { "group": "office_supplies", "repeat": [ 3, 5 ], "x": 38, "y": 56 },
        { "group": "snacks", "repeat": [ 10, 15 ], "x": 38, "y": 57 }
      ],
      "place_monsters": [
        { "monster": "GROUP_MALL", "x": [ 27, 47 ], "y": [ 10, 23 ], "repeat": [ 5, 10 ], "density": 0.1 },
        { "monster": "GROUP_MALL", "x": [ 27, 47 ], "y": [ 24, 47 ], "repeat": [ 7, 16 ], "density": 0.1 },
        { "monster": "GROUP_MALL", "x": [ 27, 47 ], "y": [ 48, 61 ], "repeat": [ 3, 4 ], "density": 0.1 }
      ],
      "monster": { "Z": { "monster": "mon_zombie_electric" }, "z": { "monster": "mon_zombie" } }
    }
  },
  {
    "type": "mapgen",
    "method": "json",
    "om_terrain": [ [ "airliner_2a_1" ], [ "airliner_2b_1" ], [ "airliner_2c_1" ] ],
    "weight": 250,
    "object": {
      "rows": [
        "AAAAAAAAAAAAAAAAAAAAAAAA",
        "AAAAAAAAAAAAAAAAAAAAAAAA",
        "AAAAAAAAAAAAAAAAAAAAAAAA",
        "AAAAAAAAAAAAAAAAAAAAAAAA",
        "AAAAAAAAAAAAAAAAAAAAAAAA",
        "AAAAAAAAAAAAAAAAAAAAAAAA",
        "AAAAAAAAAAA...AAAAAAAAAA",
        "AAAAAAAAAA.....AAAAAAAAA",
        "AAAAAAAAA.......AAAAAAAA",
        "AAAAAAAAA.......AAAAAAAA",
        "AAAAAAAAA.......AAAAAAAA",
        "AAAAAAAAA.......AAAAAAAA",
        "AAAAAAAAA.......AAAAAAAA",
        "AAAAAAAAA.......AAAAAAAA",
        "AAAAAAAAA.......AAAAAAAA",
        "AAAAAAAAAA......AAAAAAAA",
        "AAAAAAAAAA......AAAAAAAA",
        "AAAAAAAAAA......AAAAAAAA",
        "AAAAAAAAAA......AAAAAAAA",
        "AAAAAAAAAA......AAAAAAAA",
        "AAAAAAAAA.......AAAAAAAA",
        "AAAAAAAAA.......AAAAAAAA",
        "AAAAAAAAA.......AAAAAAAA",
        "AAAAAAAAA.......AAAAAAAA",
        "AAAAAAAAA.......AAAAAAAA",
        "AAAAAAAAA.......AAAAAAAA",
        "AAAAAAAAA.......AAAAAAAA",
        "AAAAAAAAA.......AAAAAAAA",
        "AAAAAAAAA.......AAAAAAAA",
        "AAAAAAAAA.......AAAAAAAA",
        "AAAAAAAAA.......AAAAAAAA",
        "AAAAAAAAA.......AAAAAAAA",
        "AAAAAAAAA.......AAAAAAAA",
        "AAAAAAAAA.......AAAAAAAA",
        "AAAAAAAAA.......AAAAAAAA",
        "AAAAAAAAA.......AAAAAAAA",
        "AAAAAAAAA.......AAAAAAAA",
        "AAAAAAAAA.......AAAAAAAA",
        "AAAAAAAAA.......AAAAAAAA",
        "AAAAAAAAA......AAAAAAAAA",
        "AAAAAAAAA.....AAAAAAAAAA",
        "AAAAAAAAA.....AAAAAAAAAA",
        "AAAAAAAAA.....AAAAAAAAAA",
        "AAAAAAAAA.....AAAAAAAAAA",
        "AAAAAAAAA.....AAAAAAAAAA",
        "AAAAAAAAA.....AAAAAAAAAA",
        "AAAAAAAAA.....AAAAAAAAAA",
        "AAAAAAAAA.....AAAAAAAAAA",
        "AAAAAAAAA.....AAAAAAAAAA",
        "AAAAAAAAA......AAAAAAAAA",
        "AAAAAAAAA.......AAAAAAAA",
        "AAAAAAAAA.......AAAAAAAA",
        "AAAAAAAAA.......AAAAAAAA",
        "AAAAAAAAA.......AAAAAAAA",
        "AAAAAAAAAA..M..AAAAAAAAA",
        "AAAAAAAAAA.MMM.AAAAAAAAA",
        "AAAAAAAAAA.MMM.AAAAAAAAA",
        "AAAAAAAAAA.MMM.AAAAAAAAA",
        "AAAAAAAAAA.MMM.AAAAAAAAA",
        "AAAAAAAAAAAMMMAAAAAAAAAA",
        "AAAAAAAAAA.MMM.AAAAAAAAA",
        "AAAAAAAAAA.MMM.AAAAAAAAA",
        "AAAAAAAA...MMM...AAAAAAA",
        "AAAAAA.....MMM.....AAAAA",
        "AAAA.......MMM.......AAA",
        "AA.........MMM.........A",
        "AA........AMMMA........A",
        "AA.....AAAAAMAAAAA.....A",
        "AA..AAAAAAAAAAAAAAAAA..A",
        "AAAAAAAAAAAAAAAAAAAAAAAA",
        "AAAAAAAAAAAAAAAAAAAAAAAA",
        "AAAAAAAAAAAAAAAAAAAAAAAA"
      ],
      "palettes": [ "airliner_palette" ]
    }
  },
  {
    "type": "mapgen",
    "method": "json",
    "om_terrain": [ [ "airliner_2b_-1" ], [ "airliner_2c_-1" ] ],
    "weight": 250,
    "object": {
      "fill_ter": "t_metal_floor",
      "rows": [
        ",,,,,,,,,,,,,,,,,,,,,,,,",
        ",,,,,,,,,,,,,,,,,,,,,,,,",
        ",,,,,,,,,,,,,,,,,,,,,,,,",
        ",,,,,,,,,,****M,,,,,,,,,",
        ",,,,,,,,,,MLLLM,,,,,,,,,",
        ",,,,,,,,,,MLLLM,,,,,,,,,",
        ",,,,,,,,,,MLLLM,,,,,,,,,",
        ",,,,,,,,,,ML,LM,,,,,,,,,",
        ",,,,,,,,,,MLLLM,,,,,,,,,",
        ",,,,,,,,,,M,LLM,,,,,,,,,",
        ",,,,,,,,,,MLL,M,,,,,,,,,",
        ",,,,,,,,,,ML..M,,,,,,,,,",
        ",,,,,,,,,,M..LM,,,,,,,,,",
        ",,,,,,,,,,M.L.M,,,,,,,,,",
        ",,,,,,,,,,M...M,,,,,,,,,",
        ",,,,,,,,,,ML..M,,,,,,,,,",
        ",,,,,,,,,,M...M,,,,,,,,,",
        ",,,,,,,,,,M...M,,,,,,,,,",
        ",,,,,,,,,,M..dM,,,,,,,,,",
        ",,,,,,,,,,M..dd,,,,,,,,,",
        ",,,,,,,,,,M..d<<,,,,,,,,",
        ",,,,,,,,,,M..d<<,,,,,,,,",
        ",,,,,,,,,,M...d,,,,,,,,,",
        ",,,,,,,,,,M...M,,,,,,,,,",
        ",,,,,,,,,,M...M,,,,,,,,,",
        ",,,,,,,,,,M...M,,,,,,,,,",
        ",,,,,,,,,,M...M,,,,,,,,,",
        ",,,,,,,,,,M...M,,,,,,,,,",
        ",,,,,,,,,,M...M,,,,,,,,,",
        ",,,,,,,,,,M...M,,,,,,,,,",
        ",,,,,,,,,,D...D,,,,,,,,,",
        ",,,,,,,,,,MMMMM,,,,,,,,,",
        ",,,,,,,,,,,,,,,,,,,,,,,,",
        ",,,,,,,,,,,,,,,,,,,,,,,,",
        ",,,,,,,,,,,,,,,,,,,,,,,,",
        ",,,,,,,,,,,,,,,,,,,,,,,,",
        ",,,,,,,,,,,,,,,,,,,,,,,,",
        ",,,,,,,,,,,,,,,,,,,,,,,,",
        ",,,,,,,,,,,,,,,,,,,,,,,,",
        ",,,,,,,,,,,,,,,,,,,,,,,,",
        ",,,,,,,,,,,,,,,,,,,,,,,,",
        ",,,,,,,,,,,,,,,,,,,,,,,,",
        ",,,,,,,,,,,,,,,,,,,,,,,,",
        ",,,,,,,,,,,,,,,,,,,,,,,,",
        ",,,,,,,,,,,,,,,,,,,,,,,,",
        ",,,,,,,,,,,,,,,,,,,,,,,,",
        ",,,,,,,,,,,,,,,,,,,,,,,,",
        ",,,,,,,,,,,,,,,,,,,,,,,,"
      ],
      "palettes": [ "airliner_palette" ],
      "items": { "L": [ { "item": "airliner_luggage", "chance": 80, "repeat": [ 2, 3 ] } ] }
    }
  },
  {
    "id": "airliner_luggage",
    "type": "item_group",
    "subtype": "collection",
    "entries": [
      { "group": "bags_trip" },
      { "group": "allclothes", "count-min": 3, "count-max": 7 },
      { "group": "shoes", "prob": 30 },
      { "group": "glasses", "prob": 10 },
      { "group": "magazines", "prob": 10 }
    ]
  },
  {
    "id": "airliner_cockpit",
    "type": "item_group",
    "subtype": "collection",
    "items": [
      { "item": "crash_axe" },
      {
        "collection": [ { "item": "flaregun" }, { "item": "signal_flare", "count-min": 1, "count-max": 2 } ],
        "prob": 40
      },
      { "item": "1st_aid", "prob": 40 },
      { "item": "handflare", "count-min": 1, "count-max": 3, "prob": 30 },
      { "item": "sm_extinguisher", "prob": 75 }
    ]
  },
  {
    "id": "airliner_galley",
    "type": "item_group",
    "subtype": "collection",
    "items": [
      { "item": "1st_aid", "prob": 40 },
      { "item": "handflare", "count-min": 1, "count-max": 3, "prob": 30 },
      { "item": "sm_extinguisher", "prob": 75 }
    ]
  },
  {
    "id": "airliner_debris",
    "type": "item_group",
    "items": [ [ "scrap", 30 ], [ "steel_chunk", 20 ], [ "steel_lump", 10 ], [ "sheet_metal_small", 10 ], [ "sheet_metal", 5 ] ]
  }
]
