[
  {
    "type": "mapgen",
    "method": "json",
    "om_terrain": [ "s_antique" ],
    "object": {
      "fill_ter": "t_floor",
      "rows": [
        "____,____,____,____,____",
        "____,____,____,____,____",
        "____,____,____,____,____",
        "____,____,____,____,____",
        "____,____,____,____,____",
        "FFFFFFFFFFFFFFFFFFFFFFFF",
        "FFFFFFFFFFFFFFFFFFFFFFFF",
        "###OOOOOO##++##OOOOOO###",
        "#l                    l#",
        "#l                    l#",
        "#l  llllll    llllll  l#",
        "#l                    l#",
        "#l                    l#",
        "#l  llllll    llllll  l#",
        "#l                    l#",
        "#l                    l#",
        "#      ccTTTTTTcc      #",
        "#              Lc      #",
        "###########M############",
        ".4........._________<...",
        "........................",
        "........................",
        "........................",
        "........................"
      ],
      "palettes": [ "parametrized_walls_palette" ],
      "terrain": {
        " ": "t_floor",
        "+": "t_door_glass_c",
        ",": "t_pavement_y",
        ".": "t_region_groundcover_urban",
        "F": "t_sidewalk",
        "O": "t_window",
        "_": "t_pavement",
        "M": "t_door_metal_pickable",
        "4": "t_gutter_downspout",
        "<": "t_ladder_up"
      },
      "furniture": { "c": "f_counter", "T": "f_displaycase", "l": "f_bookcase", "L": "f_stool" },
      "place_items": [
        { "item": "antique", "x": [ 4, 9 ], "y": [ 10, 10 ], "chance": 85, "repeat": [ 1, 3 ] },
        { "item": "antique", "x": [ 14, 19 ], "y": [ 10, 10 ], "chance": 85, "repeat": [ 1, 3 ] },
        { "item": "antique", "x": [ 4, 9 ], "y": [ 13, 13 ], "chance": 85, "repeat": [ 1, 3 ] },
        { "item": "antique", "x": [ 14, 19 ], "y": [ 13, 13 ], "chance": 85, "repeat": [ 1, 3 ] },
        { "item": "antique", "x": [ 1, 1 ], "y": [ 8, 15 ], "chance": 85, "repeat": [ 1, 3 ] },
        { "item": "antique", "x": [ 22, 22 ], "y": [ 8, 15 ], "chance": 85, "repeat": [ 1, 3 ] },
        { "item": "antique_rare", "x": [ 9, 14 ], "y": [ 16, 16 ], "chance": 65 },
        { "item": "cash_register_random", "x": [ 15, 16 ], "y": 16, "chance": 100 }
      ]
    }
  },
  {
    "type": "mapgen",
    "method": "json",
    "om_terrain": [ "s_antique_roof" ],
    "object": {
      "fill_ter": "t_tar_flat_roof",
      "rows": [
        "                        ",
        "                        ",
        "                        ",
        "                        ",
        "                        ",
        "                        ",
        "                        ",
        "-......................-",
        "-.:....................-",
        "-......................-",
        "-......................-",
        "-......................-",
        "-......................-",
        "-......................-",
        "-......................-",
        "-......................-",
        "-.........&............-",
        "-......................-",
        "-5----------------------",
        "                   #v## ",
        "                        ",
        "                        ",
        "                        ",
        "                        "
      ],
      "palettes": [ "roof_palette" ],
      "place_items": [ { "item": "SUS_trash_roof", "x": [ 4, 16 ], "y": [ 8, 15 ], "chance": 50, "repeat": [ 1, 3 ] } ],
      "place_nested": [
        { "chunks": [ [ "roof_2x2_golf", 5 ], [ "null", 85 ], [ "roof_3x3_wine", 10 ] ], "x": [ 13, 20 ], "y": 15 },
        {
          "chunks": [ [ "null", 40 ], [ "roof_4x4_party", 5 ], [ "roof_4x4_utility", 50 ], [ "roof_4x4_holdout", 3 ] ],
          "x": [ 4, 13 ],
          "y": [ 8, 13 ]
        }
      ]
    }
  }
]
