[
  {
    "type": "mapgen",
    "method": "json",
    "om_terrain": [
      [ "apartments_mod_tower_110", "apartments_mod_tower_010" ],
      [ "apartments_mod_tower_100", "apartments_mod_tower_000" ]
    ],
    "//": "Level 0",
    "object": {
      "fill_ter": "t_floor",
      "rows": [
        "           ####   fffffggfffff   ####           ",
        "       |||||ww|||||ssssssssss|||||ww|||||       ",
        "       |á......o..|ssssssssJJ|O.....ä...|       ",
        "    ||||..........|JJJsssssJJ|..........||||    ",
        "    |Ur+..........|JJJsssssJJ|..........+rU|    ",
        "    ||||....--+---||||ssss||||---+--....||||    ",
        "    R,Q|-----..j-STib|ssss|biTS-j..-----|Q,R    ",
        "    R,,wÜ.......+iiib||||D|biii+....Ü...w,,R    ",
        "    R,,D........-----|,,,,|-----........D,,R    ",
        "    R,,w.....ő.....-Y|<,,,|Y-ö..........w,,R    ",
        "    R,,|é..........+.|,,,,|.+......é....|,,R    ",
        " |||||||...........||||++||||...........||||||| ",
        " |Á....|...........|^......^|...........|.Ä...| ",
        "#|.....||||--......D........D......--||||.....|#",
        "#w.....+rU|u+......|p.~~~~.p|......+u|Ur+.....w#",
        "#w....----||||||||||..~~~~..||||||||||----....w#",
        "#|....-STb-u-.Ű....|..~~~~..|Ű.....-u-bTS-....|#",
        " |....-iib-.+......|..~~~~..|......+.-bii-....| ",
        " ||||+-+-----......|..~~~~..|......-----+-+|||| ",
        " R,,D...-ü.........|..~~~~..|......ü...-...D,,R ",
        " R,,wÓ.............|p.~~~~.p|...........ó..w,,R ",
        " R,,w..............D..~~~~..D..............w,,R ",
        " R,Q|...-.....Ü....|..~~~~..|.Ü........-...|Q,R ",
        " |||||||||||||||||||..~~~~..||||||||||||||||||| ",
        " #|O...-ű....Ö.....|^.~~~~..|Ő.....ű....-.o..|# ",
        " #w................|..~~~~..|................w# ",
        " #|....-...........|..~~~~..|...........-....|# ",
        "  ||D|+------......|..~~~~.^|......------+|D||  ",
        "  R,,|..ä...-......D..~~~~..D......-á.....|,,R  ",
        "  R,,w......-......|p.~~~~.p|......-......w,,R  ",
        "  R,,w......--+--+-|..~~~~..|-+--+--......w,,R  ",
        "  R,Q|......-Ur-u.Y|..~~~~..|Y.u-rU-......|Q,R  ",
        "  ||||+|||||||||||||..~~~~..|||||||||||||+||||  ",
        "  |biii|TSib-Ő.....|..~~~~..|Ö.....-biST|iiib|  ",
        "  |biTS|iiib-......|..~~~~..|......-biii|STib|  ",
        " |||||||-+---......|..~~~~..|......---+-||||||| ",
        "#|Ó..ä....-U-......|..~~~~..|......-U-.á...ó..|#",
        "#w........-r+......|p.~~~~.p|......+r-........w#",
        "#|........---......D..~~~~..D......---........|#",
        " ||||.....+........|..~~~~..|........+.....|||| ",
        "    ||www||e.....-+|........|+-.É....||www||    ",
        "    RQ,,,,D......-Y|^......^|Y-......D,,,,QR    ",
        "    R,,,,,w......-u||W|GG|W||u-......w,,,,,R    ",
        "    |RRRRR||||ww||||  ssss  ||||ww||||RRRRR|    ",
        "                      ssss                      ",
        "   ##   ##   ##   ##  ssss  ##   ##   ##   ##   ",
        "   ##   ##   ##   ##  ssss  ##   ##   ##   ##   ",
        "                      ssss                      "
      ],
      "palettes": [ "apartment_palette" ]
    }
  },
  {
    "type": "mapgen",
    "method": "json",
    "om_terrain": [
      [ "apartments_mod_tower_111", "apartments_mod_tower_011" ],
      [ "apartments_mod_tower_101", "apartments_mod_tower_001" ]
    ],
    "//": "Levels 1 and 3",
    "object": {
      "fill_ter": "t_floor",
      "rows": [
        "************************************************",
        "*******|||||ww|||||**********|||||ww|||||*******",
        "*******|á......o..|**********|O.....ä...|*******",
        "****||||..........w**********w..........||||****",
        "****|Ur+..........|**********|..........+rU|****",
        "****||||....--+---||||****||||---+--....||||****",
        "****R,,|-----..j-STib|****|biTS-j..-----|,,R****",
        "****R,,wÜ.......+iiib||WW||biii+....Ü...w,,R****",
        "****R,,+........-----|,,,,|-----........+,,R****",
        "****R,,w.....ő.....-Y|>,,<|Y-ö..........w,,R****",
        "****R,Q|é..........+.|,,,,|.+......é....|Q,R****",
        "*|||||||...........||||++||||...........|||||||*",
        "*|Á....|...........|^......^|...........|.Ä...|*",
        "*|.....||||--......D........D......--||||.....|*",
        "*w.....+rU|u+......|p.RRRR.p|......+u|Ur+.....w*",
        "*w....----||||||||||..R¤¤R..||||||||||----....w*",
        "*|....-TSb-u-.Ű....|..R¤¤R..|Ű.....-u-bST-....|*",
        "*|....-iib-.+......|..R¤¤R..|......+.-bii-....|*",
        "*||||+-+-----......|..R¤¤R..|......-----+-+||||*",
        "*R,,+...-ü.........|..R¤¤R..|......ü...-...+,,R*",
        "*R,,wÓ.............|p.R¤¤R.p|...........ó..w,,R*",
        "*R,,w..............D..R¤¤R..D..............w,,R*",
        "*R,Q|...-.....Ü....|..R¤¤R..|.Ü........-...|Q,R*",
        "*|||||||||||||||||||..R¤¤R..|||||||||||||||||||*",
        "**|O...-ű....Ö.....|..R¤¤R.^|Ő.....ű....-.o..|**",
        "**w................|..R¤¤R..|................w**",
        "**|....-...........|..R¤¤R..|...........-....|**",
        "**||+|+------......|^.R¤¤R..|......------+|+||**",
        "**R,,|..ä...-......D..R¤¤R..D......-á.....|,,R**",
        "**R,,w......-......|p.R¤¤R.p|......-......w,,R**",
        "**R,,w......--+--+-|..R¤¤R..|-+--+--......w,,R**",
        "**R,Q|......-Ur-u.Y|..R¤¤R..|Y.u-rU-......|Q,R**",
        "**||||+|||||||||||||..R¤¤R..|||||||||||||+||||**",
        "**|biii|TSib-Ő.....|..R¤¤R..|Ö.....-biST|iiib|**",
        "**|biTS|iiib-......|..R¤¤R..|......-biii|STib|**",
        "*|||||||-+---......|..R¤¤R..|......---+-|||||||*",
        "*|Ó..ä....-U-......|..R¤¤R..|......-U-.á...ó..|*",
        "*w........-r+......|p.R¤¤R.p|......+r-........w*",
        "*|........---......D..R¤¤R..D......---........|*",
        "*||||.....+........|..RRRR..|........+.....||||*",
        "****||www||e.....-+|........|+-.É....||www||****",
        "****RQ,,,,+......-Y|^......^|Y-......+,,,,QR****",
        "****R,,,,,w......-u||||WW||||u-......w,,,,,R****",
        "****|RRRRR||||ww||||********||||ww||||RRRRR|****",
        "************************************************",
        "************************************************",
        "************************************************",
        "************************************************"
      ],
      "palettes": [ "apartment_palette" ]
    }
  },
  {
    "type": "mapgen",
    "method": "json",
    "om_terrain": [ [ "apartments_mod_tower_112", "apartments_mod_tower_012" ] ],
    "//": "Levels 2 and 4",
    "object": {
      "fill_ter": "t_floor",
      "rows": [
        "************************************************",
        "*******|||||ww|||||**********|||||ww|||||*******",
        "*******|á......o..|**********|O.....ä...|*******",
        "****||||..........w**********w..........||||****",
        "****|Ur+..........|**********|..........+rU|****",
        "****||||....--+---||||****||||---+--....||||****",
        "****R,,|-----..j-STib|****|biTS-j..-----|,,R****",
        "****R,,wÜ.......+iiib||WW||biii+....Ü...w,,R****",
        "****R,,+........-----|,,,,|-----........+,,R****",
        "****R,,w.....ő.....-Y|<,,>|Y-ö..........w,,R****",
        "****R,Q|é..........+.|,,,,|.+......é....|Q,R****",
        "*|||||||...........||||++||||...........|||||||*",
        "*|Á....|...........|^......^|...........|.Ä...|*",
        "*|.....||||--......D........D......--||||.....|*",
        "*w.....+rU|u+......|p.RRRR.p|......+u|Ur+.....w*",
        "*w....----||||||||||..R¤¤R..||||||||||----....w*",
        "*|....-TSb-u-.Ű....|..R¤¤R..|Ű.....-u-bST-....|*",
        "*|....-iib-.+......|..R¤¤R..|......+.-bii-....|*",
        "*||||+-+-----......|..R¤¤R..|......-----+-+||||*",
        "*R,,+...-ü.........|..R¤¤R..|......ü...-...+,,R*",
        "*R,,wÓ.............|p.R¤¤R.p|...........ó..w,,R*",
        "*R,,w..............D..R¤¤R..D..............w,,R*",
        "*R,Q|...-.....Ü....|..R¤¤R..|.Ü........-...|Q,R*",
        "*|||||||||||||||||||..R¤¤R..|||||||||||||||||||*"
      ],
      "palettes": [ "apartment_palette" ]
    }
  },
  {
    "type": "mapgen",
    "method": "json",
    "om_terrain": [
      [ "apartments_mod_tower_113", "apartments_mod_tower_013" ],
      [ "apartments_mod_tower_103", "apartments_mod_tower_003" ]
    ],
    "//": "Level 5",
    "object": {
      "fill_ter": "t_flat_roof",
      "rows": [
        "                                                ",
        "       5-----------          -----------5       ",
        "       -..........-          -..........-       ",
        "    ----..........-          -..........----    ",
        "    -.............-          -.............-    ",
        "    -.............5---    ---5.............-    ",
        "    -................-    -................-    ",
        "    -................------................-    ",
        "    -................│││...................-    ",
        "    -................│>│...................-    ",
        "    -...ffffffffffff.│+│...................-    ",
        " 5---...f..........g.......................---5 ",
        " -......f.:.:......fgf........................- ",
        " -......f............f........................- ",
        " -......f.:.:......~.f........................- ",
        " -......f..........~.f........................- ",
        " -......f.X.X......~.f........................- ",
        " -......f..........~.f........................- ",
        " -......f.X.X........f........................- ",
        " -......f.........ffff........................- ",
        " -......f.N.N.....f...........................- ",
        " -......f.........f...........................- ",
        " -......f.N.N.....f...........................- ",
        " 5-.....f.........f..........................-5 ",
        "  -.....fffffffffff..........................-  ",
        "  -..........................................-  ",
        "  -..........................................-  ",
        "  -..........................................-  ",
        "  -..........................................-  ",
        "  -..........................................-  ",
        "  -..........................................-  ",
        "  -..........................................-  ",
        "  -..........................................-  ",
        "  -..........................................-  ",
        "  -..........................................-  ",
        " 5-..........................................-5 ",
        " -............................................- ",
        " -............................................- ",
        " -............................................- ",
        " ----......................................---- ",
        "    -......................................-    ",
        "    -......................................-    ",
        "    -..............5--------5..............-    ",
        "    5---------------        ---------------5    ",
        "                                                ",
        "                                                ",
        "                                                ",
        "                                                "
      ],
      "palettes": [ "roof_palette" ],
      "terrain": { "│": "t_wall_metal", "+": "t_door_locked" },
      "place_nested": [
        {
          "chunks": [ [ "roof_2x2_golf", 25 ], [ "null", 25 ], [ "roof_4x4_party", 25 ], [ "roof_3x3_wine", 25 ] ],
          "x": [ 8, 15 ],
          "y": [ 2, 7 ]
        },
        {
          "chunks": [
            [ "null", 50 ],
            [ "roof_5x5_coop", 50 ],
            [ "roof_4x4_utility_1", 30 ],
            [ "roof_4x4_utility", 30 ],
            [ "roof_2x2_utilities", 20 ],
            [ "roof_2x2_utilities_c", 20 ],
            [ "roof_2x2_utilities_b", 20 ]
          ],
          "x": [ 37, 39 ],
          "y": [ 17, 19 ]
        },
        {
          "chunks": [
            [ "roof_2x2_golf", 20 ],
            [ "null", 20 ],
            [ "roof_4x4_holdout", 20 ],
            [ "roof_4x4_party", 20 ],
            [ "roof_3x3_wine", 20 ]
          ],
          "x": [ 30, 39 ],
          "y": [ 24, 38 ]
        }
      ]
    }
  }
]
