[
  {
    "type": "mapgen",
    "method": "json",
    "om_terrain": [ "bakery" ],
    "weight": 100,
    "object": {
      "fill_ter": "t_linoleum_gray",
      "rows": [
        "_||w||sss||www||1|ww|1||",
        "_|  &|sss|^HtH^|w|Ht|w||",
        "_|   |DD||............H|",
        "_|   -..bC.......H....t|",
        "_|#  -..bC.....Htt....H|",
        "_|g  c..bC......ttH....|",
        "_|g  c..........H.....H|",
        "_|g #c................t|",
        "_|g  c................H|",
        "_|   -@...HtH....HtH...|",
        "_|   --+------.........|",
        "_|c         o-...HtH..@|",
        "_Wc         o-.........|",
        "_|S   cSc   o-.........|",
        "_|c   ccc   R-..GG^GG..|",
        "_|c         R--+-----+-|",
        "_|ccc{{     R-   &-&   |",
        "_||||||||-+---    -    |",
        "_pppaapp|b..l-c ----- c|",
        "_ppppppp|b..l-S dT-Td S|",
        "_ppppppp+...<-c ----- c|",
        "_ppppppp|rrr^-S dT-Td S|",
        "_ppppppp||||||||||||||||",
        "______________________4_"
      ],
      "terrain": {
        "+": "t_door_c",
        "-": "t_wall_w",
        ".": "t_floor",
        "^": "t_floor",
        "t": "t_floor",
        "r": "t_floor",
        "G": "t_floor",
        "b": "t_floor",
        "l": "t_floor",
        "H": "t_floor",
        "@": "t_floor",
        "C": "t_floor",
        " ": "t_linoleum_gray",
        "1": "t_region_shrub_decorative",
        "D": "t_door_glass_c",
        "W": "t_window_domestic",
        "_": "t_region_groundcover_urban",
        "a": "t_concrete",
        "d": "t_door_o",
        "p": "t_concrete",
        "s": "t_sidewalk",
        "w": "t_wall_glass",
        "<": "t_stairs_up",
        "4": "t_gutter_downspout",
        "|": "t_brick_wall"
      },
      "furniture": {
        "#": "f_stool",
        "&": "f_trashcan",
        "@": "f_trashcan",
        "H": "f_chair",
        "S": "f_sink",
        "T": "f_toilet",
        "^": "f_indoor_plant",
        "a": "f_dumpster",
        "b": "f_bench",
        "c": "f_counter",
        "C": "f_counter",
        "l": "f_locker",
        "o": "f_oven",
        "t": "f_table",
        "r": "f_rack",
        "R": "f_rack_wood",
        "g": "f_glass_cabinet",
        "G": "f_glass_cabinet",
        "{": "f_fridge"
      },
      "toilets": { "T": {  } },
      "place_items": [
        { "item": "groce_ingredient", "x": 3, "y": 16, "chance": 50 },
        { "item": "groce_ingredient", "x": 2, "y": 15, "chance": 50 },
        { "item": "groce_ingredient", "x": 2, "y": 11, "chance": 50 },
        { "item": "groce_ingredient", "x": 12, "y": [ 14, 16 ], "chance": 50, "repeat": [ 1, 3 ] },
        { "item": "groce_ingredient", "x": [ 9, 11 ], "y": 21, "chance": 50, "repeat": [ 1, 3 ] },
        { "item": "groce_dairyegg", "x": [ 5, 6 ], "y": 16, "chance": 75 },
        { "item": "groce_bread", "x": 2, "y": 16, "chance": 50 },
        { "item": "groce_bread", "x": 2, "y": 14, "chance": 50 },
        { "item": "groce_bread", "x": 16, "y": 5, "chance": 50 },
        { "item": "groce_bread", "x": 5, "y": 5, "chance": 50 },
        { "item": "bags", "x": 12, "y": [ 18, 19 ], "chance": 25 },
        { "item": "coffee_newsstand", "x": 5, "y": 8, "chance": 25 },
        { "item": "trash", "x": 19, "y": 16, "chance": 75 },
        { "item": "trash", "x": 17, "y": 16, "chance": 75 },
        { "item": "trash", "x": 22, "y": 11, "chance": 75 },
        { "item": "trash", "x": 4, "y": 1, "chance": 75 },
        { "item": "bags", "x": 12, "y": [ 18, 19 ], "chance": 75, "repeat": [ 1, 3 ] },
        { "item": "jackets", "x": 12, "y": [ 18, 19 ], "chance": 75, "repeat": [ 1, 3 ] },
        { "item": "baked_goods", "x": 2, "y": [ 5, 8 ], "chance": 75, "repeat": [ 1, 3 ] },
        { "item": "baked_goods", "x": 5, "y": [ 5, 8 ], "chance": 75, "repeat": [ 1, 3 ] },
        { "item": "baked_goods", "x": [ 16, 17 ], "y": 14, "chance": 75, "repeat": [ 1, 3 ] },
        { "item": "baked_goods", "x": [ 19, 20 ], "y": 14, "chance": 75, "repeat": [ 1, 3 ] },
        { "item": "groce_softdrink", "x": 17, "y": 4, "chance": 35 },
        { "item": "cash_register_random", "x": 5, "y": [ 5, 8 ], "chance": 100 }
      ]
    }
  },
  {
    "type": "mapgen",
    "method": "json",
    "om_terrain": [ "bakery_roof" ],
    "weight": 300,
    "object": {
      "fill_ter": "t_flat_roof",
      "rows": [
        "_22222___2222222_2222_22",
        "_|   |___3     222  2223",
        "_|   22222             3",
        "_|                     3",
        "_|                     3",
        "_|                     3",
        "_|                     3",
        "_|                     3",
        "_|                     3",
        "_|                     3",
        "_|                     3",
        "_|                     3",
        "_|                     3",
        "_|                     3",
        "_|                     3",
        "_|                     3",
        "_|   &                 3",
        "_|------| #####=+###   3",
        "________| #K      d#   3",
        "________| #K     cd#   3",
        "________| # >rK   f#   3",
        "________| #####=#=##   3",
        "________|-------------53",
        "________________________"
      ],
      "terrain": {
        " ": "t_flat_roof",
        "_": "t_open_air",
        "|": "t_gutter_west",
        "-": "t_gutter_south",
        "3": "t_gutter_east",
        "2": "t_gutter_north",
        ">": "t_stairs_down",
        "5": "t_gutter_drop",
        "r": "t_metal_railing",
        "+": "t_door_green_c",
        "=": "t_window_domestic",
        "#": "t_brick_wall"
      },
      "furniture": { "&": "f_roof_turbine_vent", "K": "f_rack", "f": "f_filing_cabinet", "d": "f_desk", "c": "f_chair" },
      "place_loot": [
        { "item": "birdfood", "x": 14, "y": 20, "chance": 50, "repeat": [ 1, 3 ] },
        { "item": "stepladder", "x": 13, "y": 18, "chance": 50 },
        { "group": "groce_ingredient", "x": 11, "y": [ 18, 19 ], "chance": 50, "repeat": [ 1, 3 ] },
        { "group": "office", "x": 18, "y": [ 18, 20 ], "chance": 50, "repeat": [ 1, 3 ] },
        { "group": "roof_trash", "x": [ 4, 16 ], "y": [ 3, 15 ], "chance": 50, "repeat": [ 1, 3 ] }
      ],
      "place_nested": [
        { "chunks": [ [ "roof_2x2_golf", 10 ], [ "null", 80 ] ], "x": 4, "y": 10 },
        { "chunks": [ [ "roof_16x16_help", 2 ], [ "null", 80 ] ], "x": 4, "y": 5 },
        {
          "chunks": [ [ "roof_4x4_utility_1", 30 ], [ "roof_4x4_utility", 20 ], [ "roof_5x5_coop", 50 ] ],
          "x": [ 10, 12 ],
          "y": 10
        }
      ]
    }
  },
  {
    "type": "mapgen",
    "method": "json",
    "om_terrain": [ "bakery_upper_roof" ],
    "weight": 300,
    "object": {
      "fill_ter": "t_open_air",
      "rows": [
        "________________________",
        "________________________",
        "________________________",
        "________________________",
        "________________________",
        "________________________",
        "________________________",
        "________________________",
        "________________________",
        "________________________",
        "________________________",
        "________________________",
        "________________________",
        "________________________",
        "________________________",
        "________________________",
        "________________________",
        "__________          ____",
        "__________          ____",
        "__________          ____",
        "__________          ____",
        "__________          ____",
        "________________________",
        "________________________"
      ],
      "terrain": { " ": "t_flat_roof", "_": "t_open_air" }
    }
  }
]
