[
  {
    "type": "mapgen",
    "method": "json",
    "om_terrain": [ "bowling_alley" ],
    "object": {
      "fill_ter": "t_floor",
      "rows": [
        ",,,,,___________________",
        ",,,,,y_____y_____y_____y",
        ",,,,,y_____y_____y_____y",
        ",,,,,y_____y_____y_____y",
        ",,,,,y_____y_____y_____y",
        ",,,,,y_____y_____y_____y",
        ",,,,,y_____y_____y_____4",
        "##+######OOOO####OOOO###",
        "#                      #",
        "#      ccc     c    c  #",
        "#F     ttt    ctc  ctc #",
        "#&     ccc             #",
        "#               =  =   #",
        "#      s s  |GSSGSSGSSG#",
        "#     CCCC@C|GSSGSSGSSG#",
        "#ctc sC    1|GSSGSSGSSG#",
        "#ctc  Cs   1|GSSGSSGSSG#",
        "#ctc sC00  1|GSSGSSGSSG#",
        "#     |||+|||GSSGSSGSSG#",
        "#     |f~~~2|GSSGSSGSSG#",
        "#+||+||f~~~2|GSSGSSGSSG#",
        "#'U|'U|(~~~2||$$|$$|$$|#",
        "#T%|T%|(~L~~+~~~~~~~~~~#",
        "########################"
      ],
      "palettes": [ "parametrized_linoleum_palette", "parametrized_walls_palette" ],
      "terrain": {
        "_": "t_pavement",
        "y": "t_pavement_y",
        ",": "t_sidewalk",
        "O": "t_window",
        "+": "t_door_c",
        " ": "t_floor",
        "S": "t_floor_waxed",
        "G": "t_floor_waxed",
        "%": { "param": "linoleum_color", "fallback": "t_linoleum_white" },
        "'": { "param": "linoleum_color", "fallback": "t_linoleum_white" },
        "T": { "param": "linoleum_color", "fallback": "t_linoleum_white" },
        "U": { "param": "linoleum_color", "fallback": "t_linoleum_white" },
        "~": "t_thconc_floor",
        "f": "t_thconc_floor",
        "2": "t_thconc_floor",
        "L": "t_thconc_floor",
        "4": "t_gutter_downspout"
      },
      "furniture": {
        "C": "f_counter",
        "@": "f_counter_gate_c",
        "c": "f_chair",
        "s": "f_stool",
        "t": "f_table",
        "G": "f_lane",
        "=": "f_ball_mach",
        "$": "f_machinery_light",
        "f": "f_heavy_duty_fridge",
        "(": "f_heavy_duty_freezer",
        "U": "f_sink",
        "0": "f_rack",
        "1": "f_rack_wood",
        "2": "f_utility_shelf",
        "L": "f_locker",
        "%": "f_trashcan",
        "&": "f_trashcan"
      },
      "toilets": { "T": {  } },
      "vendingmachines": { "F": { "item_group": "vending_food", "lootable": true } },
      "items": {
        "=": { "item": "bowling_balls", "chance": 100, "repeat": [ 1, 3 ] },
        "t": { "item": "bowling_table", "chance": 33, "repeat": [ 1, 2 ] },
        "C": { "item": "bowling_alcohol", "chance": 25 },
        "T": { "item": "bowling_bathroom", "chance": 35, "repeat": [ 1, 2 ] },
        "0": { "item": "bowling_item", "chance": 80, "repeat": [ 4, 12 ] },
        "1": { "item": "bowling_alcohol", "chance": 50, "repeat": [ 1, 3 ] },
        "2": { "item": "bowling_food", "chance": 50, "repeat": [ 1, 3 ] },
        "f": { "item": "bowling_fridge", "chance": 50, "repeat": [ 1, 3 ] },
        "%": { "item": "SUS_trash_trashcan_public", "chance": 55 },
        "&": { "item": "SUS_trash_trashcan_public", "chance": 55 },
        "L": { "item": "SUS_janitors_closet", "chance": 90 }
      },
      "place_loot": [
        { "group": "cash_register_random", "x": 11, "y": 14 },
        { "item": "bowling_pin", "x": [ 14, 15 ], "y": 20, "repeat": 10 },
        { "item": "bowling_pin", "x": [ 17, 18 ], "y": 20, "repeat": 10 },
        { "item": "bowling_pin", "x": [ 20, 21 ], "y": 20, "repeat": 10 }
      ],
      "place_monster": [ { "group": "GROUP_CIVILIAN", "x": [ 2, 21 ], "y": [ 7, 22 ], "repeat": [ 1, 3 ] } ],
      "place_vehicles": [
        { "vehicle": "parking_garage_short", "x": [ 8, 9 ], "y": 4, "rotation": 90, "chance": 33 },
        { "vehicle": "parking_garage_short", "x": [ 14, 15 ], "y": 4, "rotation": 90, "chance": 33 },
        { "vehicle": "parking_garage_short", "x": [ 20, 21 ], "y": 4, "rotation": 90, "chance": 33 }
      ]
    }
  },
  {
    "type": "mapgen",
    "method": "json",
    "om_terrain": "bowling_alley_roof",
    "object": {
      "fill_ter": "t_flat_roof",
      "rows": [
        "                        ",
        "                        ",
        "                        ",
        "                        ",
        "                        ",
        "                        ",
        "                        ",
        "-----------------------5",
        "-......................-",
        "-......................-",
        "-......................-",
        "-......................-",
        "-......................-",
        "-......................-",
        "-......................-",
        "-.:....................-",
        "-.X....................-",
        "-......................-",
        "-......................-",
        "-......................-",
        "-......................-",
        "-......................-",
        "-.........=.&..........-",
        "------------------------"
      ],
      "palettes": [ "roof_palette" ],
      "place_items": [ { "item": "SUS_trash_roof", "x": [ 3, 20 ], "y": [ 9, 20 ], "chance": 50, "repeat": [ 1, 3 ] } ],
      "place_nested": [
        {
          "chunks": [
            [ "null", 20 ],
            [ "roof_2x2_utilities_b", 15 ],
            [ "roof_2x2_utilities_c", 5 ],
            [ "roof_2x2_utilities_d", 40 ],
            [ "roof_2x2_utilities", 50 ]
          ],
          "x": [ 5, 15 ],
          "y": [ 10, 15 ]
        }
      ]
    }
  }
]
