[
  {
    "type": "mapgen",
    "method": "json",
    "om_terrain": [ "bunker_shop_g" ],
    "object": {
      "fill_ter": "t_floor",
      "rows": [
        "kkkkkkkkkkkkkkkkkkkkkkkk",
        "kkkkkkkkkkkkkkkkkkkkkkkk",
        "kkkkkkkkkkkkkkkkkkkkkkkk",
        "kkaasaaGnnGnnGnnGnnoookk",
        "kkaEDDakkkkkkkkkkkkoqokk",
        "GnaEDDakkkkzkkkkkkkopokk",
        "nkaaCaakkkkkkkkAkkkktnkk",
        "nkkktttttttttttttttttnkk",
        "GkkktkkkiicjaraaaajktGkk",
        "nkkktkkkjkkkwwyakkjktnkk",
        "nttttttkjkkkww a krktnkk",
        "Gttttttkakk    a  jktGkk",
        "nttttttkaaagaaaaagaagaak",
        "nttttttka   lj    akkkak",
        "Gttttttka   ljvv  gkk sk",
        "nttttttbbd   i    akk ak",
        "nttttttbedk  iia  a   sk",
        "Gttttttbbdkk      a   ak",
        "nttttttkakkkk     iijjak",
        "nttttttFjkkkkkk   jkkkkk",
        "GBBBBBBGiijrcjgjjijkkkkk",
        "kttttttFkf  kkkkgkkkAkkk",
        "kttttttkkj   kkkjkkkkkkk",
        "kttttttkkjjrrcrjjkkkkkkk"
      ],
      "terrain": {
        "a": "t_wall_wood",
        "b": "t_rock",
        "c": "t_window_empty",
        "d": "t_rock_floor",
        "e": "t_rock_floor",
        "f": "t_door_b",
        "g": "t_door_frame",
        "h": "t_door_c",
        "i": "t_wall_wood_broken",
        "j": "t_wall_wood_chipped",
        "k": [ "t_grass", "t_grass", "t_grass", "t_dirt" ],
        "m": "t_dirt",
        "n": "t_chainfence_h",
        "o": "t_concrete_wall",
        "p": "t_door_metal_c",
        "q": "t_stairs_down",
        "r": "t_window_frame",
        "s": "t_window_boarded",
        "t": "t_dirt",
        "l": "t_floor",
        "u": "t_floor",
        "v": "t_floor",
        "w": "t_floor",
        "x": "t_wall_wood_chipped",
        "y": "t_floor",
        "z": "t_tree_plum",
        "A": "t_tree_apple",
        "B": "t_door_metal_locked",
        "C": "t_door_c",
        "D": "t_dirtfloor",
        "E": "t_dirtfloor",
        "F": "t_gates_mech_control",
        "G": "t_wall"
      },
      "furniture": {
        "e": "f_brazier",
        "m": "f_rubble",
        "l": "f_crate_o",
        "u": "f_woodstove",
        "v": "f_table",
        "w": "f_bed",
        "y": "f_dresser",
        "E": "f_locker"
      },
      "place_loot": [
        { "group": "floor_trash", "chance": 90, "repeat": 5, "x": [ 9, 12 ], "y": [ 13, 19 ] },
        { "group": "floor_trash", "chance": 90, "repeat": 5, "x": [ 13, 17 ], "y": [ 17, 19 ] },
        { "group": "floor_trash", "chance": 90, "repeat": 5, "x": [ 14, 17 ], "y": [ 13, 15 ] },
        { "group": "floor_trash", "chance": 90, "repeat": 5, "x": [ 9, 14 ], "y": [ 9, 11 ] },
        { "group": "floor_trash", "chance": 90, "repeat": 5, "x": [ 19, 21 ], "y": [ 13, 17 ] },
        { "group": "floor_trash", "chance": 90, "repeat": 5, "x": [ 10, 15 ], "y": [ 21, 22 ] },
        { "group": "floor_trash", "chance": 90, "repeat": 3, "x": [ 16, 17 ], "y": [ 9, 11 ] }
      ]
    }
  },
  {
    "type": "mapgen",
    "method": "json",
    "om_terrain": [ "bunker_shop_b" ],
    "object": {
      "fill_ter": "t_soil",
      "rows": [
        "              fff       ",
        "              fvffffff  ",
        "              fbbbbbbf  ",
        "              fbffffbf  ",
        "        fffff fbf  faf  ",
        "       fftsrf fbf  fff  ",
        "       fvbbbf fbf       ",
        "     ffffffdfffdfffff   ",
        "     fnccmfbfjubbxfvf   ",
        "     fllccbbdbbbbbebf   ",
        "     fvccofjfbbbbbfbf   ",
        "     fffffffffgggffbf   ",
        "            fjhhhbfbf   ",
        "    fffffffffbbpbbdbf   ",
        "    fviiiiivfibbbbfff   ",
        "  fffbbbbbbbfibvbwf     ",
        "  fkdbiiiiibdbbbbhf     ",
        "  fffbbbbbbbfiqqbhf     ",
        "    fviiiiivffffdff     ",
        "    ffffffffffnlcmf     ",
        "        fvbbbdclcmf     ",
        "        fftsrfcccvf     ",
        "         ffffffffff     ",
        "                        "
      ],
      "terrain": {
        "a": "t_stairs_up",
        "b": "t_thconc_floor",
        "c": "t_floor",
        "d": "t_door_metal_c",
        "e": "t_door_metal_locked",
        "f": "t_concrete_wall",
        "g": "t_reinforced_glass",
        "h": "t_thconc_floor",
        "i": "t_thconc_floor",
        "j": "t_thconc_floor",
        "k": "t_plut_generator",
        "l": "t_floor",
        "m": "t_floor",
        "n": "t_floor",
        "o": "t_floor",
        "p": "t_thconc_floor",
        "q": "t_thconc_floor",
        "r": "t_thconc_floor",
        "s": "t_thconc_floor",
        "t": "t_thconc_floor",
        "u": "t_thconc_floor",
        "v": "t_utility_light",
        "w": "t_console_broken",
        "x": "t_atm"
      },
      "furniture": {
        "h": "f_table",
        "i": "f_rack",
        "j": "f_locker",
        "l": "f_bed",
        "m": "f_dresser",
        "n": "f_table",
        "o": "f_sofa",
        "p": "f_chair",
        "q": "f_sofa",
        "r": "f_toilet",
        "s": "f_sink",
        "t": "f_shower",
        "u": "f_crate_o"
      },
      "place_loot": [
        { "group": "mil_food_nodrugs", "chance": 90, "repeat": [ 10 ], "x": [ 6, 10 ], "y": [ 18, 18 ] },
        { "group": "ammo_rifle_milspec", "chance": 90, "repeat": [ 10 ], "x": [ 6, 10 ], "y": [ 16, 16 ] },
        { "group": "camping", "chance": 90, "repeat": [ 10 ], "x": [ 6, 10 ], "y": [ 14, 14 ] },
        { "group": "allclothes", "chance": 90, "repeat": [ 4 ], "x": [ 17, 17 ], "y": [ 19, 20 ] },
        { "group": "allclothes", "chance": 90, "repeat": [ 4 ], "x": [ 9, 9 ], "y": [ 8, 8 ] },
        { "group": "book_military", "chance": 90, "repeat": [ 1 ], "x": [ 6, 6 ], "y": [ 8, 8 ] },
        { "group": "book_military", "chance": 90, "repeat": [ 1 ], "x": [ 14, 14 ], "y": [ 12, 12 ] },
        { "group": "cleaning_bulk", "chance": 90, "repeat": [ 2 ], "x": [ 11, 11 ], "y": [ 10, 10 ] },
        { "group": "cleaning_bulk", "chance": 90, "repeat": [ 2 ], "x": [ 13, 13 ], "y": [ 12, 12 ] },
        { "group": "guns_milspec", "chance": 90, "repeat": [ 2 ], "x": [ 13, 13 ], "y": [ 14, 15 ] },
        { "group": "mil_food_nodrugs", "chance": 90, "repeat": [ 5 ], "x": [ 13, 13 ], "y": [ 17, 17 ] },
        { "group": "mil_armor", "chance": 90, "repeat": [ 5 ], "x": [ 17, 17 ], "y": [ 15, 17 ] }
      ],
      "place_npcs": [ { "class": "bunker_merchant", "x": 15, "y": 13 } ]
    }
  }
]
