[
  {
    "id": "FUNERAL",
    "type": "vehicle_group",
    "vehicles": [ [ "car", 300 ], [ "hearse", 200 ], [ "suv", 100 ], [ "policecar", 50 ] ]
  },
  {
    "id": "grave_memories",
    "type": "item_group",
    "items": [
      [ "barrette", 5 ],
      [ "boots_combat", 10 ],
      [ "cassock", 1 ],
      [ "child_book", 5 ],
      [ "flask_hip", 5 ],
      [ "jedi_cloak", 1 ],
      [ "jersey", 1 ],
      [ "kittel", 1 ],
      [ "kufi", 1 ],
      [ "kippah", 1 ],
      [ "tallit_gadol", 1 ],
      { "group": "rings_and_things", "prob": 20 },
      [ "long_glove_white", 1 ],
      [ "photo_album", 15 ],
      [ "ref_lighter", 5 ],
      [ "roadmap", 3 ],
      [ "spray_can", 5 ],
      [ "story_book", 5 ],
      [ "syringe", 3 ],
      [ "tall_tales", 5 ],
      { "item": "teddy_bear", "custom-flags": [ "FILTHY" ], "damage": [ 0, 3 ], "prob": 15 },
      [ "teleumbrella", 2 ],
      [ "thawb", 1 ],
      [ "umbrella", 10 ],
      { "group": "newspaper", "prob": 20 },
      [ "survnote", 3 ],
      [ "cig_butt", 5 ],
      [ "cigar_butt", 10 ]
    ]
  },
  {
    "type": "mapgen",
    "method": "json",
    "om_terrain": [ [ "cemetery_4square_00", "cemetery_4square_10" ], [ "cemetery_4square_01", "cemetery_4square_11" ] ],
    "object": {
      "fill_ter": "t_region_soil",
      "rows": [
        "================================================",
        "=$$$$$$$$$$$$$$$$$$$$$$$$$$$$$$$$$$$$$$$$$$$$$$=",
        "=$                                            $=",
        "=$ 7 ^ ^ ^ ^ 7 ^ ^ ^ ^ SS ^ ^ ^ ^ 7 ^ ^ S ^ 7 $=",
        "=$   X X X X   X X X X    X X X X   X X X X   $=",
        "=$ ' ^ ^ ^ ^ ' ^ ^ ^ ^ '' ^ ^ ^ ^ ' ^ ^ ^ ^ ' $=",
        "=$ ' X X X X ' X X X X '' X X X X ' X X X X ' $=",
        "=$ ' ^ ^ ^ ^ ' ^ ^ ^ ^ '' ^ ^ ^ ^ ' ^ ^ ^ ^ ' $=",
        "=$ ' X X X X ' X X X X '' X X X X ' X X X X ' $=",
        "=$ ' ^ ^ ^ ^ ' ^ ^ ^ ^ '' ^ ^ ^ ^ ' ^ ^ ^ ^ ' $=",
        "=$ ' X X X X ' X X X X '' X X X X ' X X X X ' $=",
        "=$ ' ^ ^ ^ ^ ' ^ ^ ^ ^ '' ^ ^ ^ ^ ' ^ ^ S ^ ' $=",
        "=$ ' X X X X ' X X X X '' X X X X ' X X X X ' $=",
        "=$ ' ^ ^ ^ ^ ' ^ ^ ^ ^ '' ^ ^ ^ ^ ' ^ ^ M x ' $=",
        "=$ ' X X X X ' X X X X '' X X X X ' X X X X ' $=",
        "=$ ' ^ ^ ^ ^ ' ^ ^ ^ ^ '' ^ ^ ^ ^ ' ^ ^ ^ S ' $=",
        "=$ ' X X X X ' X X X X '' X X X X ' X X X X ' $=",
        "=$ ' ^ ^ ^ S ' M ^ ^ ^ '' ^ ^ ^ ^ ' ^ x ^ x ' $=",
        "=$ ' X X X X ' X X X X '' X X X X ' X X X X ' $=",
        "=$ ' ^ ^ S M ' M M ^ ^ '' ^ ^ ^ ^ ' ^ M x x ' $=",
        "=$ ' X X X X ' X X X X '' X X X X ' X X X X ' $=",
        "=$ ' ^ ^ M M ' M M ^ S '' ^ ^ ^ ^ ' ^ ^ x M ' $=",
        "=$ ' X X X X ' X X X X '' X X X X ' X X X X ' $=",
        "=$ '        &'         ''         '         ' $=",
        "=$ ''$$$$$$$$'$$$$$$$$$''$$$$$$$  '&        ' $=",
        "=$$$ssssssssssssssssssssssssssss''''''''''''' $=",
        "=$ $ssssssssssssssssssssssssssss              $=",
        "=$ $ss$$$$$ss$$$$$ss$$$$$$$$$$ss $$$$$4$$$$$$ $=",
        "=$7$ss$***$ss$***$ss$***  ***$ss $||0|||G|||$ $=",
        "=$ $ss$*7*$ss$*7*$ss$*7*  *7*$ss $|nn|.....|$ $=",
        "=$ $ss$***$ss$***$ss$***  ***$ss $G..|.....G$ $=",
        "=$ $ss$$$$$ss$$$$$ss$        $ss $G..|..n..G$ $=",
        "=$ $ssssssssssssssss$   MM   $ss S||+|.....|$ $=",
        "=$7$ssssssssssssssss$   MM   $ssss+....bbb.G$ $=",
        "=$ $y____y____y____y$        $ssss+........G$ $=",
        "=$ $y____y____y____y$***  ***$ss S|Y...bbb.|$ $=",
        "=$ $y____y____y____y$*7*  *7*$ss $G........G$ $=",
        "=$ $y__Á_y__Á_y__Á_y$***  ***$ss $G....bbb.G$ $=",
        "=$7$y____y____y____y$$$$$$$$$$ss $|........|$ $=",
        "=$ $y____y____y____y$sssssssssss $||GG||GG||$ $=",
        "=$ $________________$sssssssssss $$$$$$$$$$$$ $=",
        "=$ $________________$ss   s   s               $=",
        "=$ $________________$ss 7 s 7 s               $=",
        "=$7$________________$ss   s   s   7    7    7 $=",
        "=$ $________________$ss $iSi$iSi$             $=",
        "=$ $________________$ss $|||$|||$             $=",
        "=$$$_______$$_______$ss$$$$$$$$$$$$$$$$$$$$$$$$=",
        "====_______Pp_______=oo========================="
      ],
      "terrain": {
        "4": "t_gutter_downspout",
        " ": "t_region_groundcover_urban",
        "'": "t_region_soil",
        "+": "t_door_c",
        ".": "t_thconc_floor",
        "b": "t_thconc_floor",
        "T": "t_thconc_floor",
        "n": "t_thconc_floor",
        "Y": "t_thconc_floor",
        "_": "t_pavement",
        "Á": "t_pavement",
        "0": "t_window_domestic",
        "7": "t_region_tree_shade",
        "y": "t_pavement_y",
        "=": "t_drystone_wall_half",
        "G": [ "t_window_stained_green", "t_window_stained_red", "t_window_stained_blue" ],
        "s": "t_concrete",
        "|": "t_rock_smooth",
        "i": "t_column",
        "o": "t_chaingate_c",
        "X": "t_grave"
      },
      "furniture": {
        "*": "f_region_flower_decorative",
        "Y": "f_rack_coat",
        "&": "f_trashcan",
        "$": "f_hedge_short",
        "^": [ [ "f_grave_head", 3 ], [ "f_grave_stone", 5 ], "f_grave_stone_old", "f_statue" ],
        "M": "f_grave_monument",
        "x": "f_grave_stone_old",
        "P": "f_sign",
        "S": "f_statue",
        "b": "f_bench",
        "n": "f_slab"
      },
      "place_nested": [ { "chunks": [ [ "SEER_Brigitte_LaCroix_spawn", 20 ], [ "null", 80 ] ], "x": 42, "y": 30 } ],
      "signs": { "P": { "signage": "Closed at sunset." }, "p": { "signage": "Maintained by the <city> Church." } },
      "items": {
        "X": { "item": "grave_memories", "chance": 1 },
        "b": { "item": "church", "chance": 20 },
        "&": { "item": "SUS_trash_trashcan_public", "chance": 66, "repeat": [ 1, 3 ] },
        "Y": { "item": "jackets", "chance": 33, "repeat": [ 1, 3 ] }
      },
      "vehicles": { "Á": { "vehicle": "FUNERAL", "chance": 20, "rotation": 90 } }
    }
  },
  {
    "type": "mapgen",
    "method": "json",
    "om_terrain": [ "cemetery_4square_11_roof" ],
    "object": {
      "rows": [
        "                        ",
        "                        ",
        "                        ",
        "                        ",
        "          ----5-----    ",
        "          -........-    ",
        "          -........-    ",
        "          -........-    ",
        "          -........-    ",
        "          -........-    ",
        "          -........-    ",
        "          -........-    ",
        "          -........-    ",
        "          -........-    ",
        "          -........-    ",
        "          ----------    ",
        "                        ",
        "                        ",
        "                        ",
        "                        ",
        " ... ...                ",
        " ... ...                ",
        "                        ",
        "                        "
      ],
      "palettes": [ "roof_palette" ],
      "terrain": { ".": "t_shingle_flat_roof" }
    }
  }
]
