[
  {
    "name": "GROUP_COLLAPSED_TOWER",
    "type": "monstergroup",
    "default": "mon_null",
    "monsters": [
      { "monster": "mon_zombie_gasbag_immobile", "freq": 150, "cost_multiplier": 1 },
      { "monster": "mon_zombie", "freq": 200, "cost_multiplier": 7, "pack_size": [ 3, 5 ] },
      { "monster": "mon_zombie_gasbag_crawler", "freq": 150, "cost_multiplier": 7, "pack_size": [ 1, 2 ] },
      { "monster": "mon_zombie_gasbag_impaler", "freq": 50, "cost_multiplier": 6, "pack_size": [ 1, 4 ] }
    ]
  },
  {
    "type": "mapgen",
    "method": "json",
    "om_terrain": [
      [ "office_tower_collapse_a0", "office_tower_collapse_a1", "office_tower_collapse_a2" ],
      [ "office_tower_collapse_b0", "office_tower_collapse_b1", "office_tower_collapse_b2" ]
    ],
    "weight": 300,
    "object": {
      "fill_ter": "t_thconc_floor",
      "rows": [
        "....ssssssssssssssssssssssssssssssssssssssssssssssssssssssssssssssssssss",
        "....s........................................sssssssssssssssssssssssssss",
        "....s.zzzzzzzzzzzzzzzzzzzzzzzzzzzzzzzzzzzzzzzsssssssssssssssssssssssssss",
        "....s.z22222---22---22--2222---2222222222---zsssssssssssssssssssssssssss",
        "....s.z1CCC 4|CC l|CCC |   4 #|4          4|zsssssss##ssssssssssssssssss",
        "....s.z1C B  |||||||###|    |#|  B   B||B  1zsssssssssssssssssssssssssss",
        "....s.|||||||||   #####|||||||||||666|||6  1zssss###ssssssssssssssssssss",
        "....s.||####         ##    |  |||####|||#B ||||ssssssssssszzzzssssssssss",
        "....s|||#            #           6666666|||||##sssss##s|||||||||Bsssssss",
        "....s|z|C B  |    |C  00    |#|   B  B  B  1zs###ssssssBsz.zz z|Bsssssss",
        "....s.#|CCC l||| -|CCC |  |||#|4          4 zss|||sssssssz.zz z|ssssssss",
        "....#.z|--   | ||||----##  ||||222--33--22  zsss|||||ssBsz.zz z|Bsssssss",
        "....s.#|;w   |####|#      |###|###       B     |||sssssBszz.  z|Bsssssss",
        "...####|--   -----|   --||####|#C##### ||##1   #zsss||||sszz zssssssssss",
        "....s.#|;w    A|A     w;| ####|||||||| B  ||||   #sss|||sssssssssssssszz",
        ".##.s  |--     |      --|#####||B  ||||||| #     ~~~ss~~22222222~~ss~~~~",
        "....s.z|;w    A|A  |  w;||||##| ###    C|C||||||~~~~ss~~1##  ##1~~ss~~~~",
        "....s z||||    |##||####|  |--|         |||||3zzzz~~sszz1##  ##1zzsszzz~",
        ".||.s     |-w-----|||#|||  |      ####C   |#-22---~~{{222--22--222{{221~",
        "....s  s|||      #  ||             ##BC  #||||||   ~~   4 ???? 4      1s",
        "..||s     |---w-----|-||   -  ---- ---- ---|###     ~~                1s",
        "...|   ||||l   l|  |B B    |  |l|        ##|||     z~~    ????    zzz 1s",
        ".||||||||#|l   l|  ||66    |  | |-c----c-| |       z~~   ######   zTz |s",
        "....s.. |--- ---|#|||66    ||#|         #|#|||     zz~~~          zzz 1s",
        "....|.. |###   #||| B B    |  |l ll ll ll|l|        ~~~               1s",
        "....s..||--   --|||||      |  |l ll ll l|####rHr   z~~   >????>   zzz 1s",
        "....s..||B666B 46B || B    w  |##       | #|?rrr  ##~~   rrrrrr        s",
        ".  |||||| 666   6B |||||   w #|###llll    l#|||r###zT~~  Hr>>rH        |",
        "..    ### B  B      666||  |  ##|||||--| ##|?r|||||#~~~            ||||s",
        "..   |||#      B B  B B||| |  |##|  ###|  ##   - |||||######      ##  |s",
        "....   |# B  B 666     ||  |  w  C    ||         ~ ||||||666666  |||  |s",
        "....s||||###6  666  B##||  |  |  444424##--    r ~~ ||| 6||  B66      1s",
        "....#z|||#####   ####66 # 4|  |||||||-##     --~~    |||##    ##      1s",
        "....#||-------  |----||||||    |  |##||  ~~~~~~~-|     |||||w###      1s",
        "....s||CCC 4 C C| ||||4 B  |  ||  ||     ~~~~~~~~~~---||||||||##-    -|s",
        "....sz|C   |  BC| CCC  CCC |  |  B|     ~~--~~~~      |```|  |      4 1s",
        "....3##|||||   C|   |||||  |  | C||    ~~~~~~~~~~~    ||``|  |BC   C  1s",
        "..###z1  ||||C    CCC  CC|||  ##|||  ~~~~~     |    M||||`|  | C   C B|s",
        "....sz14 |  BC         --      #||         ||||| |M|||||||||||CC   CCC|s",
        "....#z14 ||  C        |        #||         | ##|||    w  ||  w        1s",
        "...####  ||||||||||||||CCC    ##|||        |---| |## ||||||||||      41s",
        "..|||z|C     | C|   B  B |||||||||||| |CCC||```3        >|| ||CCC  CCC|s",
        "....s  CB    |||| CCC  CC||#D |   C|||||  |#```3          |#||||C  C B|s",
        "....    CC 4 CCC||B   4##||##3      ##|||#|#```||||||#3   ||#|####### 1s",
        "....    |||--22-|||||||||||  ##     ||||||||||||||| |||  ||||||||||||||s",
        "....szzzzz|||zzzzzzz|||##|   z##     |||z||z|###zzzz1111 ||##zzzzzzzzzzs",
        "...##.......||......||....   ##...........|||.##......|||||.............",
        ".#..sssssssssssssssssssssss  3sssssssssssssssssssssssss||sssssssssssssss"
      ],
      "set": [
        { "point": "bash", "x": [ 0, 23 ], "y": [ 0, 23 ], "repeat": [ 50, 100 ] },
        { "point": "bash", "x": [ 24, 47 ], "y": [ 0, 23 ], "repeat": [ 50, 100 ] },
        { "point": "bash", "x": [ 48, 71 ], "y": [ 0, 23 ], "repeat": [ 50, 100 ] },
        { "point": "bash", "x": [ 0, 23 ], "y": [ 24, 47 ], "repeat": [ 50, 100 ] },
        { "point": "bash", "x": [ 24, 47 ], "y": [ 24, 47 ], "repeat": [ 50, 100 ] },
        { "point": "bash", "x": [ 48, 74 ], "y": [ 24, 47 ], "repeat": [ 50, 100 ] }
      ],
      "palettes": [ "collapsed_tower" ],
      "place_items": [
        { "item": "office_mess", "x": [ 8, 23 ], "y": [ 4, 23 ], "chance": 100, "repeat": [ 20, 70 ] },
        { "item": "office_mess", "x": [ 8, 23 ], "y": [ 24, 44 ], "chance": 100, "repeat": [ 30, 70 ] },
        { "item": "cleaning", "x": [ 11, 11 ], "y": [ 21, 22 ], "chance": 60 },
        { "item": "cleaning", "x": [ 15, 15 ], "y": [ 21, 22 ], "chance": 60 }
      ],
      "monster": { "M": { "monster": "mon_zombie_crushed_giant" } },
      "place_monsters": [
        { "monster": "GROUP_COLLAPSED_TOWER", "x": [ 0, 23 ], "y": [ 0, 23 ], "density": 2.5 },
        { "monster": "GROUP_COLLAPSED_TOWER", "x": [ 24, 47 ], "y": [ 0, 23 ], "density": 2.5 },
        { "monster": "GROUP_COLLAPSED_TOWER", "x": [ 48, 71 ], "y": [ 0, 23 ], "density": 2.5 },
        { "monster": "GROUP_COLLAPSED_TOWER", "x": [ 0, 23 ], "y": [ 24, 47 ], "density": 2.5 },
        { "monster": "GROUP_COLLAPSED_TOWER", "x": [ 24, 35 ], "y": [ 24, 47 ], "density": 2.5 }
      ]
    }
  },
  {
    "type": "mapgen",
    "method": "json",
    "om_terrain": [
      [ "office_tower_collapse_b_a0", "office_tower_collapse_b_a1", "office_tower_collapse_b_a2" ],
      [ "office_tower_collapse_b_b0", "office_tower_collapse_b_b1", "office_tower_collapse_b_b2" ]
    ],
    "weight": 300,
    "object": {
      "fill_ter": "t_thconc_floor",
      "rows": [
        "########################################################################",
        "#################################################|||||||||##############",
        "##################|||||||||||||||||||############|6     6|##############",
        "#########||||||||||66     666666   |#############|6    B6|##############",
        "#############                      ||||||||||||||||||+||||||||||########",
        "############      66666   666666   |##############  ###   #####|########",
        "#############                      3 #####                   ##|########",
        "##############     |      666666   3   ###~~#||||||||||||  #  #|########",
        "##############|||||||  #||||||||||#|##  ~~~~#|#####  ###|   #  |########",
        "######################  |##########|#~~~~|||||#####   ##||~ ###|########",
        "######################  |##########|~~~~~|######## ~~ |||~~~||||||||||##",
        "#######~~~~~~~~~~~~~~~~~~~~~~~~~~~##~~~~~~~~###~~~|~~~~~~~~~~~~~~~~~~###",
        "#####~~~~~~~~~~~~~~~~~~~~~~~~~~~~~#~~~~~~~###~~~~~~~~~~~~~~~~~~~~~~~####",
        "########################  ######~~##~~~##########|~~~~|##~~ ############",
        "######################   #####    ###~~~#########|~~~~|## ~ ############",
        "######################  ###############~~########|~~~~|||  ~||||||||####",
        "######################  ||||||||||#|####~~#######|~~##|  ~         |####",
        "#####||||||||||||||||| ||          |#############|~~~#|        6666|####",
        "#####|xppCCppppCCppp|| #|##  ####  |# ~~~~~######|#~~#|22{{22222222|####",
        "#####|xppppppppppppp|| #|#  ####  #|# ~#~~~######|####|        6666|####",
        "#####|222222ppY66ppp||  |##########|   # ~~~    # ~~~~##           |####",
        "#####|ppppp2pppppppp||# |||   ## ##|# ~~#~~~~~~ #~~~#          BB  |####",
        "#####|p//pp{pppppppp33# 3##| ##|   {~~~~~~~~~~~~~~~~##||||||BB#||  |####",
        "#####|ppppp2pppppppp33  3 #| # +   { ##   ########~~ #|#########   |####",
        "#####|222222ppY66ppp|| #|##|###|   |||||||||||||||~~~~|###|#   #   |####",
        "#####|xppppppppppppp||  |#|||||| ##|##########~~#|##~~|###|#   # ##|####",
        "#####|xppCCppppppppp||  |##  ##|   |#########~~~~~####||||||||||###|####",
        "#####||||||||||#pppp|| #|  # 66|# #|#~~~~~~~~~~~~~~~~#|########### |####",
        "##############|#2{{2||  +     B||  ||######~~t~~~|       ########  |####",
        "################ppppr|# |      |         ##~~~~~~|    |#    ####   |####",
        "#################pppr|33|  ####|###||   ##### ~~~||33||##         #|####",
        "###############pppppp|##||||###|  ########~~~~~~~|#      #   6#####|####",
        "################p##pR|# |######|     # ##~~~~####|#           #####|####",
        "#############|||||||||  |######|    ######~~~####|  ##|#66#########|####",
        "#####################|  |  ####|       ##~~######| ###||||||||||||||####",
        "#####################|  | #####|  ###|||   |||||||   #3ppp|#############",
        "#####################|  3    ##|   ##| 6   |###3~~    3ppp|#############",
        "####################||  |#     |     |B6   |###       |ppp|#############",
        "#####||||||||||||||||#  |######|     | 6   |||||      |||||#############",
        "##### #  |R         |#  |######|||   +     #####     #wpp||#############",
        "#########|#######  #||  |||     ##   +    #|||||     |||||||############",
        "#########|######  ## #    +      #   |#   #|ppp3     3ppp||#############",
        "#########|#######   ###   +  # ######|||###|ppp##    ||||||#############",
        "#########|########  |||||||  #||||||||#   #|ppp|##|||###################",
        "#########|##       R|#####   ########|     ||||||||#####################",
        "#########||||||||||||####### ########|    ||############################",
        "#####################################||||||#############################",
        "########################################################################"
      ],
      "set": [
        { "point": "bash", "x": [ 0, 23 ], "y": [ 0, 23 ], "repeat": [ 50, 100 ] },
        { "point": "bash", "x": [ 24, 47 ], "y": [ 0, 23 ], "repeat": [ 50, 100 ] },
        { "point": "bash", "x": [ 48, 71 ], "y": [ 0, 23 ], "repeat": [ 50, 100 ] },
        { "point": "bash", "x": [ 0, 23 ], "y": [ 24, 47 ], "repeat": [ 50, 100 ] },
        { "point": "bash", "x": [ 24, 47 ], "y": [ 24, 47 ], "repeat": [ 50, 100 ] },
        { "point": "bash", "x": [ 48, 74 ], "y": [ 24, 47 ], "repeat": [ 50, 100 ] }
      ],
      "palettes": [ "collapsed_tower" ],
      "furniture": { "R": "f_rack" },
      "terrain": {
        "C": "t_machinery_electronic",
        "x": "t_machinery_heavy",
        "?": "t_nanofab",
        "r": "t_metal_floor",
        "/": "t_nanofab_body",
        "Y": "t_thconc_floor_olight",
        "p": "t_metal_floor"
      },
      "mapping": { "r": { "item": { "item": "standard_template_construct" } }, "R": { "item": { "item": "nanomaterial" } } },
      "toilets": { ";": {  } },
      "place_items": [
        { "item": "office_mess", "x": [ 8, 23 ], "y": [ 4, 23 ], "chance": 100, "repeat": [ 20, 70 ] },
        { "item": "office_mess", "x": [ 8, 23 ], "y": [ 24, 44 ], "chance": 100, "repeat": [ 30, 70 ] },
        { "item": "cleaning", "x": [ 11, 11 ], "y": [ 21, 22 ], "chance": 60 },
        { "item": "cleaning", "x": [ 15, 15 ], "y": [ 21, 22 ], "chance": 60 }
      ],
      "place_monster": [ { "monster": "mon_tripod", "x": [ 12, 13 ], "y": [ 20, 23 ] } ],
      "monster": { " ": { "monster": "mon_zombie_living_wall", "chance": 20 } },
      "place_monsters": [
        { "monster": "GROUP_COLLAPSED_TOWER", "x": [ 0, 23 ], "y": [ 0, 15 ], "density": 2.5 },
        { "monster": "GROUP_COLLAPSED_TOWER", "x": [ 24, 47 ], "y": [ 0, 23 ], "density": 2.5 },
        { "monster": "GROUP_COLLAPSED_TOWER", "x": [ 48, 71 ], "y": [ 0, 23 ], "density": 2.5 },
        { "monster": "GROUP_COLLAPSED_TOWER", "x": [ 0, 23 ], "y": [ 37, 47 ], "density": 2.5 },
        { "monster": "GROUP_COLLAPSED_TOWER", "x": [ 24, 47 ], "y": [ 24, 47 ], "density": 2.5 },
        { "monster": "GROUP_COLLAPSED_TOWER", "x": [ 48, 71 ], "y": [ 24, 47 ], "density": 2.5 }
      ]
    }
  }
]
