[
  {
    "type": "mapgen",
    "om_terrain": [ [ "container_yard_inland_base_1" ] ],
    "object": {
      "fill_ter": "t_pavement",
      "rows": [
        "1   1   1   1   1   1   ",
        "                        ",
        "                        ",
        "                        ",
        "                        ",
        "                        ",
        "                        ",
        "                        ",
        "                        ",
        "                        ",
        "1   1   1   1   1   1   ",
        "                        ",
        "                        ",
        "                        ",
        "                        ",
        "                        ",
        "                        ",
        "                        ",
        "                        ",
        "                        ",
        "                        ",
        "                        ",
        "          v             ",
        "                        "
      ],
      "flags": [ "ALLOW_TERRAIN_UNDER_OTHER_DATA" ],
      "nested": { "1": { "chunks": [ "shipping_container" ] } },
      "vehicles": { "v": { "vehicle": "forklift_vehicles", "chance": 20, "rotation": 1 } },
      "place_monsters": [ { "monster": "GROUP_CIVILIAN", "x": [ 10, 14 ], "y": [ 22, 23 ], "chance": 1 } ]
    }
  },
  {
    "type": "mapgen",
    "om_terrain": [ [ "container_yard_inland_base_1a" ] ],
    "object": {
      "fill_ter": "t_open_air",
      "rows": [
        "1   1   1   1   1   1   ",
        "                        ",
        "                        ",
        "                        ",
        "                        ",
        "                        ",
        "                        ",
        "                        ",
        "                        ",
        "                        ",
        "1   1   1   1   1   1   ",
        "                        ",
        "                        ",
        "                        ",
        "                        ",
        "                        ",
        "                        ",
        "                        ",
        "                        ",
        "                        ",
        "                        ",
        "                        ",
        "                        ",
        "                        "
      ],
      "flags": [ "ALLOW_TERRAIN_UNDER_OTHER_DATA" ],
      "nested": { "1": { "chunks": [ "shipping_container" ] } }
    }
  },
  {
    "type": "mapgen",
    "om_terrain": [ [ "container_yard_inland_base_1b" ] ],
    "object": {
      "fill_ter": "t_open_air",
      "rows": [
        "1   1   1   1   1   1   ",
        "                        ",
        "                        ",
        "                        ",
        "                        ",
        "                        ",
        "                        ",
        "                        ",
        "                        ",
        "                        ",
        "1   1   1   1   1   1   ",
        "                        ",
        "                        ",
        "                        ",
        "                        ",
        "                        ",
        "                        ",
        "                        ",
        "                        ",
        "                        ",
        "                        ",
        "                        ",
        "                        ",
        "                        "
      ],
      "flags": [ "ALLOW_TERRAIN_UNDER_OTHER_DATA" ],
      "nested": { "1": { "chunks": [ [ "shipping_container", 6 ], [ "containers_roof", 5 ] ] } }
    }
  },
  {
    "type": "mapgen",
    "om_terrain": [ [ "container_yard_inland_base_2" ] ],
    "object": {
      "fill_ter": "t_pavement",
      "rows": [
        "1   1   1   1   1       ",
        "                    1   ",
        "                        ",
        "                        ",
        "                        ",
        "                        ",
        "                        ",
        "                        ",
        "                        ",
        "                        ",
        "1       1   1           ",
        "    1           1       ",
        "                    1   ",
        "                        ",
        "                        ",
        "                        ",
        "                        ",
        "                        ",
        "                        ",
        "                        ",
        "                        ",
        "                        ",
        "                        ",
        "                        "
      ],
      "flags": [ "ALLOW_TERRAIN_UNDER_OTHER_DATA" ],
      "nested": { "1": { "chunks": [ "shipping_container" ] } }
    }
  },
  {
    "type": "mapgen",
    "om_terrain": [ [ "container_yard_inland_base_3" ] ],
    "object": {
      "fill_ter": "t_pavement",
      "rows": [
        "1   1   1   1   1   1   ",
        "                        ",
        "                        ",
        "                        ",
        "                        ",
        "                        ",
        "                        ",
        "                        ",
        "                        ",
        "                        ",
        "1   1   1   1   1   1   ",
        "                        ",
        "                        ",
        "                        ",
        "                        ",
        "                        ",
        "                        ",
        "                        ",
        "                        ",
        "                        ",
        "                        ",
        "                        ",
        "                        ",
        "                        "
      ],
      "flags": [ "ALLOW_TERRAIN_UNDER_OTHER_DATA" ],
      "nested": { "1": { "chunks": [ [ "shipping_container", 3 ], [ "null", 1 ] ] } },
      "place_monsters": [ { "monster": "GROUP_CIVILIAN", "x": [ 10, 14 ], "y": [ 22, 23 ], "chance": 1 } ]
    }
  },
  {
    "type": "mapgen",
    "om_terrain": [ [ "container_yard_inland_base_4" ] ],
    "object": {
      "fill_ter": "t_pavement",
      "rows": [
        "1   1   1   1   1       ",
        "                    1   ",
        "                        ",
        "                        ",
        "                        ",
        "                        ",
        "                        ",
        "                        ",
        "                        ",
        "                        ",
        "1       1   1           ",
        "    1           1       ",
        "                    1   ",
        "                        ",
        "                        ",
        "                        ",
        "                        ",
        "                        ",
        "                        ",
        "                        ",
        "                        ",
        "                        ",
        "                        ",
        "                        "
      ],
      "flags": [ "ALLOW_TERRAIN_UNDER_OTHER_DATA" ],
      "nested": { "1": { "chunks": [ [ "shipping_container", 3 ], [ "null", 2 ] ] } }
    }
  },
  {
    "type": "mapgen",
    "om_terrain": [ [ "container_yard_inland_base_5" ] ],
    "object": {
      "fill_ter": "t_pavement",
      "rows": [
        "                        ",
        "                        ",
        "                        ",
        "                        ",
        "1   1   1   1   1   1   ",
        "                        ",
        "                        ",
        "                        ",
        "                        ",
        "                        ",
        "                        ",
        "                        ",
        "                        ",
        "                        ",
        "1   1   1   1   1   1   ",
        "                        ",
        "                        ",
        "                        ",
        "                        ",
        "                        ",
        "                        ",
        "                        ",
        "                        ",
        "                        "
      ],
      "flags": [ "ALLOW_TERRAIN_UNDER_OTHER_DATA" ],
      "nested": { "1": { "chunks": [ "shipping_container" ] } }
    }
  },
  {
    "type": "mapgen",
    "om_terrain": [ [ "container_yard_inland_base_5a" ] ],
    "object": {
      "fill_ter": "t_open_air",
      "rows": [
        "                        ",
        "                        ",
        "                        ",
        "                        ",
        "1   1   1   1   1   1   ",
        "                        ",
        "                        ",
        "                        ",
        "                        ",
        "                        ",
        "                        ",
        "                        ",
        "                        ",
        "                        ",
        "1   1   1   1   1   1   ",
        "                        ",
        "                        ",
        "                        ",
        "                        ",
        "                        ",
        "                        ",
        "                        ",
        "                        ",
        "                        "
      ],
      "flags": [ "ALLOW_TERRAIN_UNDER_OTHER_DATA" ],
      "nested": { "1": { "chunks": [ [ "shipping_container", 3 ], [ "containers_roof", 2 ] ] } }
    }
  },
  {
    "type": "mapgen",
    "om_terrain": [ [ "container_yard_inland_base_6" ] ],
    "object": {
      "fill_ter": "t_pavement",
      "rows": [
        "                        ",
        "                        ",
        "                        ",
        "                        ",
        "1   1   1   1   1   1   ",
        "                        ",
        "                        ",
        "                        ",
        "                        ",
        "                        ",
        "                        ",
        "                        ",
        "                        ",
        "                        ",
        "1   1   1   1   1   1   ",
        "                        ",
        "                        ",
        "                        ",
        "                        ",
        "                        ",
        "                        ",
        "                        ",
        "                        ",
        "                        "
      ],
      "flags": [ "ALLOW_TERRAIN_UNDER_OTHER_DATA" ],
      "nested": { "1": { "chunks": [ [ "shipping_container", 3 ], [ "null", 2 ] ] } }
    }
  },
  {
    "type": "mapgen",
    "om_terrain": [ [ "container_yard_inland_fence_corner" ] ],
    "object": {
      "fill_ter": "t_pavement",
      "rows": [
        ",,,,,,,,,,,,,,,,,,,,,,,,",
        ",,,,,,,,,,,,,,,,,,,,,,,,",
        ",,,,,,,,,,,,,,,,,,,,,,,,",
        ",,,,,,,,,,,,,,,,,,,,,,,,",
        ",,,,,,,,,,,,,,,,,,,,,,,,",
        ",,,,,,,,,,,,,,,,,,,,,,,,",
        ",,,,,,,,,,,,,,,,,,,,,,,,",
        ",,,,,,,,,,,,,,,,,,,,,,,,",
        ",,,,,,,,,,,,,,,,,,,,,,,,",
        ",,,,,,,,,,,,,,,,,,,,,,,,",
        ",,,,,,,,,,ffffffffffffff",
        ",,,,,,,,,,f             ",
        ",,,,,,,,,,f             ",
        ",,,,,,,,,,f             ",
        ",,,,,,,,,,f             ",
        ",,,,,,,,,,f             ",
        ",,,,,,,,,,f             ",
        ",,,,,,,,,,f             ",
        ",,,,,,,,,,f             ",
        ",,,,,,,,,,f             ",
        ",,,,,,,,,,f             ",
        ",,,,,,,,,,f             ",
        ",,,,,,,,,,f             ",
        ",,,,,,,,,,f             "
      ],
      "flags": [ "ALLOW_TERRAIN_UNDER_OTHER_DATA" ],
      "terrain": { "f": "t_chainfence", ",": "t_region_groundcover" },
      "place_monsters": [ { "monster": "GROUP_CIVILIAN", "x": [ 10, 12 ], "y": [ 10, 12 ], "chance": 1 } ]
    }
  },
  {
    "type": "mapgen",
    "om_terrain": [ [ "container_yard_inland_fence_entry" ] ],
    "object": {
      "fill_ter": "t_pavement",
      "rows": [
        ",,,,,,,,,,f         1   ",
        ",,,,,,,,,,f             ",
        ",,,,,,,,,,f 1           ",
        "fffffffffff             ",
        "  1                     ",
        "                        ",
        "                        ",
        "                        ",
        "                        ",
        "                        ",
        "      1                 ",
        "                        ",
        "                        ",
        "                        ",
        "                        ",
        "                        ",
        "                        ",
        " v                      ",
        "                        ",
        "                        ",
        "fffffffffff     v       ",
        ",,,,,,,,,,f             ",
        ",,,,,,,,,,f             ",
        ",,,,,,,,,,f             "
      ],
      "flags": [ "ALLOW_TERRAIN_UNDER_OTHER_DATA" ],
      "terrain": { "f": "t_chainfence", ",": "t_region_groundcover" },
      "place_monsters": [ { "monster": "GROUP_CIVILIAN", "x": [ 10, 12 ], "y": [ 10, 13 ], "chance": 1 } ],
      "vehicles": { "v": { "vehicle": "forklift_vehicles", "chance": 60, "rotation": 0 } },
      "nested": { "1": { "chunks": [ [ "shipping_container", 3 ], [ "null", 2 ] ] } }
    }
  },
  {
    "type": "mapgen",
    "om_terrain": [ [ "container_yard_inland_fence" ] ],
    "object": {
      "fill_ter": "t_pavement",
      "rows": [
        ",,,,,,,,,,f1            ",
        ",,,,,,,,,,f             ",
        ",,,,,,,,,,f             ",
        ",,,,,,,,,,f             ",
        ",,,,,,,,,,f             ",
        ",,,,,,,,,,f             ",
        ",,,,,,,,,,f             ",
        ",,,,,,,,,,f             ",
        ",,,,,,,,,,f             ",
        ",,,,,,,,,,f             ",
        ",,,,,,,,,,f             ",
        ",,,,,,,,,,f             ",
        ",,,,,,,,,,f             ",
        ",,,,,,,,,,f1            ",
        ",,,,,,,,,,f     v       ",
        ",,,,,,,,,,f             ",
        ",,,,,,,,,,f             ",
        ",,,,,,,,,,f             ",
        ",,,,,,,,,,f             ",
        ",,,,,,,,,,f             ",
        ",,,,,,,,,,f             ",
        ",,,,,,,,,,f             ",
        ",,,,,,,,,,f             ",
        ",,,,,,,,,,f             "
      ],
      "flags": [ "ALLOW_TERRAIN_UNDER_OTHER_DATA" ],
      "terrain": { "f": "t_chainfence", ",": "t_region_groundcover" },
      "place_monsters": [ { "monster": "GROUP_CIVILIAN", "x": [ 10, 12 ], "y": [ 4, 9 ], "chance": 1 } ],
      "vehicles": { "v": { "vehicle": "forklift_vehicles", "chance": 5, "rotation": 3 } },
      "nested": { "1": { "chunks": [ "shipping_container", "null" ] } }
    }
  },
  {
    "type": "mapgen",
    "nested_mapgen_id": "containers_roof",
    "object": {
      "mapgensize": [ 10, 10 ],
      "rows": [
        "____      ",
        "____      ",
        "____      ",
        "____      ",
        "____      ",
        "____      ",
        "____      ",
        "____      ",
        "____      ",
        "____      "
      ],
      "palettes": [ "shipping_container_nest_palette" ],
      "flags": [ "ALLOW_TERRAIN_UNDER_OTHER_DATA" ]
    }
  },
  {
    "type": "mapgen",
    "nested_mapgen_id": "shipping_container",
    "object": {
      "mapgensize": [ 10, 10 ],
      "rows": [
        "####      ",
        "#..#      ",
        "#..#      ",
        "#..#      ",
        "#..#      ",
        "#..#      ",
        "#..#      ",
        "#..#      ",
        "#..#      ",
        "#++#      "
      ],
      "palettes": [ "shipping_container_nest_palette" ],
      "flags": [ "ALLOW_TERRAIN_UNDER_OTHER_DATA" ],
      "place_nested": [ { "chunks": [ "containers_roof" ], "x": 0, "y": 0, "z": 1, "neighbors": { "above": "open_air" } } ]
    }
  }
]
