[
  {
    "type": "mapgen",
    "method": "json",
    "om_terrain": [ "cs_internet_cafe" ],
    "weight": 1000,
    "object": {
      "fill_ter": "t_floor",
      "rows": [
        "  ssssssssssssssssssss  ",
        "  ##gggggg#GG#gggggg##  ",
        "  #ccccccc,,,,ccccccc#  ",
        "  #c,,,,,,,,,,,,,,,,c#  ",
        "  #c,,,,,cCccCc,,,,,c#  ",
        "  #,,,,,cc,,h,cc,,,,,#  ",
        "  #,,,,,P,h||,,P,,,,,#  ",
        "  #V,,,,cc,,,,cc,,,,A#  ",
        "  #V,,,,,cccccc,,,,,A#  ",
        "  #,,,,,,,,,,,,,,,,,,#  ",
        "  #|,,,|||,,,,|||,,,|#  ",
        "  #Ph,hP|Ph,,hP|Ph,hP#  ",
        "  #|,,,||||,,||||,,,|#  ",
        "  #Ph,hP|<D,,DL|Ph,hP#  ",
        "  #|,,,|||||D||||,,,|#  ",
        "  #Ph,hP|S....S|Ph,hP#  ",
        "  #|,,,||||..||||,,,|#  ",
        "  #Ph,hP|tD..Dt|Ph,hP#  ",
        "  #|,,,||||..||||,,,|#  ",
        "  #Ph,hP|tD..Dt|Ph,hP#  ",
        "  #|,,,||||..||||,,,|#  ",
        "  #Ph,hP|tD..Dt|Ph,hP#  ",
        "  ####################  ",
        "   4                    "
      ],
      "palettes": [ "parametrized_linoleum_palette", "parametrized_walls_palette" ],
      "terrain": {
        " ": "t_region_groundcover_urban",
        ",": "t_floor",
        ".": { "param": "linoleum_color", "fallback": "t_linoleum_gray" },
        "t": { "param": "linoleum_color", "fallback": "t_linoleum_gray" },
        "S": { "param": "linoleum_color", "fallback": "t_linoleum_gray" },
        "s": "t_sidewalk",
        "D": "t_door_c",
        "g": "t_wall_glass_alarm",
        "G": "t_door_glass_c",
        "<": "t_stairs_up",
        "4": "t_gutter_downspout"
      },
      "furniture": {
        "A": "f_atm_off",
        "P": "f_console_broken",
        "c": "f_displaycase",
        "C": "f_counter",
        "t": "f_toilet",
        "h": "f_chair",
        "S": "f_sink",
        "L": "f_locker"
      },
      "toilets": { "t": { "//": "no values needed here" } },
      "vendingmachines": { "V": { "item_group": "ic_merch_vending", "lootable": true } },
      "items": {
        "c": { "item": "ic_merch", "chance": 20 },
        "C": { "item": "cash_register_random", "chance": 100 },
        "L": { "item": "cleaning", "chance": 100 }
      },
      "add": [ { "item": "mop", "x": [ 11, 12 ], "y": [ 17, 20 ], "chance": 2 } ]
    }
  },
  {
    "type": "mapgen",
    "method": "json",
    "om_terrain": "cs_internet_cafe_roof",
    "object": {
      "fill_ter": "t_thconc_floor",
      "rows": [
        "                        ",
        "  --------------------  ",
        "  -..................-  ",
        "  -..................-  ",
        "  -..................-  ",
        "  -..................-  ",
        "  -........=.........-  ",
        "  -.#######ggg##.....-  ",
        "  -.#kkk#cPcccP#.....-  ",
        "  -.#kkk#,,Y,,cg.....-  ",
        "  -.#,,,#,,,,,y#.....-  ",
        "  -.##D####D####.....-  ",
        "  -.#L,,,,,,,CC#.....-  ",
        "  -.#r,,,>,,,,Cg.....-  ",
        "  -.#r,,,,,,,,r#.....-  ",
        "  -.####g#Dg####.....-  ",
        "  -....AA............-  ",
        "  -..................-  ",
        "  -..................-  ",
        "  -.......&..........-  ",
        "  -..................-  ",
        "  -..................-  ",
        "  -5------------------  ",
        "                        "
      ],
      "palettes": [ "roof_palette", "parametrized_walls_palette" ],
      "terrain": { ",": "t_thconc_floor", "D": "t_door_locked", "g": "t_wall_glass_alarm", "&": "t_flat_roof", "=": "t_flat_roof" },
      "furniture": { "P": "f_console_broken", "k": "f_generator_broken" },
      "place_loot": [ { "item": "television", "x": 14, "y": 9, "chance": 100 }, { "item": "stepladder", "x": 5, "y": 10, "chance": 100 } ],
      "items": {
        "c": { "item": "electronics", "chance": 40 },
        "r": { "item": "ic_merch", "chance": 70, "repeat": [ 1, 2 ] },
        "C": { "item": "ic_merch_vending", "chance": 70, "repeat": [ 2, 4 ] },
        "L": { "item": "cleaning", "chance": 60, "repeat": [ 2, 4 ] }
      },
      "place_nested": [
        {
          "chunks": [
            [ "null", 20 ],
            [ "roof_2x2_utilities_b", 15 ],
            [ "roof_2x2_utilities_c", 5 ],
            [ "roof_2x2_utilities_d", 40 ],
            [ "roof_2x2_utilities", 20 ],
            [ "roof_3x3_wine", 10 ]
          ],
          "x": [ 3, 15 ],
          "y": [ 3, 4 ]
        },
        {
          "chunks": [
            [ "null", 20 ],
            [ "roof_4x4_party", 15 ],
            [ "roof_6x6_survivor", 5 ],
            [ "roof_4x4_utility", 40 ],
            [ "roof_4x4_utility_1", 30 ]
          ],
          "x": 13,
          "y": 16
        }
      ]
    }
  },
  {
    "type": "mapgen",
    "method": "json",
    "om_terrain": "cs_internet_cafe_upper_roof",
    "object": {
      "fill_ter": "t_tar_flat_roof",
      "rows": [
        "                        ",
        "                        ",
        "                        ",
        "                        ",
        "                        ",
        "                        ",
        "                        ",
        "    ............        ",
        "    ............        ",
        "    ........X...        ",
        "    ............        ",
        "    ............        ",
        "    ............        ",
        "    ............        ",
        "    ...:........        ",
        "    ............        ",
        "                        ",
        "                        ",
        "                        ",
        "                        ",
        "                        ",
        "                        ",
        "                        ",
        "                        "
      ],
      "palettes": [ "roof_palette" ],
      "terrain": { ".": "t_tar_flat_roof", "X": "t_tar_flat_roof", ":": "t_tar_flat_roof" }
    }
  }
]
