[
  {
    "type": "mapgen",
    "method": "json",
    "om_terrain": "cs_market_small",
    "object": {
      "fill_ter": "t_sidewalk",
      "rows": [
        "                        ",
        "                        ",
        "          bTTb          ",
        "          bTTb          ",
        "          bTTb          ",
        "            g           ",
        "                        ",
        "          GYYG          ",
        "          GGGG          ",
        "          G!!G          ",
        "          GGGG          ",
        "          GYYG          ",
        "           BB           ",
        "                        ",
        "          bTTb          ",
        "          bTTb          ",
        "          bTTb          ",
        "            g           ",
        "                        ",
        "                        ",
        "                        ",
        "                        ",
        "                        ",
        "                        "
      ],
      "palettes": [ "open_air_market_palette" ],
      "terrain": { "Y": "t_tree", "A": "t_atm", "G": "t_region_groundcover_urban", "!": "t_region_groundcover_urban" },
      "furniture": { "T": "f_table", "b": "f_bench", "g": "f_trashcan", "B": "f_bulletin", "!": "f_region_flower" },
      "items": { "g": { "item": "trash", "chance": 50, "repeat": [ 1, 4 ] }, "B": { "item": "bulletin_public", "chance": 75 } },
      "place_nested": [
        { "chunks": [ { "param": "topleft_market_variant_nests", "fallback": "market_meat" } ], "x": 1, "y": 1 },
        { "chunks": [ { "param": "topright_market_variant_nests", "fallback": "market_clothes" } ], "x": 16, "y": 1 },
        { "chunks": [ { "param": "bottomleft_market_variant_nests", "fallback": "market_meat" } ], "x": 1, "y": 11 },
        {
          "chunks": [ { "param": "bottomright_market_variant_nests", "fallback": "market_clothes" } ],
          "x": 16,
          "y": 11
        },
        { "chunks": [ { "param": "bottom_market_variant_nests", "fallback": "market_storage" } ], "x": 5, "y": 11 }
      ]
    }
  },
  {
    "type": "mapgen",
    "method": "json",
    "nested_mapgen_id": "market_meat",
    "object": {
      "mapgensize": [ 6, 6 ],
      "rows": [
        "cccccc",
        "cf   t",
        "C    d",
        "cf   d",
        "cf H d",
        "cccccc"
      ],
      "furniture": { "H": "f_hanging_meathook" },
      "item": { "h": { "item": "" } },
      "items": {
        "t": { "item": "cash_register_random", "chance": 80 },
        "d": { "item": "butcher_meat", "chance": 25, "repeat": [ 1, 2 ] },
        "f": { "item": "butcher_raw_meat", "chance": 25, "repeat": [ 1, 2 ] },
        "H": { "item": "butcher_raw_meat", "chance": 25, "repeat": [ 1, 2 ] }
      },
      "palettes": [ "open_air_stall_palette" ]
    }
  },
  {
    "type": "mapgen",
    "method": "json",
    "nested_mapgen_id": "market_grocery",
    "object": {
      "mapgensize": [ 6, 6 ],
      "rows": [
        "cccccc",
        "cT   t",
        "C    d",
        "cT   d",
        "cT   d",
        "cccccc"
      ],
      "items": {
        "t": { "item": "cash_register_random", "chance": 100 },
        "T": { "item": "fresh_produce", "chance": 30, "repeat": [ 1, 2 ] },
        "d": { "item": "produce", "chance": 30, "repeat": [ 1, 4 ] }
      },
      "palettes": [ "open_air_stall_palette" ]
    }
  },
  {
    "type": "mapgen",
    "method": "json",
    "nested_mapgen_id": "market_fish",
    "object": {
      "mapgensize": [ 6, 6 ],
      "rows": [
        "cccccc",
        "cr   t",
        "C    d",
        "cr   d",
        "cr   d",
        "cccccc"
      ],
      "liquids": { "d": { "liquid": "water", "amount": [ 12, 60 ] } },
      "items": {
        "t": { "item": "cash_register_random", "chance": 100 },
        "d": [ { "item": "fresh_fish", "chance": 50 } ],
        "r": { "item": "fish_market_stall", "chance": 30, "repeat": [ 1, 2 ] }
      },
      "palettes": [ "open_air_stall_palette" ]
    }
  },
  {
    "type": "mapgen",
    "method": "json",
    "nested_mapgen_id": "market_confectionery",
    "object": {
      "mapgensize": [ 6, 6 ],
      "rows": [
        "ccccc ",
        "cr  t ",
        "cr  d ",
        "C   d ",
        "cr  d ",
        "ccccc "
      ],
      "items": {
        "t": { "item": "cash_register_random", "chance": 100 },
        "r": { "item": "CANDY BOXES", "chance": 30, "repeat": [ 1, 2 ] },
        "d": { "item": "LOOSE CANDY", "chance": 30, "repeat": [ 1, 2 ] }
      },
      "palettes": [ "open_air_stall_palette" ]
    }
  },
  {
    "type": "mapgen",
    "method": "json",
    "nested_mapgen_id": "market_bees",
    "object": {
      "mapgensize": [ 4, 4 ],
      "rows": [
        "cccc",
        "cr t",
        "C  d",
        "cccc"
      ],
      "items": {
        "t": { "item": "cash_register_random", "chance": 100 },
        "r": { "item": "HONEY", "chance": 30, "repeat": [ 1, 2 ] },
        "d": { "item": "HONEY", "chance": 30, "repeat": [ 1, 2 ] }
      },
      "palettes": [ "open_air_stall_palette" ],
      "//": "Give small chance to spawn mutated/normal bees?"
    }
  },
  {
    "type": "mapgen",
    "method": "json",
    "nested_mapgen_id": "market_clothes",
    "object": {
      "mapgensize": [ 7, 7 ],
      "rows": [
        "ccccccc",
        "      c",
        " MRKJZc",
        "      C",
        " MRTIUc",
        "      c",
        " cccccc"
      ],
      "furniture": {
        "K": "f_clothing_rail",
        "J": "f_clothing_rail",
        "Z": "f_clothing_rail",
        "U": "f_clothing_rail",
        "T": "f_clothing_rail"
      },
      "items": {
        "t": { "item": "cash_register_random", "chance": 100 },
        "R": { "item": "clothes", "chance": 30, "repeat": [ 1, 2 ] },
        "M": { "item": "SUS_mannequin_general", "chance": 30, "repeat": [ 1, 2 ] },
        "K": { "item": "coats_unisex", "chance": 50 },
        "J": [ { "item": "shoes_unisex", "chance": 60 }, { "item": "shoes_womens", "chance": 20 } ],
        "Z": [ { "item": "shirts_unisex", "chance": 60 }, { "item": "shirts_womens", "chance": 25 } ],
        "U": { "item": "underwear_mens", "chance": 65 },
        "I": { "item": "underwear_womens", "chance": 65 },
        "T": [ { "item": "gloves_unisex", "chance": 65 }, { "item": "scarfs_unisex", "chance": 40 } ]
      },
      "palettes": [ "open_air_stall_palette" ]
    }
  },
  {
    "type": "mapgen",
    "method": "json",
    "nested_mapgen_id": "market_botanical",
    "object": {
      "mapgensize": [ 5, 5 ],
      "rows": [
        "ccccc",
        "ppppc",
        "    C",
        "ppppc",
        "ccccc"
      ],
      "furniture": { "p": "f_planter_harvest" },
      "items": { "t": { "item": "cash_register_random", "chance": 100 }, "f": { "item": "FLOWERS", "chance": 30, "repeat": [ 1, 2 ] } },
      "palettes": [ "open_air_stall_palette" ]
    }
  },
  {
    "type": "mapgen",
    "method": "json",
    "nested_mapgen_id": "market_misc",
    "object": {
      "mapgensize": [ 7, 7 ],
      "rows": [
        "ccccccc",
        " rrrrrc",
        "      c",
        " rrrrrc",
        "      c",
        " rrrrrc",
        "ccccccc"
      ],
      "items": { "t": { "item": "cash_register_random", "chance": 100 } },
      "place_items": [ { "chance": 50, "repeat": [ 1, 3 ], "item": "recycle_electronic", "x": [ 1, 5 ], "y": [ 5, 5 ] } ],
      "palettes": [ "open_air_stall_palette" ]
    }
  },
  {
    "type": "mapgen",
    "method": "json",
    "nested_mapgen_id": "market_storage",
    "object": {
      "mapgensize": [ 12, 12 ],
      "rows": [
        "            ",
        "            ",
        "            ",
        "            ",
        "            ",
        "            ",
        "            ",
        "            ",
        "            ",
        "            ",
        "            ",
        "            "
      ]
    }
  },
  {
    "type": "mapgen",
    "method": "json",
    "nested_mapgen_id": "community_center",
    "object": {
      "mapgensize": [ 12, 12 ],
      "rows": [
        "            ",
        "            ",
        "            ",
        "            ",
        "            ",
        "            ",
        "            ",
        "            ",
        "            ",
        "            ",
        "            ",
        "            "
      ]
    }
  }
]
