[
  {
    "type": "mapgen",
    "method": "json",
    "om_terrain": [ "diary_farm_NW" ],
    "weight": 250,
    "object": {
      "rows": [
        "........................",
        ".$$$$$$$$$$$$$$$$$$$$$$$",
        ".$......................",
        ".$......................",
        ".$.................... .",
        ".$......................",
        ".$......................",
        ".$......................",
        ".$......................",
        ".$......................",
        ".$......................",
        ".$......................",
        ".$......................",
        ".$......................",
        ".$......................",
        ".$......................",
        ".$......................",
        ".$................... ..",
        ".$................... ..",
        ".$................... ..",
        ".$..................... ",
        ".$......................",
        ".$......................",
        ".$......................"
      ],
      "terrain": {
        " ": "t_grass",
        "$": "t_chainfence_v",
        ".": "t_grass"
      },
      "place_monster": [
        { "monster": "mon_cow", "x": 7, "y": 4 },
        { "monster": "mon_cow", "x": 14, "y": 4 },
        { "monster": "mon_cow", "x": 19, "y": 6 },
        { "monster": "mon_cow", "x": 9, "y": 10 },
        { "monster": "mon_cow", "x": 11, "y": 10 },
        { "monster": "mon_cow", "x": 17, "y": 11 },
        { "monster": "mon_cow", "x": 7, "y": 12 },
        { "monster": "mon_cow", "x": 9, "y": 14 },
        { "monster": "mon_cow", "x": 13, "y": 16 },
        { "monster": "mon_cow", "x": 6, "y": 17 },
        { "monster": "mon_cow", "x": 8, "y": 18 },
        { "monster": "mon_cow", "x": 13, "y": 18 }
      ]
    }
  },
  {
    "type": "mapgen",
    "method": "json",
    "om_terrain": [ "diary_farm_NE" ],
    "weight": 250,
    "object": {
      "rows": [
        "........................",
        "$$$$$$$$$$$$$$$$$$$$$$$.",
        "......................$.",
        "......................$.",
        "......................$.",
        "......................$.",
        "......................$.",
        "......................$.",
        "......................$.",
        "......................$.",
        "......................$.",
        "......................$.",
        "......................$.",
        "......................$.",
        "......................$.",
        "......................$.",
        "......................$.",
        "......................$.",
        "......................$.",
        "......................$.",
        "......................$.",
        "......................$.",
        "......................$.",
        "......................$."
      ],
      "terrain": {
        "$": "t_chainfence_v",
        ".": "t_grass"
      },
      "place_monster": [
        { "monster": "mon_cow", "x": 5, "y": 5 },
        { "monster": "mon_cow", "x": 16, "y": 5 },
        { "monster": "mon_cow", "x": 8, "y": 6 },
        { "monster": "mon_cow", "x": 13, "y": 9 },
        { "monster": "mon_cow", "x": 5, "y": 10 },
        { "monster": "mon_cow", "x": 8, "y": 13 },
        { "monster": "mon_cow", "x": 4, "y": 18 },
        { "monster": "mon_cow", "x": 11, "y": 18 }
      ]
    }
  },
  {
    "type": "mapgen",
    "method": "json",
    "om_terrain": [ "diary_farm_SE" ],
    "weight": 250,
    "object": {
      "rows": [
        "......................$.",
        "......................$.",
        "......................$.",
        ".|*|+|*|....|*|+|*|...$.",
        ".|_____|....|_____|...$.",
        ".|O%_%O|....|_____|...$.",
        ".*O%_%O*....*_____*...$.",
        ".|O%_%O|....|_____|...$.",
        ".|O%_%O|....|_____|...$.",
        ".|O%_%O|....|_____|...$.",
        ".*O%_%O*....*_____*...$.",
        ".|O%_%O|....|_____|...$.",
        ".|O%_%O|....|_____|...$.",
        ".|O%_%O|....|_____|...$.",
        ".*O%_%O*....*_____*...$.",
        ".|O%_%O|....|_____|...$.",
        ".|O%_%O|....|_____|...$.",
        ".|O%_%O|....|_____|...$.",
        ".|OOOOO|....|_____|...$.",
        ".|*|||*|....|*|||*|...$.",
        "......................$.",
        "......................$.",
        "$$$$$$$$$$$$$$$$$$$$$$$.",
        "........................"
      ],
      "terrain": {
        "$": "t_chainfence_v",
        "%": "t_milking_machine",
        "*": "t_window_bars",
        "+": "t_door_o",
        ".": "t_grass",
        "O": "t_bulk_tank",
        "_": "t_floor",
        "|": "t_wall"
      }
    }
  },
  {
    "type": "mapgen",
    "method": "json",
    "om_terrain": [ "diary_farm_SW" ],
    "weight": 250,
    "object": {
      "fill_ter": "t_floor",
      "rows": [
        ".$......................",
        ".$......................",
        ".$......................",
        ".$......................",
        ".$......................",
        ".$......................",
        ".$......................",
        ".$......................",
        ".$......................",
        ".$...||*||+||*||||......",
        ".$...|A{{_______{|......",
        ".$...|w_________{*......",
        ".$...*______HHH__|......",
        ".$...|__||'||||'||......",
        ".$...|__|g_dd|t_c|O.....",
        ".$...||'|__C_|C_c|X.....",
        ".$...|_&|D_##|T_o*X.....",
        ".$...*bs|D_##|_F&|......",
        ".$...||||*|*||+|||......",
        ".$........aa............",
        ".$......................",
        ".$......................",
        ".$$$$$$$$$$$$$$$$$$fffff",
        "........................"
      ],
      "terrain": {
        "$": "t_chainfence_v",
        "'": "t_door_o",
        "*": "t_window_domestic",
        "+": "t_door_locked_interior",
        ".": "t_grass",
        "_": "t_floor",
        "f": "t_door_metal_c",
        "|": "t_wall"
      },
      "furniture": {
        "#": "f_bed",
        "&": "f_sink",
        "A": "f_armchair",
        "C": "f_chair",
        "D": "f_dresser",
        "F": "f_fridge",
        "H": "f_sofa",
        "O": "f_crate_o",
        "T": "f_table",
        "X": "f_crate_c",
        "a": "f_dumpster",
        "b": "f_toilet",
        "c": "f_cupboard",
        "d": "f_desk",
        "g": "f_gunsafe_ml",
        "o": "f_oven",
        "s": "f_shower",
        "t": "f_trashcan",
        "w": "f_washer",
        "{": "f_bookcase"
      },
      "place_items": [
        { "item": "bed", "x": 12, "y": 16, "chance": 70 },
        { "item": "bed", "x": 11, "y": 17, "chance": 90 },
        { "item": "bed", "x": 13, "y": 16, "chance": 60 },
        { "item": "drugs_heal_simple", "x": 7, "y": 16, "chance": 90 },
        { "item": "homebooks", "x": 8, "y": 10, "chance": 80 },
        { "item": "homebooks", "x": 17, "y": 12, "chance": 80 },
        { "item": "homebooks", "x": 17, "y": 13, "chance": 80 },
        { "item": "clothing_outdoor_set", "x": 9, "y": 16, "chance": 90 },
        { "item": "fridge", "x": 15, "y": 17, "chance": 90 },
        { "item": "fridge", "x": 15, "y": 17, "chance": 90 },
        { "item": "everyday_gear", "x": 14, "y": 16, "chance": 80 },
        { "item": "book_survival", "x": 7, "y": 10, "chance": 50 },
        { "item": "supplies_farming", "x": 18, "y": 16, "chance": 80 },
        { "item": "supplies_farming", "x": 18, "y": 14, "chance": 90 },
        { "item": "tools_home", "x": 18, "y": 15, "chance": 80 },
        { "item": "tools_home", "x": 16, "y": 10, "chance": 90 },
        { "item": "livingroom", "x": 14, "y": 12, "chance": 80 },
        { "item": "kitchen", "x": 16, "y": 16, "chance": 90 },
        { "item": "tools_mechanic", "x": 16, "y": 11, "chance": 80 },
        { "item": "knifeblock", "x": 16, "y": 14, "chance": 90 },
        { "item": "cannedfood", "x": 16, "y": 15, "chance": 90 },
        { "item": "guns_rifle_common", "x": 9, "y": 14, "chance": 50 },
        { "item": "clothing_work_set", "x": 9, "y": 17, "chance": 90 }
      ],
      "place_vehicles": [
        { "vehicle": "cube_van_cheap", "x": 7, "y": 5, "chance": 50, "fuel": 300, "status": -1, "rotation": 0 },
        { "vehicle": "quad_bike", "x": 15, "y": 6, "chance": 30, "fuel": 200, "status": -1, "rotation": 0 },
        { "vehicle": "bicycle", "x": 13, "y": 8, "chance": 80, "fuel": 0, "status": 0, "rotation": 0 }
      ]
    }
  }
]
