[
  {
    "type": "mapgen",
    "method": "json",
    "om_terrain": [ "dojo" ],
    "weight": 1000,
    "object": {
      "fill_ter": "t_floor",
      "rows": [
        "  x-------ssss-------x  ",
        "  x,-----,sxxs,-----,x  ",
        "  x,-----,sxxs,-----,x  ",
        "  x,---Á-,sxxs,---Á-,x  ",
        "  x,-----,sxxs,-----,x  ",
        "  p,-----,ssss,-----,p  ",
        "  |gggggggg++gggggggg|  ",
        " p|y................y|p ",
        " p|.################.|p ",
        " p|.################.|p ",
        "  |.################.|  ",
        " p|.################.|p ",
        " p|.################.|p ",
        " p|.################.|p ",
        "  |.################.|  ",
        " p|.################.|p ",
        " 4|y................y|p ",
        " p|||||||||||''|||||||p ",
        "  |LLLLLLLLL|..|.DC.y|  ",
        " p|.........'..|.DDD.|p ",
        " p|BBB...BBB|..'.C.C.|p ",
        " p||||...||||'||.....|p ",
        "  |S_'.y.'_T|.<|XXXXX|  ",
        "  ||||||||||||||||||||  "
      ],
      "terrain": {
        " ": "t_region_groundcover_urban",
        "x": "t_region_groundcover_urban",
        "p": "t_bamboo_long",
        "'": "t_door_c",
        "+": "t_door_glass_c",
        ",": "t_pavement_y",
        "-": "t_pavement",
        "Á": "t_pavement",
        ".": "t_floor",
        "_": "t_linoleum_gray",
        "S": "t_linoleum_gray",
        "T": "t_linoleum_gray",
        "g": "t_wall_glass",
        "s": "t_sidewalk",
        "4": "t_gutter_downspout",
        "|": "t_wall_b",
        "<": "t_stairs_up"
      },
      "furniture": {
        "y": [ "f_indoor_plant", "f_indoor_plant_y" ],
        "#": "f_tatami",
        "B": "f_bench",
        "C": "f_chair",
        "D": "f_desk",
        "L": "f_locker",
        "S": "f_shower",
        "X": "f_rack",
        "x": "f_region_flower_decorative"
      },
      "toilets": { "T": {  } },
      "place_items": [
        { "item": "gi", "x": [ 3, 11 ], "y": [ 18, 18 ], "chance": 80, "repeat": [ 5, 8 ] },
        { "item": "judo_belts", "x": [ 3, 11 ], "y": [ 18, 18 ], "chance": 80, "repeat": [ 1, 2 ] },
        { "item": "dojo_manuals", "x": [ 17, 19 ], "y": [ 19, 19 ], "chance": 80, "repeat": [ 1, 2 ] }
      ],
      "place_item": [ { "item": "judo_belt_black", "x": 17, "y": 18 } ],
      "place_monster": [
        { "monster": "mon_zombie_tough", "x": [ 9, 12 ], "y": [ 16, 19 ], "repeat": [ 1, 2 ] },
        { "monster": "mon_zombie", "x": [ 5, 12 ], "y": [ 8, 16 ], "repeat": [ 2, 3 ] }
      ],
      "vehicles": { "Á": { "vehicle": "parking_garage_short", "chance": 20, "rotation": 90 } }
    }
  },
  {
    "type": "mapgen",
    "method": "json",
    "om_terrain": "dojo_roof",
    "object": {
      "fill_ter": "t_flat_roof",
      "rows": [
        "                        ",
        "                        ",
        "                        ",
        "                        ",
        "                        ",
        "                        ",
        "  |2222222222222222223  ",
        "  |..................3  ",
        "  |..................3  ",
        "  |...oooooooooooo...3  ",
        "  |...oooooooooooo...3  ",
        "  |...oooooooooooo...3  ",
        "  |...oooooooooooo...3  ",
        "  |...oooooooooooo...3  ",
        "  |..................3  ",
        "  |..................3  ",
        "  5..................3  ",
        "  |..................3  ",
        "  |..................3  ",
        "  |..................3  ",
        "  |.........#####+####  ",
        "  |........4#******Sx#  ",
        "  |.........#*>*SS**x#  ",
        "  |---------##########  "
      ],
      "palettes": [ "roof_palette" ],
      "terrain": {
        ">": "t_stairs_down",
        "#": "t_wall_b",
        "*": "t_thconc_floor",
        "S": "t_thconc_floor",
        "x": "t_thconc_floor",
        "+": "t_door_c"
      },
      "furniture": {
        "S": "f_filing_cabinet",
        "x": [ "f_machinery_light", "f_machinery_heavy", "f_machinery_old", "f_machinery_electronic" ]
      },
      "items": { "t": { "item": "office_paper", "chance": 25, "repeat": [ 2, 4 ] } },
      "place_nested": [
        {
          "chunks": [
            [ "null", 20 ],
            [ "roof_2x2_utilities_b", 15 ],
            [ "roof_2x2_utilities_c", 5 ],
            [ "roof_2x2_utilities_d", 40 ],
            [ "roof_2x2_utilities", 50 ]
          ],
          "x": [ 4, 15 ],
          "y": 15
        }
      ]
    }
  },
  {
    "type": "mapgen",
    "method": "json",
    "om_terrain": "dojo_upper_roof",
    "object": {
      "fill_ter": "t_flat_roof",
      "rows": [
        "                        ",
        "                        ",
        "                        ",
        "                        ",
        "                        ",
        "                        ",
        "                        ",
        "                        ",
        "                        ",
        "                        ",
        "                        ",
        "                        ",
        "                        ",
        "                        ",
        "                        ",
        "                        ",
        "                        ",
        "                        ",
        "                        ",
        "                        ",
        "            2222222222  ",
        "            5........3  ",
        "            |......:.3  ",
        "            |--------3  "
      ],
      "palettes": [ "roof_palette" ]
    }
  },
  {
    "type": "mapgen",
    "method": "json",
    "om_terrain": [ "dojo_1" ],
    "weight": 1000,
    "object": {
      "fill_ter": "t_floor",
      "rows": [
        "           sss          ",
        "  |||||||||!s!||||||||| ",
        "  |LBB|S,S|sss|S,S|BBL| ",
        "  |L,B|S,S|sss|S,S|B,L| ",
        "  |L,B||'||sss||'||B,L|0",
        "  |L,,,,,,|sss|,,,,,,L| ",
        "  ||||'||||sss||||'|||| ",
        " !!sssssssssssssssssss!!",
        " !sssssssssssssssssssss!",
        " ! 1z z1s#######s1z 1  !",
        " !  1 1 s#######s1 1z1 !",
        " ! z  z s#######sz   z !",
        " ! 1 z1 s#######s 1zx1 !",
        " ! 1 1z s#######s11  z !",
        " !  z  1s#######s 1z 1 !",
        " !!z 1z1s#######s 1 z !!",
        " z||OO||sssssssss||OO||z",
        "  |..h.|||||'||||||.@@| ",
        "  |.DDD.|....|hth.'..d| ",
        " z|.h.h.'....'....||'|| ",
        " 0|.....'....',,,,',,T| ",
        " z|bbXbb|...<|eEcc|ULS| ",
        "  ||||||||||||||||||||| ",
        "                        "
      ],
      "terrain": {
        " ": "t_region_groundcover_urban",
        "1": "t_region_groundcover_urban",
        "x": "t_region_groundcover_urban",
        "z": [ "t_bamboo", "t_bamboo_long", "t_bamboo_tall", "t_region_groundcover_urban" ],
        "#": "t_region_soil",
        "'": "t_door_c",
        ".": "t_floor",
        ",": "t_linoleum_white",
        "B": "t_linoleum_white",
        "c": "t_linoleum_white",
        "E": "t_linoleum_white",
        "e": "t_linoleum_white",
        "U": "t_linoleum_white",
        "L": "t_linoleum_white",
        "S": "t_linoleum_white",
        "T": "t_linoleum_white",
        "O": "t_window_domestic",
        "g": "t_wall_glass",
        "|": "t_wall_g",
        "!": "t_wall_log",
        "s": "t_concrete",
        "<": "t_stairs_up",
        "0": "t_gutter_downspout"
      },
      "furniture": {
        "#": "f_tatami",
        "b": "f_bookcase",
        "d": "f_dresser",
        "e": "f_fridge",
        "E": "f_woodstove",
        "c": "f_cupboard",
        "t": "f_table",
        "h": "f_chair",
        "@": "f_bed",
        "B": "f_bench",
        "C": "f_chair",
        "D": "f_desk",
        "L": "f_locker",
        "U": "f_sink",
        "S": "f_shower",
        "X": "f_rack",
        "1": "f_region_flower_decorative",
        "x": "f_birdbath"
      },
      "toilets": { "T": {  } },
      "items": {
        "b": { "item": "dojo_manuals", "chance": 45, "repeat": [ 1, 2 ] },
        "X": { "item": "judo_belts", "chance": 100 },
        "L": { "item": "gi", "chance": 80, "repeat": [ 5, 8 ] },
        "d": { "item": "dresser", "chance": 40, "repeat": [ 1, 3 ] },
        "e": { "item": "SUS_fridge_breakroom", "chance": 70 },
        "E": { "item": "oven", "chance": 75, "repeat": [ 1, 2 ] },
        "@": { "item": "bed", "chance": 20, "repeat": [ 1, 2 ] },
        "c": { "item": "cannedfood", "chance": 40, "repeat": [ 1, 2 ] }
      },
      "place_monster": [
        { "monster": "mon_zombie_tough", "x": [ 6, 12 ], "y": [ 7, 12 ], "repeat": [ 1, 2 ] },
        { "monster": "mon_zombie", "x": [ 5, 14 ], "y": [ 5, 14 ], "repeat": [ 2, 3 ] }
      ]
    }
  },
  {
    "type": "mapgen",
    "method": "json",
    "om_terrain": "dojo_roof_1",
    "object": {
      "fill_ter": "t_floor",
      "rows": [
        "                        ",
        "  |22222223   |22222223 ",
        "  |.......3   |.......3 ",
        "  |.......3   |.......3 ",
        "  |.......3   |.......5 ",
        "  |.......3   |.......3 ",
        "  |-------3   |-------3 ",
        "                        ",
        "                        ",
        "                        ",
        "                        ",
        "                        ",
        "                        ",
        "                        ",
        "                        ",
        "                        ",
        "  |U....         ##gg## ",
        "  |......b##gggg##^tt^# ",
        "  |......b#yssssy#^**^# ",
        "  |.......+^^^^^^#^**^# ",
        "  5.......+^^^^^^+^**^# ",
        "  |.......#^>#tty#y^^y# ",
        "  |------4############# ",
        "                        "
      ],
      "palettes": [ "roof_palette" ],
      "terrain": {
        "^": "t_floor",
        "#": "t_wall_g",
        "+": "t_door_glass_c",
        "g": "t_wall_glass",
        ">": "t_stairs_down",
        "b": "t_flat_roof",
        "U": "t_flat_roof"
      },
      "furniture": { "*": "f_tatami" },
      "items": { "t": { "item": "dojo_manuals", "chance": 25 } },
      "nested": { "U": { "chunks": [ [ "roof_6x6_garden_1", 50 ], [ "roof_6x6_garden_3", 50 ] ] } }
    }
  },
  {
    "type": "mapgen",
    "method": "json",
    "om_terrain": "dojo_upper_roof_1",
    "object": {
      "fill_ter": "t_flat_roof",
      "rows": [
        "                        ",
        "                        ",
        "                        ",
        "                        ",
        "                        ",
        "                        ",
        "                        ",
        "                        ",
        "                        ",
        "                        ",
        "                        ",
        "                        ",
        "                        ",
        "                        ",
        "                        ",
        "                        ",
        "          |222222222223 ",
        "          |...........3 ",
        "          |.........X.3 ",
        "          |...........3 ",
        "          |...........3 ",
        "          |..:........3 ",
        "          5-----------3 ",
        "                        "
      ],
      "palettes": [ "roof_palette" ]
    }
  }
]
