[
  {
    "type": "mapgen",
    "method": "json",
    "om_terrain": [ [ "horse_farm_house_1" ], [ "horse_farm_house_2" ] ],
    "weight": 250,
    "object": {
      "fill_ter": "t_floor",
      "rows": [
		"%%%%%%%..........%%%%%%%",
		"%......................%",
		"%.........,,..ppp....99%",
		"%..pppppp..,.|vvv|..9..%",
		"%.|||vvv|||+||y1g|-..9.%",
		"%p-8 yy8-1g a    8-....%",
		"%pv     -n    Y  n-...9%",
		"%,- hhh -     Y  n-..9.%",
		"%,+ nnn i     Y  n-p...%",
		"%.- nnn -     Y  n-....%",
		"%.- hhh -     Y  n-p...%",
		"%.-     -888     8-..9.%",
		"%p|     ||||- -|||-....%",
		"%pvc    -rrr- -Y 8-....%",
		"%pvS    +  r- -Y  --..9%",
		"%pvc    -rrr- -y  kv...%",
		"%p|c cc ||||- +  hkv...%",
		"%.-f    -y D- -   kv.0.%",
		"%.-c    -   + -8  --...%",
		"%.-coccD-t S-<-818-...9%",
		"%.|||vv|||||||||v||.9..%",
		"%................4...9.%",
		"%......................%",
		"%%%%%%%%%%%%%%%%%%%%...%",
		"%......................%",
		"%......................%",
		"%......................%",
		"%......................%",
		"%......................%",
		"%...........$$OOO$$....%",
		"%...........$Q;Q;Q$....%",
		"%...........OQ;Q;QO....%",
		"%...........OQ;Q;QO....%",
		"%...........$Q;Q;Q$....%",
		"%...........*;;;;;*....%",
		"%...........$Q;Q;Q$....%",
		"%...........OQ;Q;QO....%",
		"%...........OQ;Q;QO....%",
		"%...........$Q;Q;Q$....%",
		"%...........$$OOO$$....%",
		"%......................%",
		"%......................%",
		"%......................%",
		"%......................%",
		"%......................%",
		"%......................%",
		"%......................%",
		"%%%%%%%%%%%%%%%%%%%%%%%%"
      ],
      "palettes": [ "farm_horse" ],
      "terrain": { "p": "t_grass", "0": "t_grass", "6": "t_grass", "Ы": "t_dirtfloor" },
      "sealed_item": { "Q": { "item": { "item": "seed_rose" }, "furniture": "f_planter_mature" } },
      "items": {
        "k": { "item": "office", "chance": 30 },
        "f": { "item": "fridge", "chance": 30 },
        "o": { "item": "oven", "chance": 30 },
        "8": { "item": "ranch_homebooks", "chance": 30 },
        "r": { "item": "restaur_kitchen", "chance": 30 },
        "c": { "item": "kitchen_counters", "chance": 30 },
        "D": { "item": "trash", "chance": 20, "repeat": [ 2, 4 ] },
        "7": { "item": "horse_gear", "chance": 20 },
        "^": { "item": "horse_gear", "chance": 30 }
      },
      "item": { "Ы": { "item": "salt_lick", "chance": 80, "repeat": [ 1, 4 ] } }
    }
  },
  {
    "type": "mapgen",
    "method": "json",
    "om_terrain": [ [ "horse_farm_stable_1" ], [ "horse_farm_stable_2" ] ],
    "weight": 250,
    "object": {
      "fill_ter": "t_floor",
      "rows": [
        "%%%%%%%..........%%%%%%%",
        "%......................%",
        "%......................%",
        "%......................%",
        "%......................%",
        "%.WWvvWWWGGGGGWWWvvWW..%",
        "%.Wkkk8W5;;;;;;WL  ^W..%",
        "%.v h  +;;;;;;;+   ^v..%",
        "%.W1  8W;;;;;;;WLL ^W..%",
        "%.WWWWWWW;;;;;WWWWWWW..%",
        "%.W;;;WЫ;;;;;;ЫЫW;;;W..%",
        "%.3;;;3;;;;;;;;;3;;;3..%",
        "%.W;;;W77;;;;;77W;;;W..%",
        "%.WWWWWWW;;;;;WWWWWWW..%",
        "%.W;;;WЫЫ;;;;;;ЫW;;;W..%",
        "%.3;;;3;;;;;;;;;3;;;3..%",
        "%.W;;;W77;;;;;77W;;;W..%",
        "%.WWWWWWW;;;;;WWWWWWW..%",
        "%.W;;;W77;;;;;ЫЫW;;;W..%",
        "%.3;;;3;;;;;;;;;3;;;3..%",
        "%.W;;;W#5;;;;;77W;;;W..%",
        "%.WWWWWWWGGGGGWWWWWWW..%",
        "%......................%",
        "%......................%",
        "%......................%",
        "%......................%",
        "%......................%",
        "%......................%",
        "%......................%",
        "%......................%",
        "%......................%",
        "%......................%",
        "%......................%",
        "%......................%",
        "%......................%",
        "%......................%",
        "%......................%",
        "%......................%",
        "%......................%",
        "%......................%",
        "%......................%",
        "%......................%",
        "%......................%",
        "%......................%",
        "%......................%",
        "%......................%",
        "%......................%",
        "%%%%%%%%%%%%%%%%%%%%%%%%"
      ],
      "palettes": [ "farm_horse" ],
      "terrain": { "p": "t_grass", "0": "t_grass", "6": "t_grass", "Ы": "t_dirtfloor" },
      "sealed_item": { "Q": { "item": { "item": "seed_rose" }, "furniture": "f_planter_mature" } },
      "items": {
        "k": { "item": "office", "chance": 30 },
        "f": { "item": "fridge", "chance": 30 },
        "o": { "item": "oven", "chance": 30 },
        "8": { "item": "ranch_homebooks", "chance": 30 },
        "r": { "item": "restaur_kitchen", "chance": 30 },
        "c": { "item": "kitchen_counters", "chance": 30 },
        "D": { "item": "trash", "chance": 20, "repeat": [ 2, 4 ] },
        "7": { "item": "horse_gear", "chance": 20 },
        "^": { "item": "horse_gear", "chance": 30 }
      },
      "item": { "Ы": { "item": "salt_lick", "chance": 80, "repeat": [ 1, 4 ] } }
    }
  },
  {
    "type": "mapgen",
    "method": "json",
    "om_terrain": "paddock_basic",
    "weight": 250,
    "object": {
      "fill_ter": "t_floor",
      "rows": [
        "%%%%%%%%%%%%%%%%%%%%%%%%",
        "%......................%",
        "%......................%",
        "%......................%",
        "%......................%",
        "%......................%",
        "%......................%",
        "%......................%",
        "%......................%",
        "%......................%",
        "%......................%",
        "%......................%",
        "%......................%",
        "%......................%",
        "%......................%",
        "%......................%",
        "%......................%",
        "%......................%",
        "%......................%",
        "%......................%",
        "%......................%",
        "%......................%",
        "%......................%",
        "%%%%%%%%%%%%%%%%%%%%%%%%"
      ],
      "palettes": [ "farm_horse" ]
    }
  }
]
