[
  {
    "type": "mapgen",
    "method": "json",
    "om_terrain": [ [ "farm_3", "null", "farm_1" ], [ "farm_6", "farm_5", "farm_4" ], [ "farm_9", "farm_8", "farm_7" ] ],
    "weight": 250,
    "object": {
      "fill_ter": "t_floor",
      "rows": [
        "       ,,,,,,,,,        ││││││││││││││││││││││││ FFFFFFFFFFFFFFFFFFFFFF ",
        "       ,,,,,,,,,,,,,,,, ││││││││││││││││││││││││ F                    F ",
        "       ,,,,,,,,,,,,,,,,,││││││││││││││││││││││││ F  DDDDDDDDDDDDDDDD  F ",
        "       ,,,,,,,,,O     ,,││││││││││││││││││││││││ F                    F ",
        "  ##W##MMMMMMMMM##W##   ││││││││││││││││││││││││ F  DDDDDDDDDDDDDDDD  F ",
        "  #yyy__________O___#   ││││││││││││││││││││││││,g                    F ",
        "  Wyyy______________W   ││││││││││││││││││││││││,g  DDDDDDDDDDDDDDDD  F ",
        "  Wyyy______________W   ││││││││││││││││││││││││ F                    F ",
        "  #_____________1___W   ││││││││││││││││││││││││ F  DDDDDDDDDDDDDDDD  F ",
        "  #333___________233W   ││││││││││││││││││││││││ F                    F ",
        "  #__2___________2__#   ││││││││││││││││││││││││ F  DDDDDDDDDDDDDDDD  F ",
        "  #__2___________2__#   ││││││││││││││││││││││││ F          Q         F ",
        "  W__g___________g__W   ││││││││││││││││││││││││ F  DDDDDDDDDDDDDDDD  F ",
        "  W__g___________g__W   ││││││││││││││││││││││││ F                    F ",
        "  #__2___________2__#   ││││││││││││││││││││││││ F  DDDDDDDDDDDDDDDD  F ",
        "  #__2___________2__#   ││││││││││││││││││││││││ F                    F ",
        "  #332___________233#   ││││││││││││││││││││││││ F  DDDDDDDDDDDDDDDD  F ",
        "  #_____________1___#   ││││││││││││││││││││││││ F                    F ",
        "  W_________________W   ││││││││││││││││││││││││ F  DDDDDDDDDDDDDDDD  F ",
        "  W_________________W   ││││││││││││││││││││││││ F                    F ",
        "  #lll__________O___#,,,││││││││││││││││││││││││ F  DDDDDDDDDDDDDDDD  F ",
        "FF##W##MMMMMMMMM##W##gF,││││││││││││││││││││││││ F                    F ",
        "F      ,,,,,,,,,O   ,,F ││││││││││││││││││││││││ F  DDDDDDDDDDDDDDDD  F ",
        "F      ,,,,,,,,,,,,,, F ││││││││││││││││││││││││ F                    F ",
        "F                     FFFFFFFFFFFFFFFFFFFFFFFFFFFF                    F ",
        "F                                                                     F ",
        "F  DDDDDDDDDDDDDDDDD        DDDDDDDDDDDDDDDDQ       DDDDDDDDDDDDDDDD  F ",
        "F                                                                     F ",
        "F  DDDDDDDDDDDDDDDDDDDD  DDDDDDDDDDDDDDDDDDDDDD  DDDDDDDDDDDDDDDDDDD  F ",
        "F                                                                     F ",
        "F  DDDDDDDDDDDDDDDDDDDD  DDDDDDDDDDDDDDDDDDDDDD  DDDDDDDDDDDDDDDDDDD  F ",
        "F                                                                     F ",
        "F  DDDDDDDDDDDDDDDDDDDD  DDDDDDDDDDDDDDDDDDDDDD  DDDDDDDDDDDDDDDDDDD  F ",
        "F                                  Q                                  F ",
        "F  DDDDDDDDDDDDDDDDDDDD  DDDDDDDDDDDDDDDDDDDDDD  DDDDDDDDDDDDDDDDDDD  F ",
        "F                                                                     F ",
        "F  DDDDDDDDDDDDDDDDDDDD  DDDDDDDDDDDDDDDDDDDDDD  DDDDDDDDDDDDDDDDDDD  F ",
        "F                                                                     F ",
        "F  DDDDDDDDDDDDDDDDDDDD  DDDDDDDDDDDDDDDDDDDDDD  DDDDDDDDDDDDDDDDDDD  F ",
        "F                                                                     F ",
        "F  DDDDDDDDDDDDDDDDDDDD  DDDDDDDDDDDDDDDDDDDDDD  DDDDDDDDDDDDDDDDDDD  F ",
        "F           Q                                                         F ",
        "F  DDDDDDDDDDDDDDDDDDDD  DDDDDDDDDDDDDDDDDDDDDD  DDDDDDDDDDDDDDDDDDD  F ",
        "F                                                                     F ",
        "F  DDDDDDDDDDDDDDDDDDDD  DDDDDDDDDDDDDDDDDDDDDD  DDDDDDDDDDDDDDDDDDD  F ",
        "F                                                                     F ",
        "F  DDDDDDDDDDDDDDDDD        DDDDDDDDDDDDDDDD        DDDDDDDDDDDDDDDD  F ",
        "F                                                                     F ",
        "F                                                                     F ",
        "F                                                                     F ",
        "F  DDDDDDDDDDDDDDDDD        DDDDDDDDDDDDDDDD        DDDDDDDDDDDDDDDD  F ",
        "F                                                                     F ",
        "F  DDDDDDDDDDDDDDDDDDDD  DDDDDDDDDDDDDDDDDDDDDD  DDDDDDDDDDDDDDDDDDD  F ",
        "F                                                                     F ",
        "F  DDDDDDDDDDDDDDDDDDDD  DDDDDDDDDDDDDDDDDDDDDD  DDDDDDDDDDDDDDDDDDD  F ",
        "F                                                                     F ",
        "F  DDDDDDDDDDDDDDDDDDDD  DDDDDDDDDDDDDDDDDDDDDD  DDDDDDDDDDDDDDDDDDD  F ",
        "F                                                                     F ",
        "F  DDDDDDDDDDDDDDDDDDDD  DDDDDDDDDDDDDDDDDDDDDD  DDDDDDDDDDDDDDDDDDD  F ",
        "F                                                                     F ",
        "F  DDDDDDDDDDDDDDDDDDDD  DDDDDDDDDDDDDDDDDDDDDD  DDDDDDDDDDDDDDDDDDD  F ",
        "F                                  Q                                  F ",
        "F  DDDDDDDDDDDDDDDDDDDD  DDDDDDDDDDDDDDDDDDDDDD  DDDDDDDDDDDDDDDDDDD  F ",
        "F                                                                     F ",
        "F  DDDDDDDDDDDDDDDDDDDD  DDDDDDDDDDDDDDDDDDDDDD  DDDDDDDDDDDDDDDDDDD  F ",
        "F                                                                     F ",
        "F  DDDDDDDDDDDDDDDDDDDD  DDDDDDDDDDDDDDDDDDDDDD  DDDDDDDDDDDDDDDDDDD  F ",
        "F                                                           Q         F ",
        "F  DDDDDDDDDDDDDDDDDDDD  DDDDDDDDDDDDDDDDDDDDDD  DDDDDDDDDDDDDDDDDDD  F ",
        "F                                                                     F ",
        "F                                                                     F ",
        "FFFFFFFFFFFFFFFFFFFFFFFFFFFFFFFFFFFFFFFFFFFFFFFFFFFFFFFFFFFFFFFFFFFFFFF "
      ],
      "palettes": [ "farm" ],
      "terrain": { "│": "t_open_air" },
      "place_item": [
        { "item": "straw_pile", "x": [ 3, 5 ], "y": [ 5, 7 ], "amount": [ 0, 8 ] },
        { "item": "cattlefodder", "x": [ 3, 5 ], "y": [ 5, 7 ], "amount": [ 0, 4 ] },
        { "item": "straw_pile", "x": [ 3, 3 ], "y": [ 10, 15 ], "amount": [ 2, 7 ] },
        { "item": "cattlefodder", "x": [ 3, 3 ], "y": [ 10, 15 ], "amount": [ 2, 7 ] },
        { "item": "straw_pile", "x": [ 19, 19 ], "y": [ 10, 15 ], "amount": [ 2, 7 ] },
        { "item": "cattlefodder", "x": [ 19, 19 ], "y": [ 10, 15 ], "amount": [ 2, 7 ] }
      ],
      "place_monster": [ { "group": "GROUP_DOMESTIC", "x": [ 10, 12 ], "y": [ 15, 17 ], "repeat": [ 1, 10 ] } ],
      "sealed_item": { "D": { "item": { "item": "seed_corn" }, "furniture": "f_plant_seedling", "chance": 70 } }
    }
  },
  {
    "type": "mapgen",
    "method": "json",
    "om_terrain": [ [ "farm_2" ] ],
    "weight": 500,
    "object": {
      "fill_ter": "t_floor",
      "rows": [
        "........................",
        ".................p......",
        ",,,,....................",
        ",,,,,,,,,...............",
        "...,,,,,,,,,,,,.........",
        ".....,..,,,,,,,,,,,,,,,,",
        ".....,........,,,,,,,,,,",
        "....,,........---..$$$$.",
        "....,.........---0##oo##",
        "....,.....$$$.---^#VHHH#",
        "...,,....##o###*###  l #",
        "!!!**!!!.#4OF|L   Y   y#",
        "!~~__~~!.#3           a#",
        "!~___~~!.#5    hfh    y#",
        "!_!__!~!.#1 6| hfh     #",
        "!______!.#2 6|||||||+||#",
        "!______!.#|+||rrr T   d#",
        "!_!__!_!.#B't| h     @@o",
        "!______!.#B''+       @@#",
        "!qq__qq!.#8S8|RRR  E  d#",
        "!!!**!!!.##o########oo##",
        ",,,,,...................",
        "..............u.........",
        "........................"
      ],
      "palettes": [ "standard_domestic_palette", "standard_domestic_lino_bathroom" ],
      "terrain": {
        "!": "t_wall_wood",
        ",": "t_region_soil",
        "0": "t_water_pump",
        "$": "t_region_shrub_decorative",
        "'": { "param": "linoleum_color_bathroom", "fallback": "t_linoleum_gray" },
        "q": "t_dirtfloor",
        "_": "t_dirtfloor",
        "~": "t_dirtmoundfloor"
      },
      "items": {
        "q": [
          { "item": "tools_earthworking", "chance": 65 },
          { "item": "mechanics", "chance": 40 },
          { "item": "home_hw", "chance": 50 },
          { "item": "tools_common", "chance": 50 }
        ]
      },
      "place_loot": [ { "group": "corpse_generic_human", "x": [ 2, 22 ], "y": [ 2, 22 ], "chance": 100 } ]
    }
  },
  {
    "type": "mapgen",
    "method": "json",
    "om_terrain": [ [ "farm_2" ] ],
    "//": "NPC version",
    "weight": 50,
    "object": {
      "fill_ter": "t_floor",
      "rows": [
        "........................",
        ".................p......",
        ",,,,....................",
        ",,,,,,,,,...............",
        "...,,,,,,,,,,,,.........",
        ".....,..,,,,,,,,,,,,,,,,",
        ".....,........,,,,,,,,,,",
        "....,,........---..$$$$.",
        "....,.........---0##oo##",
        "....,.....$$$.---^#VHHH#",
        "...,,....##o###*###  l #",
        "!!!**!!!.#4OF|L   Y   y#",
        "!~~__~~!.#3           a#",
        "!~___~~!.#5    hfh    y#",
        "!_!__!~!.#1 6| hfh     #",
        "!______!.#2 6|||||||+||#",
        "!______!.#|+||rrr T   d#",
        "!_!__!_!.#B't| h     @@o",
        "!______!.#B''+       @@#",
        "!qq__qq!.#8S8|RRR  E  d#",
        "!!!**!!!.##o########oo##",
        ",,,,,...................",
        "..............u.........",
        "........................"
      ],
      "palettes": [ "standard_domestic_palette", "standard_domestic_lino_bathroom" ],
      "terrain": {
        "o": [ "t_window_boarded", "t_window_boarded_noglass" ],
        "!": "t_wall_wood",
        ",": "t_region_soil",
        "0": "t_water_pump",
        "$": "t_region_shrub_decorative",
        "'": { "param": "linoleum_color_bathroom", "fallback": "t_linoleum_gray" },
        "q": "t_dirtfloor",
        "_": "t_dirtfloor",
        "~": "t_dirtmoundfloor"
      },
      "items": {
        " ": { "item": "SUS_trash_floor", "chance": 7 },
        "F": { "item": "SUS_fridge_survivor", "chance": 100 },
        "q": [
          { "item": "tools_earthworking", "chance": 65 },
          { "item": "mechanics", "chance": 40 },
          { "item": "home_hw", "chance": 50 },
          { "item": "tools_common", "chance": 50 }
        ]
      },
      "place_npcs": [ { "class": "farmer", "x": 12, "y": 3 } ]
    }
  },
  {
    "type": "mapgen",
    "method": "json",
    "om_terrain": [ [ "farm_3_roof", "farm_2_roof" ] ],
    "object": {
      "fill_ter": "t_shingle_flat_roof",
      "rows": [
        "                                                ",
        "                                                ",
        "                                                ",
        "                                                ",
        "  ,,,,,,,,,,,,,,,,,,,                           ",
        "  ,,,,,,,,,,,,,,,,,,,                           ",
        "  ,,,,,,,,,,,,,,,,,,,                           ",
        "  ,,,,,,,,,,,,,,,,,,,                           ",
        "  ,,,,,,,,,,,,,,,,,,,                     ------",
        "  ,,,,,,,,,,,,,,,,,,,                     -....-",
        "  ,,,,,,,,,,,,,,,,,,,            ----------....-",
        "  ,,,,,,,,,,,,,,,,,,,   ,,,,,,,, -.............-",
        "  ,,,,,,,,,,,,,,,,,,,   ,,,,,,,, -............~-",
        "  ,,,,,,,,,,,,,,,,,,,   ,,,,,,,, -.............-",
        "  ,,,,,,,,,,,,,,,,,,,   ,,,,,,,, -.&...........-",
        "  ,,,,,,,,,,,,,,,,,,,   ,,,,,,,, -.............-",
        "  ,,,,,,,,,,,,,,,,,,,   ,,,,,,,, -.............-",
        "  ,,,,,,,,,,,,,,,,,,,   ,,,,,,,, -.............-",
        "  ,,,,,,,,,,,,,,,,,,,   ,,,,,,,, -.=.........:.-",
        "  ,,,,,,,,,,,,,,,,,,,   ,,,,,,,, -.............-",
        "  ,,,,,,,,,,,,,,,,,,,   ,,,,,,,, ---------------",
        "  ,,,,,,,,,,,,,,,,,,,                           ",
        "                                                ",
        "                                                "
      ],
      "palettes": [ "roof_palette" ],
      "terrain": { ".": "t_shingle_flat_roof", ",": "t_metal_flat_roof" }
    }
  },
  {
    "type": "mapgen",
    "method": "json",
    "om_terrain": [ [ "farm_1_silo" ] ],
    "//": "Grain silo copy of silo in ranch_camp_57",
    "object": {
      "fill_ter": "t_dirtfloor",
      "rows": [
        "      III               ",
        "    IIIfIII####W###W### ",
        "    IfffffI#____rrr___# ",
        "   IIfffffIII________s# ",
        "   IfffffffA_________s# ",
        ",  IIfffffIII________s# ",
        ",,  IfffffI#__________W ",
        ",,  IIIfIII#_______O__# ",
        ",,    III  ####MMMM#### ",
        ",,,    <       ,,,,O    ",
        " ,,,,,,,,,,,,,,,,,,     ",
        "  ,,,,,,,,,,,,,,,,,     ",
        "               ,,,,     ",
        "               ,,,,     ",
        " FFFFFFFFFFFFFFggggFFFF ",
        " F                    F ",
        " F  DDDDDDDDDDDDDDDD  F ",
        " F                    F ",
        " F  DDDDDDDDDDDDDDDD  F ",
        " F                    F ",
        " F  DDDDDDDDDDDDDDDD  F ",
        " F                    F ",
        " F  DDDDDDDDDDDDDDDD  F ",
        " F                    F "
      ],
      "terrain": { "I": "t_wall_metal", "f": "t_metal_floor", "<": "t_ladder_up" },
      "items": { "r": { "item": "farming_tools", "chance": 25 } },
      "item": {
        "_": [ { "item": "straw_pile", "chance": 3 }, { "item": "cattlefodder", "chance": 2 } ],
        "f": { "item": "cattlefodder", "chance": 40, "repeat": 10 }
      },
      "sealed_item": { "D": { "item": { "item": "seed_oats" }, "furniture": "f_plant_seedling", "chance": 70 } },
      "palettes": [ "farm" ]
    }
  },
  {
    "type": "mapgen",
    "method": "json",
    "om_terrain": [ [ "farm_1_silo_1" ] ],
    "object": {
      "rows": [
        "      III               ",
        "    IIIoIII............ ",
        "    IoooooI............ ",
        "   IIoooooII........... ",
        "   IoooooooI........... ",
        "   IIoooooII........... ",
        "    IoooooI............ ",
        "    IIIoIII............ ",
        "      III  ............ ",
        "       ≷                ",
        "                        ",
        "                        ",
        "                        ",
        "                        ",
        "                        ",
        "                        ",
        "                        ",
        "                        ",
        "                        ",
        "                        ",
        "                        ",
        "                        ",
        "                        ",
        "                        "
      ],
      "terrain": { "I": "t_wall_metal", "o": "t_open_air_rooved", "≷": "t_ladder_up_down", ".": "t_shingle_flat_roof" },
      "palettes": [ "roof_palette" ]
    }
  },
  {
    "type": "mapgen",
    "method": "json",
    "om_terrain": [ [ "farm_1_silo_2" ] ],
    "object": {
      "rows": [
        "      III               ",
        "    IIIoIII             ",
        "    IoooooI             ",
        "   IIoooooII            ",
        "   IoooooooI            ",
        "   IIoooooII            ",
        "    IoooooI             ",
        "    IIIoIII             ",
        "      III               ",
        "       ≷                ",
        "                        ",
        "                        ",
        "                        ",
        "                        ",
        "                        ",
        "                        ",
        "                        ",
        "                        ",
        "                        ",
        "                        ",
        "                        ",
        "                        ",
        "                        ",
        "                        "
      ],
      "terrain": { "I": "t_wall_metal", "o": "t_open_air_rooved", "≷": "t_ladder_up_down" },
      "palettes": [ "roof_palette" ]
    }
  },
  {
    "type": "mapgen",
    "method": "json",
    "om_terrain": [ [ "farm_1_silo_roof" ] ],
    "object": {
      "rows": [
        "      ...               ",
        "    .......             ",
        "    .......             ",
        "   .........            ",
        "   .........            ",
        "   .........            ",
        "    .......             ",
        "    .......             ",
        "      ...               ",
        "       v                ",
        "                        ",
        "                        ",
        "                        ",
        "                        ",
        "                        ",
        "                        ",
        "                        ",
        "                        ",
        "                        ",
        "                        ",
        "                        ",
        "                        ",
        "                        ",
        "                        "
      ],
      "terrain": { ".": "t_shingle_flat_roof" },
      "palettes": [ "roof_palette" ]
    }
  },
  {
    "type": "mapgen",
    "method": "json",
    "om_terrain": [ [ "farm_1_coop" ] ],
    "//": "Chicken Coop",
    "object": {
      "fill_ter": "t_dirtfloor",
      "rows": [
        "                        ",
        "                        ",
        "  :::::::::###########  ",
        "  :        #_#_#_#_#_#  ",
        "  :        #__8____7_#  ",
        ",,C        c_______8_#  ",
        ",,C        #__7______#  ",
        "  :        #_#_#_#_#_#  ",
        "  :        ###########  ",
        "  :                  :  ",
        "  :                  :  ",
        "  :                  :  ",
        "  ::::::::::::::::::::  ",
        "                        ",
        " FFFFFFFFFFFFFFFFFFFFFF ",
        " F                    F ",
        " F  DDDDDDDDDDDDDDDD  F ",
        " F                    F ",
        " F  DDDDDDDDDDDDDDDD  F ",
        " F                    F ",
        " F  DDDDDDDDDDDDDDDD  F ",
        " F                    F ",
        " F  DDDDDDDDDDDDDDDD  F ",
        " F                    F "
      ],
      "monster": { "7": { "monster": "mon_chicken" }, "8": { "monster": "mon_chicken_chick" } },
      "sealed_item": { "D": { "item": { "item": "seed_corn" }, "furniture": "f_plant_seedling", "chance": 70 } },
      "place_item": [
        { "item": "straw_pile", "x": 12, "y": 3, "chance": 75 },
        { "item": "straw_pile", "x": 14, "y": 3, "chance": 75 },
        { "item": "straw_pile", "x": 16, "y": 3, "chance": 75 },
        { "item": "straw_pile", "x": 18, "y": 3, "chance": 75 },
        { "item": "straw_pile", "x": 20, "y": 3, "chance": 75 },
        { "item": "straw_pile", "x": 12, "y": 7, "chance": 75 },
        { "item": "straw_pile", "x": 14, "y": 7, "chance": 75 },
        { "item": "straw_pile", "x": 16, "y": 7, "chance": 75 },
        { "item": "straw_pile", "x": 18, "y": 7, "chance": 75 },
        { "item": "straw_pile", "x": 20, "y": 7, "chance": 75 },
        { "item": "birdfood", "x": [ 3, 7 ], "y": [ 5, 11 ], "chance": 75, "repeat": [ 4, 7 ] },
        { "item": "straw_pile", "x": 20, "y": 7, "chance": 75 }
      ],
      "palettes": [ "farm" ]
    }
  },
  {
    "type": "mapgen",
    "method": "json",
    "om_terrain": [ [ "farm_1_coop_roof" ] ],
    "//": "Chicken Coop",
    "object": {
      "rows": [
        "                        ",
        "                        ",
        "           ...........  ",
        "           ...........  ",
        "           ...........  ",
        "           ...........  ",
        "           ...........  ",
        "           ...........  ",
        "           ...........  ",
        "                        ",
        "                        ",
        "                        ",
        "                        ",
        "                        ",
        "                        ",
        "                        ",
        "                        ",
        "                        ",
        "                        ",
        "                        ",
        "                        ",
        "                        ",
        "                        ",
        "                        "
      ],
      "terrain": { ".": "t_shingle_flat_roof" },
      "palettes": [ "roof_palette" ]
    }
  },
  {
    "type": "mapgen",
    "method": "json",
    "om_terrain": [ [ "farm_1_greenhouse" ] ],
    "//": "Greenhouse",
    "object": {
      "fill_ter": "t_dirt",
      "rows": [
        "                        ",
        "                        ",
        "     GGGGGGGGGGGGGGGGGG ",
        "     G♥♠♠♠♦♦♦♣♣♣♣♣♦♦%%G ",
        "     G♥_______________G ",
        ",,,  G♥__♠♠♠♠♠♥♥♥♥♥__rG ",
        ",,,,,~_______________rG ",
        "  ,,,~_______________rG ",
        "     GɅ__♦♦♦♦♦♣♣♣♣♣__rG ",
        "     GɅ_______________G ",
        "     GɅɅɅΔΔΔΔΔ‡‡‡‡‡%%%G ",
        "     GGGGGGGGGGGGGGGGGG ",
        "                        ",
        "                        ",
        " FFFFFFFFFFFFFFFFFFFFFF ",
        " F                    F ",
        " F  DDDDDDDDDDDDDDDD  F ",
        " F                    F ",
        " F  DDDDDDDDDDDDDDDD  F ",
        " F                    F ",
        " F  DDDDDDDDDDDDDDDD  F ",
        " F                    F ",
        " F  DDDDDDDDDDDDDDDD  F ",
        " F                    F "
      ],
      "items": { "r": { "item": "tools_earthworking", "chance": 20 } },
      "terrain": {
        "♥": "t_dirtfloor",
        "♠": "t_dirtfloor",
        "♦": "t_dirtfloor",
        "♣": "t_dirtfloor",
        "Ʌ": "t_dirtfloor",
        "Δ": "t_dirtfloor",
        "‡": "t_dirtfloor",
        "%": "t_dirtfloor"
      },
      "sealed_item": {
        "D": { "item": { "item": "seed_corn" }, "furniture": "f_plant_seedling", "chance": 70 },
        "♥": { "item": { "item": "seed_tomato" }, "furniture": "f_planter_harvest", "chance": 100 },
        "♠": { "item": { "item": "seed_lettuce" }, "furniture": "f_planter_harvest", "chance": 100 },
        "♦": { "item": { "item": "seed_cucumber" }, "furniture": "f_planter_harvest", "chance": 100 },
        "♣": { "item": { "item": "seed_carrot" }, "furniture": "f_planter_harvest", "chance": 100 },
        "Ʌ": { "item": { "item": "seed_zucchini" }, "furniture": "f_planter_harvest", "chance": 100 },
        "Δ": { "item": { "item": "seed_celery" }, "furniture": "f_planter_harvest", "chance": 100 },
        "‡": { "item": { "item": "seed_pumpkin" }, "furniture": "f_planter_harvest", "chance": 100 },
        "%": { "item": { "item": "seed_oats" }, "furniture": "f_planter_harvest", "chance": 100 }
      },
      "palettes": [ "farm" ]
    }
  },
  {
    "type": "mapgen",
    "method": "json",
    "om_terrain": [ [ "farm_1_greenhouse_roof" ] ],
    "object": {
      "rows": [
        "                        ",
        "                        ",
        "     oooooooooooooooooo ",
        "     oooooooooooooooooo ",
        "     oooooooooooooooooo ",
        "     oooooooooooooooooo ",
        "     oooooooooooooooooo ",
        "     oooooooooooooooooo ",
        "     oooooooooooooooooo ",
        "     oooooooooooooooooo ",
        "     oooooooooooooooooo ",
        "     oooooooooooooooooo ",
        "                        ",
        "                        ",
        "                        ",
        "                        ",
        "                        ",
        "                        ",
        "                        ",
        "                        ",
        "                        ",
        "                        ",
        "                        ",
        "                        "
      ],
      "palettes": [ "roof_palette" ]
    }
  },
  {
    "type": "mapgen",
    "method": "json",
    "om_terrain": [ [ "farm_1_apiary" ] ],
    "//": "Apiary",
    "object": {
      "fill_ter": "t_dirt",
      "rows": [
        "                        ",
        "                        ",
        "     FFFFFFFFFFFFFFFFFF ",
        "     F         ,      F ",
        "     F ⬡⬡  ⬡⬡  ⬡⬡  ⬡⬡ F ",
        ",,,  F ⬡⬡  ⬡⬡  ⬡⬡  ⬡⬡ F ",
        ",,,,,g,,,,,     ,,    F ",
        "  ,,,g,,,,   ,        F ",
        "     F ⬡⬡  ⬡⬡  ⬡⬡  ⬡⬡ F ",
        "   , F ⬡⬡  ⬡⬡  ⬡⬡  ⬡⬡ F ",
        "     F               ,F ",
        "    ,FFFFFFFFFFFFFFFFFF ",
        "     ,,                 ",
        "           ,      ##### ",
        "               , ♦#r♠♥# ",
        "                ,,+___# ",
        "                  ##### ",
        "                        ",
        " FFFFFFFFFFFFFFFFFFFFFF ",
        " F                    F ",
        " F  DDDDDDDDDDDDDDDD  F ",
        " F                    F ",
        " F  DDDDDDDDDDDDDDDD  F ",
        " F                    F "
      ],
      "terrain": { "⬡": [ [ "t_apiary", 5 ], [ "t_apiary_empty", 95 ] ] },
      "items": {
        "♠": [
          { "item": "hive", "chance": 50, "repeat": [ 2, 4 ] },
          { "item": "home_hw", "chance": 50 },
          { "item": "tools_common", "chance": 50 }
        ],
        "r": { "item": "honey_market_stall", "repeat": [ 4, 12 ] }
      },
      "furniture": { "♥": "f_machinery_light", "♠": "f_locker", "♦": "f_woodchips" },
      "sealed_item": { "D": { "item": { "item": "seed_corn" }, "furniture": "f_plant_seedling", "chance": 70 } },
      "palettes": [ "farm" ],
      "place_monster": [
        { "group": "GROUP_BEEKEEPER", "x": [ 6, 21 ], "y": [ 3, 10 ], "pack_size": 1, "chance": 10 },
        { "group": "GROUP_BEE", "x": [ 6, 21 ], "y": [ 3, 10 ], "pack_size": [ 2, 4 ], "chance": 20 }
      ]
    }
  },
  {
    "type": "mapgen",
    "method": "json",
    "om_terrain": [ [ "farm_1_apiary_roof" ] ],
    "object": {
      "rows": [
        "                        ",
        "                        ",
        "                        ",
        "                        ",
        "                        ",
        "                        ",
        "                        ",
        "                        ",
        "                        ",
        "                        ",
        "                        ",
        "                        ",
        "                        ",
        "                  ..... ",
        "                  ...=. ",
        "                  ..... ",
        "                  ..... ",
        "                        ",
        "                        ",
        "                        ",
        "                        ",
        "                        ",
        "                        ",
        "                        "
      ],
      "palettes": [ "roof_palette" ]
    }
  }
]
