[
  {
    "method": "json",
    "om_terrain": "gambling_hall",
    "type": "mapgen",
    "object": {
      "fill_ter": "t_floor",
      "rows": [
        "        ##-+-+-##       ",
        " 999999 #.......#       ",
        "#########.......##----##",
        "##.....^||-+-+-||hthhth#",
        "#..............v|hthhth#",
        "##.pp..........V|......#",
        "#..pp...66.....&|ht..ht#",
        "#..pp...66......|ht..ht#",
        "#....................ht#",
        "#..hhhh.hhhh...........#",
        "#..6666.6666........CCC#",
        "#..6666.6666........C..#",
        "#..hhhh.hhhh........Ch.#",
        "#...................C..#",
        "#............^......r..#",
        "#6h.......|%|||%|^..r..#",
        "#6h..hhhh.|''|''||d|||'#",
        "#....6666^|SU|SU|''qq''#",
        "#||a|||||||||||||''''''#",
        "#^....tt.{{{|XX.d''''''#",
        "#...............|SSoo(f#",
        "#h..............########",
        "#tth..THHH.^|<|.bccDD4cc",
        "#################ccccccc"
      ],
      "palettes": [ "parametrized_linoleum_palette", "parametrized_walls_palette" ],
      "terrain": {
        "+": "t_door_glass_c",
        "-": "t_wall_glass",
        ".": "t_floor",
        "'": { "param": "linoleum_color", "fallback": "t_linoleum_white" },
        "S": { "param": "linoleum_color", "fallback": "t_linoleum_white" },
        "U": { "param": "linoleum_color", "fallback": "t_linoleum_white" },
        "q": { "param": "linoleum_color", "fallback": "t_linoleum_white" },
        "f": { "param": "linoleum_color", "fallback": "t_linoleum_white" },
        "o": { "param": "linoleum_color", "fallback": "t_linoleum_white" },
        "6": "t_slot_machine",
        "D": "t_concrete",
        "9": "t_region_shrub_decorative",
        " ": "t_region_groundcover_urban",
        "a": "t_door_metal_c",
        "b": [ "t_door_metal_locked", "t_door_metal_elocked" ],
        "c": "t_concrete",
        "d": "t_door_c",
        "4": "t_gutter_downspout",
        "<": "t_ladder_up",
        "%": "t_door_c",
        "(": { "param": "linoleum_color", "fallback": "t_linoleum_white" }
      },
      "items": { "U": { "item": "SUS_toilet", "chance": 50 } },
      "toilets": { "U": {  } },
      "furniture": {
        "&": "f_atm_off",
        "h": "f_chair",
        "C": "f_counter",
        "q": "f_counter",
        "D": "f_dumpster",
        "H": "f_sofa",
        "T": "f_trashcan",
        "X": "f_cardboard_box",
        "^": [ "f_indoor_plant", "f_indoor_plant_y" ],
        "f": "f_heavy_duty_fridge",
        "(": "f_heavy_duty_freezer",
        "o": "f_oven",
        "p": "f_pool_table",
        "r": "f_rack",
        "t": "f_table",
        "{": "f_locker",
        "S": "f_sink"
      },
      "vendingmachines": {
        "v": { "item_group": "vending_drink_items", "lootable": true },
        "V": { "item_group": "vending_food_items", "lootable": true }
      },
      "place_items": [
        { "chance": 15, "item": "bags", "x": 5, "y": 9 },
        { "chance": 45, "item": "dining", "x": 22, "y": 7 },
        { "chance": 45, "item": "dining", "x": 18, "y": 4 },
        { "chance": 55, "item": "fridge", "x": [ 21, 22 ], "y": 20 },
        { "chance": 45, "item": "jackets", "x": 10, "y": 19 },
        { "chance": 45, "item": "jackets", "x": 4, "y": 12 },
        { "chance": 55, "item": "misc_smoking", "x": 7, "y": 22 },
        { "chance": 45, "item": "magazines", "x": 1, "y": 22 },
        { "chance": 45, "item": "magazines", "x": 11, "y": 19 },
        { "chance": 45, "item": "SUS_trash_dumpster", "x": [ 19, 20 ], "y": 22 },
        { "chance": 55, "item": "pool_table", "x": [ 3, 4 ], "y": [ 5, 7 ] },
        { "chance": 25, "item": "hatstore_hats", "x": 11, "y": 15 },
        { "chance": 25, "item": "hatstore_hats", "x": 1, "y": 5 },
        { "chance": 45, "item": "snacks", "x": 20, "y": [ 14, 15 ] },
        { "chance": 35, "item": "softdrugs", "x": 9, "y": 19 },
        { "chance": 65, "item": "cannedfood", "x": 14, "y": 19 },
        { "chance": 65, "item": "cannedfood", "x": 13, "y": 19 },
        { "chance": 65, "item": "kitchen", "x": [ 19, 20 ], "y": 17 },
        { "chance": 25, "item": "SUS_trash_floor_light", "x": 1, "y": 17 },
        { "chance": 25, "item": "SUS_trash_floor_light", "x": 8, "y": 15 },
        { "chance": 25, "item": "SUS_trash_floor_light", "x": 13, "y": 13 },
        { "chance": 25, "item": "SUS_trash_floor_light", "x": 1, "y": 11 },
        { "chance": 25, "item": "SUS_trash_floor_light", "x": 10, "y": 7 },
        { "chance": 25, "item": "SUS_trash_floor_light", "x": 5, "y": 3 },
        { "chance": 45, "item": "cannedfood", "x": 18, "y": 20 },
        { "item": "cash_register_random", "x": 20, "y": [ 11, 13 ], "chance": 100 }
      ],
      "place_monsters": [ { "chance": 15, "density": 0.02, "monster": "GROUP_ZOMBIE", "x": 12, "y": 9 } ]
    }
  },
  {
    "type": "mapgen",
    "method": "json",
    "om_terrain": "gambling_hall_roof",
    "object": {
      "fill_ter": "t_flat_roof",
      "rows": [
        "        ---------       ",
        "        -.......-       ",
        "---------.......--------",
        "-......................-",
        "-......................-",
        "-......................-",
        "-......................-",
        "-......................-",
        "-......................-",
        "-......................-",
        "-......................-",
        "-......................-",
        "-......................-",
        "-......................-",
        "-......................-",
        "-......####+#####......-",
        "-......#*******C#......-",
        "-......#C*******#......-",
        "-......#C*******#......-",
        "-..&...#C*******#......-",
        "-......#*******C#......-",
        "-......#*******C#----5--",
        "-..=...#*C***v**#       ",
        "-------##########       "
      ],
      "palettes": [ "roof_palette" ],
      "terrain": { "#": "t_wall_w", "+": "t_door_locked_alarm", "*": "t_concrete", "C": "t_concrete" },
      "place_nested": [
        {
          "chunks": [
            [ "null", 20 ],
            [ "roof_2x2_utilities_b", 15 ],
            [ "roof_2x2_utilities_c", 5 ],
            [ "roof_2x2_utilities_d", 20 ],
            [ "roof_2x2_utilities", 30 ],
            [ "roof_2x2_golf", 10 ],
            [ "roof_3x3_wine", 10 ]
          ],
          "x": [ 3, 15 ],
          "y": 11
        },
        { "chunks": [ [ "null", 50 ], [ "roof_6x6_survivor", 50 ] ], "x": 9, "y": 16 },
        { "chunks": [ [ "roof_16x16_help", 20 ], [ "null", 80 ] ], "x": 2, "y": 4 }
      ]
    }
  },
  {
    "type": "mapgen",
    "method": "json",
    "om_terrain": "gambling_hall_upper_roof",
    "object": {
      "fill_ter": "t_flat_roof",
      "rows": [
        "                        ",
        "                        ",
        "                        ",
        "                        ",
        "                        ",
        "                        ",
        "                        ",
        "                        ",
        "                        ",
        "                        ",
        "                        ",
        "                        ",
        "                        ",
        "                        ",
        "                        ",
        "       ..........       ",
        "       ..........       ",
        "       ...X......       ",
        "       ..........       ",
        "       ..........       ",
        "       ..........       ",
        "       .......:..       ",
        "       ..........       ",
        "       ..........       "
      ],
      "palettes": [ "roof_palette" ]
    }
  },
  {
    "method": "json",
    "om_terrain": "gambling_hall_1",
    "type": "mapgen",
    "object": {
      "fill_ter": { "param": "carpet_color_type", "fallback": "t_carpet_red" },
      "rows": [
        "     sss                ",
        "    #+-+#               ",
        "    -...-  9999999999   ",
        "  ###...############### ",
        "  #a....{}.hth....h.&^# ",
        "  #^..................# ",
        "  #a.......hth...ppp..# ",
        "  #&.............ppp..# ",
        "  #..................h# ",
        "  #6h.h66h.h66h.......# ",
        "  #6h.h66h.h66h..ppp..# ",
        "  #6h.h66h.......ppp..# ",
        "  #6h.h66h...........h# ",
        "  #6h.h66h.h66h..ppp..# ",
        "  #&.......h66h..ppp..# ",
        "  #6h................^# ",
        "  #6h...........||%|%|# ",
        "  #6h.hhhhhh....|''|''# ",
        "  #6h.666666&a..|US|US# ",
        "  #############b|||#### ",
        "        PDDPPP#...l#4   ",
        "        PPPPPPc..ht#    ",
        "        PPPPPP######    ",
        "                        "
      ],
      "palettes": [ "parametrized_linoleum_palette", "parametrized_walls_palette", "parametrized_carpets_palette" ],
      "terrain": {
        "+": "t_door_glass_c",
        "-": "t_wall_glass",
        ".": { "param": "carpet_color_type", "fallback": "t_carpet_red" },
        "'": { "param": "linoleum_color", "fallback": "t_linoleum_white" },
        "S": { "param": "linoleum_color", "fallback": "t_linoleum_white" },
        "U": { "param": "linoleum_color", "fallback": "t_linoleum_white" },
        "6": "t_slot_machine",
        "D": "t_concrete",
        "P": "t_concrete",
        "9": "t_region_shrub_decorative",
        " ": "t_region_groundcover_urban",
        "b": [ "t_door_metal_c", "t_door_metal_elocked" ],
        "c": "t_door_metal_locked",
        "s": "t_sidewalk",
        "4": "t_gutter_downspout",
        "%": "t_door_c"
      },
      "items": { "U": { "item": "SUS_toilet", "chance": 50 } },
      "toilets": { "U": {  } },
      "furniture": {
        "a": "f_atm_off",
        "h": "f_chair",
        "&": "f_trashcan",
        "D": "f_dumpster",
        "^": "f_indoor_plant",
        "l": "f_locker",
        "p": "f_pool_table",
        "t": "f_table",
        "S": "f_sink"
      },
      "vendingmachines": {
        "{": { "item_group": "vending_drink_items", "lootable": true },
        "}": { "item_group": "vending_food_items", "lootable": true }
      },
      "place_items": [
        { "chance": 45, "item": "cubical_office", "x": 18, "y": 21 },
        { "chance": 45, "item": "jackets", "x": 18, "y": 20 },
        { "chance": 55, "item": "SUS_trash_dumpster", "x": [ 9, 10 ], "y": 20 },
        { "chance": 55, "item": "SUS_trash_trashcan_public", "x": 12, "y": 18 },
        { "chance": 55, "item": "SUS_trash_trashcan_public", "x": 3, "y": 14 },
        { "chance": 55, "item": "SUS_trash_trashcan_public", "x": 3, "y": 7 },
        { "chance": 15, "item": "jackets", "x": 7, "y": 17 },
        { "chance": 65, "item": "vending_drink_items", "x": 8, "y": 4 },
        { "chance": 45, "item": "pool_table", "x": [ 17, 19 ], "y": [ 14, 15 ] },
        { "chance": 45, "item": "pool_table", "x": [ 17, 19 ], "y": [ 10, 11 ] },
        { "chance": 35, "item": "pool_table", "x": [ 17, 19 ], "y": [ 6, 7 ] },
        { "chance": 25, "item": "SUS_trash_floor", "x": 17, "y": 18 },
        { "chance": 25, "item": "SUS_trash_floor", "x": 9, "y": 15 },
        { "chance": 25, "item": "SUS_trash_floor", "x": 19, "y": 13 },
        { "chance": 25, "item": "SUS_trash_floor", "x": 7, "y": 8 },
        { "chance": 25, "item": "SUS_trash_floor", "x": 11, "y": 7 },
        { "chance": 25, "item": "SUS_trash_floor", "x": 16, "y": 6 },
        { "chance": 25, "item": "SUS_trash_floor", "x": 5, "y": 3 },
        { "chance": 35, "item": "misc_smoking", "x": 4, "y": 17 },
        { "chance": 35, "item": "misc_smoking", "x": 9, "y": 12 },
        { "chance": 35, "item": "misc_smoking", "x": 14, "y": 9 },
        { "chance": 65, "item": "vending_food_items", "x": 9, "y": 4 },
        { "chance": 35, "item": "magazines", "x": 12, "y": 4 },
        { "chance": 65, "item": "hatstore_hats", "x": 4, "y": 11 }
      ]
    }
  },
  {
    "type": "mapgen",
    "method": "json",
    "om_terrain": "gambling_hall_roof_1",
    "object": {
      "fill_ter": "t_flat_roof",
      "rows": [
        "    -----               ",
        "    -...-               ",
        "    -...-               ",
        "  ---...--------------- ",
        "  -...................- ",
        "  -...................- ",
        "  -...................- ",
        "  -...................- ",
        "  -...................- ",
        "  -...................- ",
        "  -...................- ",
        "  -...................- ",
        "  -...................- ",
        "  -...................- ",
        "  -...................- ",
        "  -...................- ",
        "  -...................- ",
        "  -...................- ",
        "  -...................- ",
        "  -------------....5--- ",
        "              -....-    ",
        "              -....-    ",
        "              ------    ",
        "                        "
      ],
      "palettes": [ "roof_palette" ],
      "place_items": [ { "item": "SUS_trash_roof", "x": [ 4, 20 ], "y": [ 6, 17 ], "chance": 50, "repeat": [ 1, 3 ] } ],
      "place_nested": [
        {
          "chunks": [
            [ "null", 20 ],
            [ "roof_2x2_utilities_b", 15 ],
            [ "roof_2x2_utilities_c", 15 ],
            [ "roof_2x2_utilities_d", 30 ],
            [ "roof_2x2_utilities", 30 ]
          ],
          "x": [ 3, 15 ],
          "y": 5
        },
        {
          "chunks": [ [ "null", 20 ], [ "roof_4x4_utility", 40 ], [ "roof_4x4_utility_1", 30 ], [ "roof_6x6_utility", 20 ] ],
          "x": [ 5, 15 ],
          "y": [ 11, 12 ]
        }
      ]
    }
  }
]
