[
  {
    "type": "mapgen",
    "method": "json",
    "om_terrain": [ "s_garage" ],
    "weight": 1000,
    "object": {
      "fill_ter": "t_floor",
      "rows": [
        "                        ",
        "                        ",
        "                        ",
        "                        ",
        "    e         e         ",
        " ----========--======-- ",
        " |c.e.........e.......| ",
        " |c...................| ",
        " |c...................| ",
        " |c...................| ",
        " |c...................| ",
        " |c...................| ",
        " |c...................| ",
        " |....................| ",
        " |---.................| ",
        " |..|............HHHHH| ",
        " |..|............H.bbb| ",
        " |..*............H....| ",
        " |..|............$.6b.+ ",
        " |..|ccccccccccccH.LLL| ",
        " |----::::::----------| ",
        "                        ",
        "                        ",
        "                        "
      ],
      "terrain": {
        " ": [ "t_grass", "t_grass", "t_grass", "t_dirt" ],
        "$": "t_door_glass_c",
        "*": "t_door_frame",
        "+": "t_door_c",
        "-": "t_wall",
        ".": "t_floor",
        "6": "t_console_broken",
        ":": "t_window",
        "=": "t_door_metal_locked",
        "H": "t_wall_glass",
        "e": "t_gates_mech_control",
        "|": "t_wall"
      },
      "furniture": {
        "L": "f_locker",
        "b": "f_bench",
        "c": "f_counter"
      },
      "items": {
        "L": { "item": "clothing_work_set", "chance": 40 },
        "c": { "item": "mechanics", "chance": 20 }
      },
      "place_vehicles": [
        { "vehicle": "garage", "x": [ 10, 11 ], "y": [ 16, 18 ], "chance": 25, "rotation": 0 },
        { "vehicle": "garage", "x": [ 10, 11 ], "y": [ 6, 8 ], "chance": 25, "rotation": 0 }
      ]
    }
  }
]
