[
  {
    "type": "mapgen",
    "method": "json",
    "om_terrain": [ "craft_shop" ],
    "weight": 200,
    "object": {
      "fill_ter": "t_floor",
      "rows": [
        "________ss4       2     ",
        "________ss4   2    5  4 ",
        "_______ss5     52   445 ",
        "_______s%%--%rr%--%-%%  ",
        "_______s#...........E%  ",
        "_______sG.n.n.n.n.P%%%5 ",
        "______s5w.n.n.n.n.B%S%  ",
        "______ss=.n.n.n.n..=.%55",
        "______s5w.........R%t%1 ",
        "______s4GEEcccC...P%v%4 ",
        "______s %....T....E% 4 5",
        "______s4%BBB....PEE%    ",
        "______s4%%%%%=%%xx%%  4 ",
        "______s 5 551 11 55  1 5",
        "_____s42   41 1 4  2 5  ",
        "_____s4||||||=|||x||  4 ",
        "_____s4|L??%'''qNmY|    ",
        "_____ss='''='''''#'| 2  ",
        "______ |fLm%''qqq''|    ",
        "______4|||v|Q'''''m| 2  ",
        "______  2 5|Q'Qqq'Q| 54 ",
        "_______ u H|Q'Q''qQ|2   ",
        "________  H||r|G|w||1 4 ",
        "______UU5    5   5      "
      ],
      "terrain": {
        ".": "t_floor",
        "s": "t_sidewalk",
        "u": "t_dirt",
        "_": "t_pavement",
        "U": "t_pavement",
        " ": [ "t_grass", "t_dirt" ],
        "H": "t_grass",
        "1": "t_shrub_hydrangea",
        "2": [ "t_tree_walnut", "t_tree_apple" ],
        "4": "t_underbrush",
        "5": "t_grass",
        "-": "t_wall_glass",
        "|": "t_rock_wall",
        "%": "t_wall_wood",
        "+": "t_door_glass_c",
        "=": "t_door_c",
        "G": "t_window_stained_green",
        "w": "t_window_stained_blue",
        "r": "t_window_stained_red",
        "x": "t_window_no_curtains",
        "v": "t_window_domestic",
        "c": "t_floor",
        "C": "t_console_broken",
        "L": "t_rock_floor",
        "'": "t_rock_floor",
        "Q": "t_rock_floor",
        "Y": "t_rock_floor",
        "A": "t_rock_floor",
        "q": "t_rock_floor",
        "E": "t_rock_floor",
        "h": "t_rock_floor",
        "z": "t_rock_floor",
        "d": "t_rock_floor",
        "@": "t_rock_floor",
        "f": "t_rock_floor",
        "?": "t_rock_floor",
        "m": "t_rock_floor",
        "N": "t_rock_floor",
        "#": "t_rock_floor"
      },
      "furniture": {
        "H": "f_bench",
        "S": "f_sink",
        "T": "f_stool",
        "#": "f_stool",
        "P": "f_indoor_plant",
        "B": "f_bookcase",
        "c": "f_counter",
        "n": "f_table",
        "m": "f_table",
        "h": "f_chair",
        "L": "f_locker",
        "R": "f_trashcan",
        "Y": "f_forge_rock",
        "N": "f_kiln_empty",
        "Q": "f_rack",
        "q": "f_crate_c",
        "E": "f_displaycase",
        "U": "f_dumpster",
        "5": [ "f_flower_tulip", "f_bluebell", "f_dandelion" ],
        "z": "f_cupboard",
        "d": "f_dresser",
        "@": "f_bed",
        "f": "f_fridge",
        "?": "f_sofa",
        "u": "f_brazier"
      },
      "toilets": { "t": {  } },
      "place_items": [
        { "item": "glass_shop", "x": [ 20, 20 ], "y": [ 4, 4 ], "chance": 70, "repeat": [ 2, 10 ] },
        { "item": "glass_shop", "x": [ 18, 18 ], "y": [ 6, 6 ], "chance": 70, "repeat": [ 2, 10 ] },
        { "item": "glass_shop", "x": [ 18, 18 ], "y": [ 10, 11 ], "chance": 75, "repeat": [ 2, 10 ] },
        { "item": "glass_shop", "x": [ 17, 17 ], "y": [ 11, 11 ], "chance": 75, "repeat": [ 2, 10 ] },
        { "item": "glass_shop", "x": [ 10, 10 ], "y": [ 5, 7 ], "chance": 50, "repeat": [ 2, 10 ] },
        { "item": "glass_shop", "x": [ 12, 12 ], "y": [ 5, 7 ], "chance": 70, "repeat": [ 2, 10 ] },
        { "item": "glass_shop", "x": [ 14, 14 ], "y": [ 5, 7 ], "chance": 50, "repeat": [ 2, 10 ] },
        { "item": "glass_shop", "x": [ 16, 16 ], "y": [ 5, 7 ], "chance": 70, "repeat": [ 2, 10 ] },
        { "item": "glass_shop", "x": [ 9, 10 ], "y": [ 9, 9 ], "chance": 55, "repeat": [ 3, 10 ] },
        { "item": "glass_shop", "x": [ 9, 11 ], "y": [ 11, 11 ], "chance": 70, "repeat": [ 2, 10 ] },
        { "item": "car_misc", "x": [ 11, 13 ], "y": [ 9, 9 ], "chance": 50, "repeat": [ 2, 10 ] },
        { "item": "trash", "x": [ 18, 18 ], "y": [ 8, 8 ], "chance": 70, "repeat": [ 2, 10 ] },
        { "item": "cleaning", "x": [ 9, 9 ], "y": [ 18, 18 ], "chance": 50, "repeat": [ 2, 10 ] },
        { "item": "glass_workroom", "x": [ 14, 16 ], "y": [ 18, 18 ], "chance": 80, "repeat": [ 2, 5 ] },
        { "item": "glass_shop", "x": [ 12, 12 ], "y": [ 20, 21 ], "chance": 50, "repeat": [ 2, 10 ] },
        { "item": "glass_shop", "x": [ 14, 14 ], "y": [ 20, 21 ], "chance": 50, "repeat": [ 2, 10 ] },
        { "item": "glass_shop", "x": [ 18, 18 ], "y": [ 21, 21 ], "chance": 50, "repeat": [ 2, 10 ] },
        { "item": "glass_workroom", "x": [ 17, 17 ], "y": [ 21, 21 ], "chance": 50, "repeat": [ 2, 10 ] },
        { "item": "consumer_electronics", "x": [ 10, 10 ], "y": [ 18, 18 ], "chance": 70 },
        { "item": "glass_workroom", "x": [ 15, 16 ], "y": [ 20, 20 ], "chance": 50, "repeat": [ 2, 5 ] },
        { "item": "glass_workroom", "x": [ 17, 17 ], "y": [ 16, 16 ], "chance": 50, "repeat": [ 2, 5 ] },
        { "item": "fridge", "x": [ 8, 8 ], "y": [ 18, 18 ], "chance": 70, "repeat": [ 2, 10 ] },
        { "item": "bed", "x": [ 9, 10 ], "y": [ 16, 16 ], "chance": 70 },
        { "item": "alcohol_bottled_canned", "x": [ 10, 10 ], "y": [ 21, 22 ], "chance": 50 },
        { "item": "trash", "x": [ 6, 7 ], "y": [ 23, 23 ], "chance": 70 },
        { "item": "softdrugs", "x": [ 20, 20 ], "y": [ 7, 8 ], "chance": 50, "repeat": [ 2, 10 ] },
        { "item": "jackets", "x": [ 8, 8 ], "y": [ 16, 16 ], "chance": 70, "repeat": [ 2, 4 ] }
      ],
      "place_monsters": [ { "monster": "GROUP_ZOMBIE", "x": [ 2, 21 ], "y": [ 2, 21 ], "chance": 2 } ]
    }
  }
]
