[
  {
    "type": "mapgen",
    "method": "json",
    "om_terrain": [
      [ "golfcourse_00", "golfcourse_10", "golfcourse_20", "golfcourse_30" ],
      [ "golfcourse_01", "golfcourse_11", "golfcourse_21", "golfcourse_31" ],
      [ "golfcourse_02", "golfcourse_12", "golfcourse_22", "golfcourse_32" ]
    ],
    "object": {
      "fill_ter": "t_floor",
      "rows": [
        "││││││││││││││││││││││││││││││││││││││││││││││││││││││││││││││││││││││││sssssss;;;;;;;;;;sssssss",
        "│444444444444444444ww44444444444444444444444444444444444444444444444444│s;;;;;;;;;;;;;;;;;;;;;;s",
        "│44444444444444444wwww44444444444444444444444444444444444444444&44__444│s;;;;;;;;;;;;;;;;;;;;;;s",
        "│444__444____44444wwww44_____44444444________________________44P_vvvv44│s;;É;;;;;;;;;;;;;;;;Á;;s",
        "│44vvvv__....______www__..ggg._444P_vvvv..............___ggg.ddddvvvv_4│s;;;;;;;;;;;;;;;;;;;;;;s",
        "│4_vvvv...........cccc....gGg.ddddddvvvv.................gGg.ddddvvvv_4│s;;;;;;;;;;;;;;;;;;;;;;s",
        "│4_vvvv...........cccc....ggg.ddddddvvvv.................ggg._44_vvvv_4│syyyyyy;;;;;;;;;;yyyyyys",
        "│4_vvvv.........__wwww_......._4444_vvvv...................._444_...._4│s;;;;;;;;;;;;;;;;;;;;;;s",
        "│4_...........___44www4_______44444__....___________________4444_...._4│s;;;;;;;;;;;;;;;;;;;;;;s",
        "│P_dd_&444444444444www4444444444444&4____44444444444444444444444_...._4│s;;É;;;;;;;;;;;;;;;;Á;;s",
        "│44dd44444444444444www44444444444444444444444444444444444444444_....._4│s;;;;;;;;;;;;;;;;;;;;;;s",
        "│44dd4444444444444www4444____444___________________________4444_...._44│s;;;;;;;;;;;;;;;;;;;;;;s",
        "│44dd___4444444444www444_....__.........................vvvv&44_....._4│syyyyyy;;;;;;;;;;yyyyyys",
        "│44_...._44444&P44www444_.ggg...........................vvvv_44_....._4│s;;;;;;;;;;;;;;;;;;;;;;s",
        "│4__ggg._444____ddccccddd.gGg.............ooo...........vvvv_44_....._4│s;;;;;;;;;;;;;;;;;;;;;;s",
        "│4_.gGg.444_vvvvddccccddd.ggg.............oooo..........vvvv_44__...._4│s;;É;;;;;;;;;;;;;;;;Á;;s",
        "│4_.ggg.444_vvvv_4wwww44_...._......______oooo___________dd44444_...._4│s;;;;;;;;;;;;;;;;;;;;;;s",
        "│4_...._444_vvvv_44www444____4______44444______4444444444ddP4444_...._4│s;;;;;;;;;;;;;;;;;;;;;;s",
        "│4_...._444_vvvv_44www44444444444444444444444444444444444dd44444_...._4│syyyyyy;;;;;;;;;;yyyyyys",
        "│4_...._444_...._44www4444___44444_______________________dd__444_...._4│s;;;;;;;;;;;;;;;;;;;;;;s",
        "│4_...._444_...._44www444_vvvv....................____....ggg_44_...._4│s;;;;;;;;;;;;;;;;;;;;;;s",
        "│4_...._444_...._44ww4444_vvvv............................gGg_44_...._4│s;;É;;;;;;;;;;;;;;;;Á;;s",
        "│4_...._444_...._44ww4444_vvvv............................ggg_44_...._4│s;;;;;;;;;;;;;;;;;;;;;;s",
        "│44_..._444_...._44ww4444_vvvv.....______....................444_...._4│s;;;;;;;;;;;;;;;;;;;;;;s",
        "│44_..._444_...._4www4444_dd_______444444___________________4444_...._4│ssssssssssssssssssssssss",
        "│44_..._444_...._4www44444ddP44&4444444444444444444444444444444_...._44│ssssssssssssssssssssssss",
        "│44_...._44_...._4www4444_dd___44444____4444444444444&444444444_...._44│ss|||00|00|00||+||00||ss",
        "│44_...._44_...._44ww444_.ggg.__444_...._____________4444444444_....._4│ss|p,,,,,,,,,,r,,,,,p|ss",
        "│44_...._44_...._44ww444_.gGg.__44_.ggg..........vvvv44_____444_....._4│ss|,{{,{{,{{,,,,,,{{,|ss",
        "│44_...._44_...._44ww444_.ggg.__44_.gGg..........vvvv_4_..._444_....._4│ss|,{{,{{,{{,,,,,,{{,|ss",
        "│4_....._44_...._44ww444_.....__44_.ggg..........vvvvdddggg_44__....._4│ss|,,,,,,,,,,,,,,,,,,|ss",
        "│4_....._44_...._44www44_....._444_..............vvvvdddgGg_44__....._4│ss|,CCC,=========,,,D|ss",
        "│4_....._44_...._44www44_....._4444_dd_______________P4_ggg_44__....__4│ss|,,,C,=========,,,r|ss",
        "│4ooo.__44__...._44www44_....._44444dd&4444444444444444_..._444_....__4│ss|,a,C,=========,,,F|ss",
        "│4oooo._44_....._44www44_....._44444ddP4444444444444444_..._444_....._4│ss|tttC,=========,,,,|ss",
        "│4ooooo._4_....._444ww44_....._444__dd_444_____44444&44_..._444_....._4│ss|||||,=========,{{,|ss",
        "│4oooo.._4_....__444ww44_....._444_vvvv_4_.ggg_44____44_..._444_....._4│ss|   +,,,,,,,,,,,{{,|ss",
        "│44oo..._4_....__444ww44_....._444_vvvv_4_.gGg_4Pvvvv44_..._444__...._4│ss|T S|p,aaaa,,,,,,,p|ss",
        "│44_...._44_...__444ww44_....._44_.vvvv_4_.ggg.ddvvvv44_...__44__...._4│ss|||||||||||||+||||||ss",
        "│44_...._44_...._444ww44_....._44_.vvvv_4_.....ddvvvv44_...._44__...._4│ss;;;y;;;y;;;y;;;;;<|Uss",
        "│44_...._44_...._44www44__...._44__..._44_....._.vvvv_4_...._444_...._4│ss;;;y;;;y;;;y;;;;;<|Uss",
        "│4_....__44_...._44www444_...._444_..._44_....._4...._4__..._444_.ggg_4│ssyyyyyyyyyyyy;;;;;|||ss",
        "│4_...._444_...._44ww4444_...._444_..._44_....._4...._4__..._4444_gGgdddss;;;;;;;;;;;;;;;;;;;;ss",
        "│4_...._44_oo..._44ww4444_...._444_...._4_....._4...._44_...__444_gggdddss;;;;;;;;;;;;;;;;;;;;ss",
        "│4_...._44_ooo.._44ww4444_...._444_...._4_....._4...._44_...._4444_.._4│ssyyyyyyyyyyyy;;;;;;;;ss",
        "│4_...._44oooo.._44www444_...._444_...._4_....._4..._444_...._4444___44│ss;;;y;;;y;;;y;;;;;;;;ss",
        "│4_...._44oooo.._444www44_...._444_...._4_....._4_.._444_...._444444444│ss;;;y;;;y;;;y;;;;;;;;ss",
        "│4_...._44ooo..._4444ww44_...._444_...._4_....._4_..._44_...._444444444││││││││││││││││││││dd│││",
        "│4_...._444_...._4444ww44_...._444_...._4_....._4_...__4_...._44444444444444444444444444444dd44│",
        "│4_...._444_....._44www44_...._444_...._4_....._4_..oo_4_...._444______________444444444444dd44│",
        "│4_vvvv_44_..ggg._44www44_vvvv_444_...._4_....._4_..oo_4_...._44__.............____________ddP4│",
        "│4_vvvv_44_..gGg._44ww444_vvvv_444_...._4_o...._4_.ooo_4_...._44_ggg.....................vvvv&4│",
        "│4_vvvvdddd..ggg._44ww444_vvvv_444_...._4oo...._4_.ooo44_...._44_gGg.....................vvvv_4│",
        "│4_vvvvdddd_...._444ww444_vvvv_444_...._4ooo..._4_.oo__4_...._44_ggg.....................vvvv_4│",
        "│4&44__P4444____444www4444_dd_&444_...._4ooo.._4_....._4_...._44__.............._____....vvvv_4│",
        "│444444444444444444www__444ddP444__...._4ooo.._4_....._4_...._4444dd_________________________44│",
        "│444________4444444www..444dd4444_....._4ooo.._4_....._4_...._4444dd444444444444444444444444444│",
        "│44_vvvv...________www..___dd_444_....._4_o..._4_....._4_vvvv_444Pdd444444444444_____________44│",
        "│44_vvvv...........ccc........_44__...._4__..._4_.ggg._P_vvvv_44&_dd____________..........ggg_4│",
        "│44_vvvv...........ccc.....ggg._4__...._4_...._4_.gGg.dddvvvv_44_vvvv.....................gGg_4│",
        "│44_vvvv...........ww......gGg._44_...._44_..._4_.ggg.dddvvvv_44_vvvv.....................ggg_4│",
        "│44_....___________ww___...ggg_444_...._44_...._4__.__44______44_vvvv........................_4│",
        "│444dd__4444444444www444______4444_...._44_...._44___44444&44444_vvvv........._____________dd44│",
        "│44Pdd4&4444444444www444444444444_....._44_...._44444444444444444_____________4444444444444dd44│",
        "│444dd444444______www___444444444_....._44_...._444444444444444444444444444444444_____44444ddP4│",
        "│444dd4_____......www..._______44_.ggg._44_vvvv_44_____________44444_____________....._____dd_4│",
        "│444_ggg..........www......vvvv_4_.gGg._44_vvvv_4_ggg........._______....................vvvv_&│",
        "│444_gGg...........ccc.....vvvvddd.ggg._44_vvvvdddgGg.........................oo.........vvvv_4│",
        "│444_ggg...........ccc.....vvvvddd....__44_vvvvdddggg.......__________......oooooo.......vvvv_4│",
        "│444444____________www_____vvvv4P______444_____P4___________4444444444_____ooooooo_______vvvv_4│",
        "│4444444444444444444ww4444444&44444444444444444444444444444444444444444444444444444444444444444│",
        "││││││││││││││││││││││││││││││││││││││││││││││││││││││││││││││││││││││││││││││││││││││││││││││││"
      ],
      "vendingmachines": { "D": { "item_group": "vending_drink", "lootable": true }, "F": { "item_group": "vending_food", "lootable": true } },
      "place_monster": [ { "group": "GROUP_ZOMBIE", "x": [ 72, 95 ], "y": [ 24, 47 ], "repeat": [ 0, 4 ] } ],
      "palettes": [ "parametrized_linoleum_palette", "parametrized_walls_palette", "parametrized_carpets_palette" ],
      "terrain": {
        "4": [ [ "t_region_shrub_decorative", 12 ], "t_region_tree_shade", [ "t_region_groundcover_forest", 3 ] ],
        "+": "t_door_c",
        "U": "t_pavement",
        "d": "t_region_soil",
        "s": "t_sidewalk",
        "0": "t_window",
        "│": "t_drystone_wall_half",
        "<": "t_stairs_up",
        "G": "t_golf_hole",
        "P": "t_grass_long",
        "c": "t_dock",
        "_": "t_grass_long",
        ".": "t_region_grass",
        "o": "t_sand",
        ",": "t_floor",
        " ": { "param": "linoleum_color", "fallback": "t_linoleum_gray" },
        "T": { "param": "linoleum_color", "fallback": "t_linoleum_gray" },
        "S": { "param": "linoleum_color", "fallback": "t_linoleum_gray" },
        "&": "t_region_grass",
        "v": "t_grass_golf",
        "g": "t_grass_golf",
        "w": "t_water_sh",
        ";": "t_pavement",
        "Á": "t_pavement",
        "É": "t_pavement",
        "y": "t_pavement_y"
      },
      "furniture": {
        "P": "f_sign",
        "&": "f_trashcan",
        "T": "f_toilet",
        "C": "f_counter",
        "S": "f_sink",
        "a": "f_chair",
        "t": "f_desk",
        "{": "f_rack",
        "p": [ "f_indoor_plant_y", "f_indoor_plant" ],
        "r": "f_trashcan",
        "U": [ "f_dumpster", "f_recycle_bin" ]
      },
      "items": {
        "&": { "item": "SUS_trash_trashcan_public", "chance": 25, "repeat": 2 },
        "v": { "item": "golf_green", "chance": 10 },
        "t": { "chance": 75, "item": "SUS_office_mess" },
        "T": { "item": "SUS_toilet", "chance": 50 }
      },
      "place_loot": [ { "group": "cash_register_random", "x": 78, "y": [ 31, 34 ] } ],
      "place_item": [
        { "item": "gloves_golf", "chance": 40, "repeat": 2, "x": 76, "y": 28 },
        { "item": "gloves_golf", "chance": 40, "repeat": 2, "x": 77, "y": 28 },
        { "item": "hat_golf", "chance": 40, "repeat": 2, "x": 79, "y": 28 },
        { "item": "hat_golf", "chance": 40, "repeat": 2, "x": 80, "y": 28 },
        { "item": "golf_bag", "chance": 55, "x": 82, "y": 28 },
        { "item": "golf_bag", "chance": 55, "x": 83, "y": 28 },
        { "item": "golf_shoes", "chance": 40, "repeat": 2, "x": 90, "y": 28 },
        { "item": "golf_shoes", "chance": 40, "repeat": 2, "x": 91, "y": 28 },
        { "item": "gloves_golf", "chance": 40, "repeat": 2, "x": 76, "y": 29 },
        { "item": "gloves_golf", "chance": 40, "repeat": 2, "x": 77, "y": 29 },
        { "item": "hat_golf", "chance": 40, "repeat": 2, "x": 79, "y": 29 },
        { "item": "hat_golf", "chance": 40, "repeat": 2, "x": 80, "y": 29 },
        { "item": "golf_bag", "chance": 55, "x": 93, "y": 29 },
        { "item": "golf_bag", "chance": 55, "x": 83, "y": 29 },
        { "item": "golf_shoes", "chance": 40, "repeat": 2, "x": 90, "y": 29 },
        { "item": "golf_shoes", "chance": 40, "repeat": 2, "x": 91, "y": 29 },
        { "item": "golf_tee", "chance": 65, "repeat": 5, "x": 90, "y": 35 },
        { "item": "golf_tee", "chance": 65, "repeat": 5, "x": 91, "y": 35 },
        { "item": "golf_ball", "chance": 65, "repeat": 5, "x": 90, "y": 36 },
        { "item": "golf_ball", "chance": 65, "repeat": 5, "x": 91, "y": 36 }
      ],
      "vehicles": {
        "Á": { "vehicle": "parking_garage", "rotation": 0, "chance": 33 },
        "É": { "vehicle": "parking_garage", "rotation": 180, "chance": 33 }
      },
      "place_vehicles": [
        { "chance": 33, "rotation": 0, "vehicle": "golf_carts", "x": 83, "y": 39 },
        { "chance": 33, "rotation": 0, "vehicle": "golf_carts", "x": 79, "y": 39 },
        { "chance": 33, "rotation": 0, "vehicle": "golf_carts", "x": 75, "y": 39 },
        { "chance": 33, "rotation": 0, "vehicle": "golf_carts", "x": 83, "y": 45 },
        { "chance": 33, "rotation": 0, "vehicle": "golf_carts", "x": 79, "y": 45 },
        { "chance": 33, "rotation": 0, "vehicle": "golf_carts", "x": 75, "y": 45 }
      ],
      "toilets": { "T": {  } },
      "place_signs": [
        { "signage": "HOLE #18", "x": 63, "y": 3 },
        { "signage": "HOLE #17", "x": 34, "y": 4 },
        { "signage": "HOLE #16", "x": 1, "y": 9 },
        { "signage": "HOLE #15", "x": 7, "y": 54 },
        { "signage": "HOLE #14", "x": 15, "y": 13 },
        { "signage": "HOLE #13", "x": 59, "y": 17 },
        { "signage": "HOLE #12", "x": 28, "y": 25 },
        { "signage": "HOLE #11", "x": 29, "y": 55 },
        { "signage": "HOLE #10", "x": 3, "y": 63 },
        { "signage": "HOLE #9", "x": 32, "y": 69 },
        { "signage": "HOLE #8", "x": 38, "y": 34 },
        { "signage": "HOLE #7", "x": 53, "y": 32 },
        { "signage": "HOLE #6", "x": 55, "y": 58 },
        { "signage": "HOLE #5", "x": 48, "y": 37 },
        { "signage": "HOLE #4", "x": 47, "y": 69 },
        { "signage": "HOLE #3", "x": 93, "y": 64 },
        { "signage": "HOLE #2", "x": 65, "y": 57 },
        { "signage": "HOLE #1", "x": 93, "y": 50 }
      ]
    }
  },
  {
    "type": "mapgen",
    "method": "json",
    "om_terrain": "golfcourse_31_2ndfloor",
    "object": {
      "fill_ter": "t_floor",
      "rows": [
        "                        ",
        "                        ",
        "  ####################  ",
        "  #*hth*hth**hth*hth*#  ",
        "  #c*****************#  ",
        "  #ca**|||00||00|||**#  ",
        "  #ca**|T......C.f|**#  ",
        "  #ca**0..HTH..C.f0**#  ",
        "  #ca**+..HTH..CAC|**#  ",
        "  #ca**0..HTH..C.C0**#  ",
        "  #ca**|T.........|4*#  ",
        "  #ca**||0||++||0||**#  ",
        "  #ca****************#  ",
        "  #******************#  ",
        "  #################**#  ",
        "                   >*#  ",
        "                   >*#  ",
        "                   ###  ",
        "                        ",
        "                        ",
        "                        ",
        "                        ",
        "                        ",
        "                        "
      ],
      "palettes": [ "parametrized_walls_palette" ],
      "terrain": {
        ".": "t_floor",
        " ": "t_open_air",
        "#": "t_metal_railing",
        "*": "t_tile_flat_roof",
        "c": "t_tile_flat_roof",
        "a": "t_tile_flat_roof",
        "h": "t_tile_flat_roof",
        "t": "t_tile_flat_roof",
        "+": "t_door_c",
        "0": "t_window_domestic",
        ">": "t_stairs_down_no_roof",
        "4": "t_gutter_downspout"
      },
      "furniture": {
        "a": "f_stool",
        "A": "f_stool",
        "c": "f_counter",
        "C": "f_counter",
        "f": "f_glass_fridge",
        "h": "f_chair",
        "H": "f_chair",
        "t": "f_table",
        "T": "f_table"
      },
      "place_loot": [
        { "item": "television", "x": 8, "y": 6, "chance": 100 },
        { "item": "television", "x": 8, "y": 10, "chance": 100 },
        { "item": "stepladder", "x": 20, "y": 6, "chance": 20 }
      ],
      "items": {
        "T": { "item": "alcohol_bottled_canned", "chance": 20 },
        "t": { "item": "alcohol_bottled_canned", "chance": 20 },
        "f": { "item": "alcohol_bottled_canned", "chance": 30, "repeat": [ 2, 4 ] },
        "C": { "item": "snacks", "chance": 30, "repeat": [ 1, 2 ] }
      }
    }
  },
  {
    "type": "mapgen",
    "method": "json",
    "om_terrain": "golfcourse_31_roof",
    "object": {
      "fill_ter": "t_flat_roof",
      "rows": [
        "                        ",
        "                        ",
        "                        ",
        "                        ",
        "                        ",
        "       ------------     ",
        "       -.......A..-     ",
        "       -..........-     ",
        "       -.X........-     ",
        "       -..........-     ",
        "       -.......:..5     ",
        "       ------------     ",
        "                        ",
        "                        ",
        "                        ",
        "                        ",
        "                        ",
        "                        ",
        "                        ",
        "                        ",
        "                        ",
        "                        ",
        "                        ",
        "                        "
      ],
      "palettes": [ "roof_palette" ]
    }
  }
]
