[
  {
    "type": "mapgen",
    "method": "json",
    "om_terrain": [ [ "haz_sar_1_2", "haz_sar_1_1" ], [ "haz_sar_1_4", "haz_sar_1_3" ] ],
    "object": {
      "rows": [
        "                            ::::::::::::::::    ",
        "                            ::::::::::::::::    ",
        "                            ::::::::::::::::    ",
        " ffffffffffffffffffffffffffffffff:::::::|www-   ",
        " f  ,,,,,,,,,,,,,,,,,,,,,,      f:::::::wcdcw   ",
        " f  ,,:::::::::;:::::::::,  v   f:::::::+.C6w   ",
        " f  ,,:::::::::;:::::::::,      |LLLLLLL--+--ff ",
        " f  ,,:::::::::;:::::::::,,,,,,,,:::::::,,,,  f ",
        " f  ,,::::::::::::::::::::::::::::::::::,,,,  f ",
        " f  ,,::::::::::::::::::::::::::::::::::,     f ",
        " f  ,,::::::::::::::::::::::::::::::::::,     f ",
        " f  ,,::::::::::::::::::::::::::::::::::,     f ",
        " f  ,,::::;::::;::::;::::,,,,,,,,:::::::,     f ",
        " f  ,,::::;::::;::::;::::,,,,,,,,:::::::,     f ",
        " f  ,,::::;::::;::::;::::,,|-+-|-LLLLLLL-|    f ",
        " f  ,,::::;::::;::::;::::,,|4.6|~~~~~~~~~|    f ",
        " f  ,,,,,,,,,,,,,,,,,,,,,,,|4..`~~~~~~~~~|    f ",
        " f  ,,,,,,,,,,,,,,,,,,,,,,,|4..`~~~~~~~~l|    f ",
        " f |-000--000-0*0|000-000| |4..`~~~~~~~~l|    f ",
        " f |dddrFFddcW..2|2..Fddd| |s..|~~~~~~~~l|    f ",
        " f 0dC.....Cc....*....dCr| |4..?~~~~~~~~~|    f ",
        " f 0............a|b...d..| |4..|~~~~~~~~4|    f ",
        " f 0..C...|*-|-*-|b......| |4..`::::::::4|    f ",
        " f |rddd1p|.l|&.s|a36561p| |s..`~~~~~~~~4|    f ",
        " f |-000--|--|---|-------| |4..`~~~~~~~~~|    f ",
        " f                         |4.6|6~~~~~~~~|    f ",
        " f       ////////////////////+///LLLLLLL///   f ",
        " f      /////////////////////.//6~~~~~~~.///  f ",
        " f     //.......................~~~~~~~~..//  f ",
        " f    //.......................~~~~~~~~~..//  f ",
        " f   //........||||......A....~~~~~~~~~~..//  f ",
        " f   //...S....|EE......AA...~~~~~~~~~~~.9//  f ",
        " f   //...P....|EE......AA..~~~~~~~~~~~~.9//  f ",
        " f   //.``P``..|e.|.........~~~~~~~~~~~~.9//  f ",
        " f   //.`$$$`...............~~~~~~~~~~~~.9//  f ",
        " f   //.`$$$`6..............~~~~~~~~~~~~.9//  f ",
        " f   //.`$$$`......AAA......~~~~~~~~~~~~..//  f ",
        " f   //.`$$$`......AA.......~~~~~~~~~~~~..//  f ",
        " f   //.``P``.|G|...........SS6~~~~~~~~~..//  f ",
        " f   //...PPPPPPPPPPPPPPPPPPSS~~~~~~~~~~..//  f ",
        " f    //......|G|..............~~~~~~~~~.//   f ",
        " f     //.........V.V.V...........7788..//    f ",
        " f      /////////////////////////////////     f ",
        " f       ///////////////////////////////      f ",
        " f                                            f ",
        " f                                            f ",
        " ffffffffffffffffffffffffffffffffffffffffffffff ",
        "                                                "
      ],
      "palettes": [ "parametrized_linoleum_palette" ],
      "fill_ter": { "param": "linoleum_color", "fallback": "t_linoleum_white" },
      "terrain": {
        " ": [ [ "t_region_groundcover", 40 ], [ "t_region_shrub", 2 ], [ "t_region_tree", 1 ] ],
        "f": "t_chainfence",
        "|": "t_wall",
        "-": "t_wall",
        "/": "t_concrete_wall",
        "+": "t_door_locked",
        "*": "t_door_c",
        "?": "t_door_locked_alarm",
        "w": "t_window_alarm",
        "0": [ [ "t_curtains", 10 ], [ "t_window_open", 3 ], [ "t_window_domestic", 5 ] ],
        ",": "t_sidewalk",
        ":": "t_pavement",
        ";": "t_pavement_y",
        "$": "t_sewage",
        "P": "t_sewage_pipe",
        "S": "t_sewage_pump",
        "G": "t_grate",
        "E": "t_elevator",
        "e": "t_elevator_control_off",
        "v": "t_dirt",
        "V": "t_vat",
        "L": "t_door_metal_locked",
        "W": "t_water_dispenser",
        "~": "t_thconc_floor",
        "`": "t_wall_glass"
      },
      "furniture": {
        "1": "f_shredder",
        "2": "f_rack_coat",
        "3": "f_server",
        "4": "f_utility_shelf",
        "5": "f_console",
        "6": "f_console_broken",
        "7": "f_locker",
        "8": "f_utility_shelf",
        "9": "f_utility_shelf",
        "a": "f_air_conditioner",
        "b": "f_bookcase",
        "r": "f_trashcan",
        "F": "f_filing_cabinet",
        "A": "f_crate_c",
        "c": "f_counter",
        "C": "f_chair",
        "d": "f_desk",
        "l": "f_locker",
        "p": [ "f_indoor_plant", "f_indoor_plant_y" ],
        "s": "f_sink",
        "v": "f_vent_pipe"
      },
      "toilets": { "&": {  } },
      "liquids": { "W": { "liquid": "water_clean", "amount": [ 0, 80 ] } },
      "items": {
        "2": { "item": "coat_rack", "chance": 60, "repeat": 2 },
        "4": { "item": "toxic_dump_equipment", "chance": 85, "repeat": [ 1, 2 ] },
        "7": { "item": "tools_common", "chance": 85, "repeat": [ 1, 2 ] },
        "8": { "item": "tools_common", "chance": 85, "repeat": [ 1, 2 ] },
        "9": { "item": "cleaning", "chance": 85, "repeat": [ 1, 2 ] },
        "&": { "item": "SUS_toilet", "chance": 50 },
        "r": { "item": "SUS_trash_floor_light", "chance": 50 },
        "d": { "item": "office", "chance": 50 },
        "c": { "item": "SUS_office_desk", "chance": 60 },
        "b": { "item": "lab_bookshelves", "chance": 60, "repeat": 2 },
        "l": { "item": "cleaning", "chance": 85, "repeat": 2 },
        "A": [
          { "item": "toxic_dump_equipment", "chance": 85, "repeat": [ 1, 2 ] },
          { "item": "tools_common", "chance": 85, "repeat": [ 1, 2 ] },
          { "item": "cleaning", "chance": 85, "repeat": 2 }
        ],
        "F": { "item": "SUS_office_filing_cabinet", "chance": 50 }
      },
      "place_item": [ { "item": "id_military", "x": 22, "y": 20 }, { "item": "cleansuit", "x": 28, "y": 24 } ],
      "set": [
        { "square": "radiation", "amount": [ 10, 30 ], "x": 0, "y": 0, "x2": 23, "y2": 23 },
        { "square": "radiation", "amount": [ 10, 30 ], "x": 0, "y": 24, "x2": 23, "y2": 47 },
        { "square": "radiation", "amount": [ 10, 30 ], "x": 24, "y": 0, "x2": 47, "y2": 23 },
        { "square": "radiation", "amount": [ 10, 30 ], "x": 24, "y": 24, "x2": 47, "y2": 47 }
      ],
      "place_monster": [
        { "monster": "mon_hazmatbot", "x": 36, "y": 20 },
        { "monster": "mon_hazmatbot", "x": 13, "y": 29 },
        { "monster": "mon_hazmatbot", "x": 26, "y": 37 },
        { "monster": "mon_hazmatbot", "x": 22, "y": 29 }
      ],
      "computers": {
        "5": {
          "name": "SRCF Security Terminal",
          "security": 5,
          "options": [
            { "name": "Security Reminder [1055]", "action": "sr1_mess" },
            { "name": "Security Reminder [1056]", "action": "sr2_mess" },
            { "name": "Security Reminder [1057]", "action": "sr3_mess" },
            { "name": "Security Reminder [1058]", "action": "sr4_mess" },
            { "name": "EPA: Report All Potential Containment Breaches [3873643]", "action": "srcf_1_mess" },
            { "name": "SRCF: Internal Memo, EPA [2918024]", "action": "srcf_2_mess" },
            { "name": "CDC: Internal Memo, Standby [2918115]", "action": "srcf_3_mess" },
            { "name": "USARMY: SEAL SRCF [987167]", "action": "srcf_seal_order" },
            { "name": "COMMAND: REACTIVATE ELEVATOR", "action": "srcf_elevator" },
            { "name": "COMMAND: SEAL SRCF [4423]", "action": "srcf_seal" }
          ],
          "failures": [ { "action": "alarm" } ]
        }
      },
      "place_vehicles": [ { "vehicle": "military_cargo_trucks", "x": 37, "y": 35, "chance": 25, "status": 1, "rotation": 90, "fuel": 40 } ]
    }
  },
  {
    "type": "mapgen",
    "method": "json",
    "om_terrain": [ [ "haz_sar_1_2_2", "haz_sar_1_1_2" ], [ "haz_sar_1_4_2", "haz_sar_1_3_2" ] ],
    "object": {
      "rows": [
        "                                                ",
        "                                                ",
        "                                                ",
        "                                        -----   ",
        "                                        -...-   ",
        "                                        -...-   ",
        "                                        -----   ",
        "                                                ",
        "                                                ",
        "                                                ",
        "                                                ",
        "                                                ",
        "                                                ",
        "                                                ",
        "                           ---------------      ",
        "                           -.............-      ",
        "                           -.............-      ",
        "                           -.............-      ",
        "   ----------------------- -.............-      ",
        "   -.....................- -.............-      ",
        "   -.....................- -.............-      ",
        "   -.....................- -.............-      ",
        "   -.....................- -.............-      ",
        "   -.....................- -.............-      ",
        "   ----------------------- -.............-      ",
        "                           -.............-      ",
        "         -------------------|||||||||||||--     ",
        "        --||||||||||||||||||||||||||||||||--    ",
        "       --||||||||||||||||||||||||||||||||||-    ",
        "      --|||||||||||||||||||||||||||||||||||-    ",
        "     --||||||||||||||||||||||||||||||||||||-    ",
        "     -|||||||||||||||||||||||||||||||||||||-    ",
        "     -|||||||||||||||||||||||||||||||||||||-    ",
        "     -|||||||||||||||||||||||||||||||||||||-    ",
        "     -|||||||||||||||||||||||||||||||||||||-    ",
        "     -|||||||||||||||||||||||||||||||||||||-    ",
        "     -|||||||||||||||||||||||||||||||||||||-    ",
        "     -|||||||||||||||||||||||||||||||||||||-    ",
        "     -|||||||||||||||||||||||||||||||||||||-    ",
        "     --|||||||||||||||||||||||||||||||||||--    ",
        "      --|||||||||||||||||||||||||||||||||--     ",
        "       --|||||||||||||||||||||||||||||||--      ",
        "        --|||||||||||||||||||||||||||||--       ",
        "         -------------------------------        ",
        "                                                ",
        "                                                ",
        "                                                ",
        "                                                "
      ],
      "fill_ter": "t_open_air",
      "palettes": [ "roof_palette" ],
      "terrain": { "|": "t_concrete" }
    }
  },
  {
    "type": "mapgen",
    "method": "json",
    "om_terrain": [ [ "haz_sar_b_2", "haz_sar_b_1" ], [ "haz_sar_b_4", "haz_sar_b_3" ] ],
    "object": {
      "rows": [
        "###|-------------------|-------------------|####",
        "###|~~~~~~~~~~~~~~~~~~~|~~~~~~~~~~~~~~~~~~~|####",
        "###|~~~~~~~~~~~~~~~~~~~|~~~~~~~~~~~~~~~~~~~|####",
        "###|~~~~~~~~~~~~~~~~~~~|~~~~~~~~~~~~~~~~~~~|####",
        "###|~~~~~~~~~~~~~~~~~~~|~~~~~~~~~~~~~~~~~~~|####",
        "###|~~~~~~~~~~~~~~~~~~~|~~~~~~~~~~~~~~~~~~~|####",
        "###|~~~~~~~~~~~~~~~~~~~|~~~~~~~~~~~~~~~~~~~|####",
        "###|~~~~~~~~~~~~~~~~~~~|~~~~~~~~~~~~~~~~~~~|####",
        "###|----|~~~~~~~~~|----|----|~~~~~~~~~|----|####",
        "########|--LLLLL--|#########|--LLLLL--|#########",
        "#######         ^    ###  ####      ^###########",
        "######                               ###########",
        "####                                ############",
        "###                                 #|---------|",
        "#                                    |~~~~~~~~~|",
        "##                                   L~~~~~~~~~|",
        "##                                   L~~~~~~~~~|",
        "#                                    L~~~~~~~~~|",
        "##                                   L~~~~~~~~~|",
        "###                                  L~~~~~~~~~|",
        "##                                  ^|~~~~~~~~~|",
        "###                                 #|---------|",
        "####       |+%%-|                  #############",
        "####       |....|  ^               #############",
        "####|-%%%%-|-%%+|-|-LLLLL-|         #|---------|",
        "####|a....8|a....W|^.....a|          |~~~~~~~~~|",
        "####|.c5c..*......*.......|          L~~~~~~~~~|",
        "####|.cC..F|...|--|......8|          L~~~~~~~~~|",
        "####|.c....%...|99|......8|          L~~~~~~~~~|",
        "####|......%...+..|......8|          L~~~~~~~~~|",
        "####|l...C.%...|--|-L-|---|          L~~~~~~~~~|",
        "####|l.Fddd|...*EE|l..|####         ^|~~~~~~~~~|",
        "####|-|----|...*EE|l..|####         #|---------|",
        "######|....*...|e||-+-|##           ############",
        "######|&rsa|...|-|## ###           #############",
        "######|----|---|####              ##############",
        "###################              ###############",
        "#####|----------|#              |----------|####",
        "#####|~~~~~~~~~~|^              |~~~~~~~~~~|####",
        "#####|~~~~~~~~~~L               L~~~~~~~~~~|####",
        "#####|~~~~~~~~~~L               L~~~~~~~~~~|####",
        "#####|~~~~~~~~~~L               L~~~~~~~~~~|####",
        "#####|~~~~~~~~~~L               L~~~~~~~~~~|####",
        "#####|~~~~~~~~~~L               L~~~~~~~~~~|####",
        "#####|~~~~~~~~~~|              ^|~~~~~~~~~~|####",
        "#####|----------|            ###|----------|####",
        "#######################  ## ####################",
        "################################################"
      ],
      "fill_ter": "t_metal_floor",
      "terrain": {
        " ": "t_rock_floor",
        "|": "t_concrete_wall",
        "-": "t_concrete_wall",
        "+": "t_door_metal_c",
        "*": "t_door_metal_c",
        "L": "t_door_metal_locked",
        "#": "t_rock",
        "^": "t_gates_control_concrete",
        "%": "t_reinforced_glass",
        "E": "t_elevator",
        "e": "t_elevator_control_off",
        "W": "t_water_dispenser",
        "~": [ [ "t_sewage", 55 ], [ "t_dirtfloor", 25 ], [ "t_dirtmound", 20 ] ]
      },
      "furniture": {
        "s": "f_sink",
        "r": "f_trashcan",
        "d": "f_desk",
        "c": "f_counter",
        "C": "f_chair",
        "l": "f_locker",
        "5": "f_console",
        "8": "f_utility_shelf",
        "9": "f_utility_shelf",
        "a": "f_air_conditioner",
        "F": "f_filing_cabinet",
        "~": [ [ "f_null", 2 ], "f_wreckage", "f_rubble", "f_rubble_landfill" ]
      },
      "toilets": { "&": {  } },
      "//": "Reused from mx_toxic_waste, with some minor tweaks (less soapy water, more acid so it really looks more hazardous).",
      "liquids": {
        "W": { "liquid": "water_clean", "amount": [ 0, 80 ] },
        "~": [
          { "liquid": "chem_acetic_acid", "amount": [ 1, 4 ], "chance": 100 },
          { "liquid": "acetic_anhydride", "amount": [ 1, 4 ], "chance": 100 },
          { "liquid": "chem_acetone", "amount": [ 1, 4 ], "chance": 200 },
          { "liquid": "chem_formaldehyde", "amount": [ 1, 4 ], "chance": 140 },
          { "liquid": "chem_muriatic_acid", "amount": [ 1, 4 ], "chance": 100 },
          { "liquid": "chem_hydrogen_peroxide", "amount": [ 1, 4 ], "chance": 100 },
          { "liquid": "chem_hydrogen_peroxide_conc", "amount": [ 1, 2 ], "chance": 100 },
          { "liquid": "chem_nitric_acid", "amount": [ 1, 4 ], "chance": 200 },
          { "liquid": "chem_sulphuric_acid", "amount": [ 1, 4 ], "chance": 200 },
          { "liquid": "ammonia_liquid", "amount": [ 1, 4 ], "chance": 50 },
          { "liquid": "ammonia_hydroxide", "amount": [ 1, 4 ], "chance": 70 },
          { "liquid": "bleach", "amount": [ 1, 4 ], "chance": 80 },
          { "liquid": "lye", "amount": [ 1, 4 ], "chance": 10 },
          { "liquid": "lye_potassium", "amount": [ 1, 2 ], "chance": 50 },
          { "liquid": "ether", "amount": [ 1, 2 ], "chance": 120 },
          { "liquid": "chem_DMSO", "amount": [ 1, 4 ], "chance": 100 },
          { "liquid": "chem_chloroform", "amount": [ 1, 2 ], "chance": 130 },
          { "liquid": "chem_phenol", "amount": [ 1, 4 ], "chance": 100 },
          { "liquid": "chem_benzene", "amount": [ 1, 4 ], "chance": 100 },
          { "liquid": "chem_toluene", "amount": [ 1, 4 ], "chance": 100 },
          { "liquid": "chem_glycerol", "amount": [ 1, 4 ], "chance": 100 },
          { "liquid": "chem_ethanol", "amount": [ 1, 4 ], "chance": 10 },
          { "liquid": "methed_alcohol", "amount": [ 1, 4 ], "chance": 50 },
          { "liquid": "denat_alcohol", "amount": [ 1, 4 ], "chance": 10 },
          { "liquid": "chem_methanol", "amount": [ 1, 4 ], "chance": 10 },
          { "liquid": "diesel", "amount": [ 1, 4 ], "chance": 50 },
          { "liquid": "motor_oil", "amount": [ 1, 4 ], "chance": 10 },
          { "liquid": "chem_turpentine", "amount": [ 1, 4 ], "chance": 10 },
          { "liquid": "camphine", "amount": [ 1, 4 ], "chance": 100 },
          { "liquid": "soapy_water", "amount": [ 1, 4 ], "chance": 50 },
          { "liquid": "gasoline", "amount": [ 1, 4 ], "chance": 10 }
        ]
      },
      "//2": "Two itemgroups reused from mx_toxic_waste as they contain nothing super specific.",
      "items": {
        "8": { "item": "mechanics", "chance": 60, "repeat": [ 1, 2 ] },
        "9": { "item": "sewage_plant", "chance": 60, "repeat": [ 1, 2 ] },
        "r": { "item": "SUS_trash_floor_light", "chance": 50 },
        "d": { "item": "office", "chance": 50 },
        "c": { "item": "SUS_office_desk", "chance": 60 },
        "l": { "item": "cleaning", "chance": 60, "repeat": 2 },
        "F": { "item": "SUS_office_filing_cabinet", "chance": 50 },
        "&": { "item": "SUS_toilet", "chance": 50 },
        "~": [
          { "item": "SUS_trash_floor", "chance": 15 },
          { "item": "sewer", "chance": 15 },
          { "item": "hazardous_waste", "chance": 50 },
          { "item": "toxic_waste_mx_radioactive", "chance": 30 },
          { "item": "toxic_waste_mx_chems", "chance": 50 },
          { "item": "nanomaterials", "chance": 3 }
        ]
      },
      "place_item": [ { "item": "sarcophagus_access_code", "x": 20, "y": 31 } ],
      "set": [
        { "square": "radiation", "amount": [ 10, 30 ], "x": 0, "y": 0, "x2": 23, "y2": 23 },
        { "square": "radiation", "amount": [ 10, 30 ], "x": 0, "y": 24, "x2": 23, "y2": 47 },
        { "square": "radiation", "amount": [ 10, 30 ], "x": 24, "y": 0, "x2": 47, "y2": 23 },
        { "square": "radiation", "amount": [ 10, 30 ], "x": 24, "y": 24, "x2": 47, "y2": 47 }
      ],
      "monster": { " ": { "monster": "mon_zombie", "chance": 10 } },
      "//3": "The government would not put live humans into a highly irradiated cavern with lots of maneating zombies.  Right?  Right?!",
      "monsters": { "~": { "monster": "GROUP_VANILLA_NO_FERAL", "chance": 20, "density": 0.1 } },
      "computers": {
        "5": {
          "name": "SRCF Security Terminal",
          "security": 5,
          "options": [
            { "name": "Security Reminder [1055]", "action": "sr1_mess" },
            { "name": "Security Reminder [1056]", "action": "sr2_mess" },
            { "name": "Security Reminder [1057]", "action": "sr3_mess" },
            { "name": "Security Reminder [1058]", "action": "sr4_mess" },
            { "name": "EPA: Report All Potential Containment Breaches [3873643]", "action": "srcf_1_mess" },
            { "name": "SRCF: Internal Memo, EPA [2918024]", "action": "srcf_2_mess" },
            { "name": "CDC: Internal Memo, Standby [2918115]", "action": "srcf_3_mess" },
            { "name": "USARMY: SEAL SRCF [987167]", "action": "srcf_seal_order" },
            { "name": "COMMAND: REACTIVATE ELEVATOR", "action": "srcf_elevator" }
          ],
          "failures": [ { "action": "alarm" } ]
        }
      }
    }
  },
  {
    "id": "hazardous_waste",
    "type": "item_group",
    "items": [
      { "item": "sewage", "container-item": "55gal_drum", "charges": [ 26, 126 ], "prob": 40 },
      { "item": "water_sewage", "container-item": "55gal_drum", "charges": [ 26, 126 ], "prob": 40 },
      { "prob": 2, "group": "meat_tainted_55gal_drum_3_20" },
      { "group": "toxic_waste_mx_chems", "prob": 35 },
      { "item": "55gal_drum", "prob": 50 }
    ]
  },
  {
    "id": "nanomaterials",
    "type": "item_group",
    "subtype": "collection",
    "entries": [ { "item": "nanomaterial", "prob": 100 } ]
  },
  {
    "type": "item_group",
    "id": "meat_tainted_55gal_drum_3_20",
    "subtype": "collection",
    "//": "This group was created automatically and may contain errors.",
    "container-item": "55gal_drum",
    "entries": [ { "item": "meat_tainted", "count": [ 3, 20 ] } ]
  }
]
