[
  {
    "method": "json",
    "om_terrain": "headshop",
    "type": "mapgen",
    "weight": 100,
    "object": {
      "fill_ter": "t_floor",
      "rows": [
        "__d_____sssdd___d___d___",
        "________sss_____________",
        "__|----|sss|----|4|-|4_d",
        "d_-S..H-sss-HttH|-|^|-|_",
        "__-S..^|++||..........|_",
        "__-S......bb..........|d",
        "__|t.H........#...{..{|_",
        "__|...........#...{..{|_",
        "d_|...........#...{..{|_",
        "d_|...........#...{..{|_",
        "__|##ccc##....c...{..{|d",
        "__|&.u...c....c...{..{|_",
        "d_|...................|_",
        "__|{{{{{.............H|d",
        "d_|||||||||||-+--|...t|d",
        "__U_d___DD5s|{..u-...H|d",
        "___d____ppps|{...+...^|_",
        "________ppps|{{##-..|||d",
        "d___d___ppps|||||||%|L|_",
        "________pppsa....%..a.|_",
        "__d_____ppps|ll|<|ll|R|_",
        "d_____d_ppps|||||||||||_",
        "______________d_________",
        "___d______dddd_____d__d_"
      ],
      "terrain": {
        "+": "t_door_glass_c",
        "-": "t_wall_glass",
        ".": "t_floor",
        "4": "t_tree_pine",
        "D": "t_pavement",
        "_": "t_grass",
        "a": "t_door_c",
        "d": "t_dirt",
        "p": "t_pavement",
        "s": "t_sidewalk",
        "|": "t_wall_p",
        "<": "t_stairs_up",
        "5": "t_gutter_downspout",
        "U": "t_grass"
      },
      "furniture": {
        "#": "f_displaycase",
        "&": "f_trashcan",
        "D": [ "f_dumpster", "f_recycle_bin" ],
        "H": "f_armchair",
        "S": "f_sofa",
        "^": [ "f_indoor_plant_y", "f_indoor_plant" ],
        "b": "f_bench",
        "c": "f_counter",
        "l": "f_locker",
        "t": "f_table",
        "{": "f_rack",
        "R": "f_sink",
        "%": "f_beaded_door",
        "u": "f_stool"
      },
      "nested": {
        "U": {
          "chunks": [
            [ "roof_6x6_greenhouse_1", 25 ],
            [ "roof_6x6_garden_4", 25 ],
            [ "roof_6x6_garden_1", 25 ],
            [ "roof_6x6_garden_2", 25 ]
          ]
        }
      },
      "toilets": { "L": {  } },
      "place_nested": [ { "chunks": [ [ "null", 2 ], [ "headshop_graffiti_snippet", 98 ] ], "x": 22, "y": 19 } ],
      "place_item": [
        { "item": "rolling_paper", "repeat": 1, "x": 13, "y": 3 },
        { "item": "rolling_paper", "repeat": 1, "x": 3, "y": 6 },
        { "item": "pipe_tobacco", "repeat": 1, "x": 18, "y": 6 },
        { "item": "pipe_glass", "repeat": 1, "x": 21, "y": 7 },
        { "item": "crackpipe", "repeat": 1, "x": 18, "y": 8 },
        { "item": "pipe_glass", "repeat": 1, "x": 21, "y": 8 },
        { "item": "crackpipe", "repeat": 1, "x": 4, "y": 10 },
        { "item": "pipe_glass", "repeat": 1, "x": 4, "y": 10 },
        { "item": "pipe_glass", "repeat": 1, "x": 7, "y": 10 },
        { "item": "pipe_glass", "repeat": 1, "x": 18, "y": 10 },
        { "item": "crackpipe", "repeat": 1, "x": 21, "y": 10 }
      ],
      "place_items": [
        { "chance": 35, "item": "clothing_outdoor_torso", "x": [ 13, 14 ], "y": 20 },
        { "chance": 45, "item": "stoner", "x": 14, "y": 17 },
        { "chance": 45, "item": "jar_weed", "x": 13, "y": [ 16, 17 ] },
        { "chance": 45, "item": "jar_weed", "x": [ 3, 5 ], "y": 13, "repeat": [ 2, 4 ] },
        { "chance": 45, "item": "stoner", "x": 14, "y": 11 },
        { "chance": 45, "item": "stoner", "x": 8, "y": 10 },
        { "chance": 45, "item": "stoner", "x": [ 4, 5 ], "y": 10 },
        { "chance": 45, "item": "stoner", "x": 14, "y": [ 8, 9 ] },
        { "chance": 65, "item": "misc_smoking", "x": 15, "y": 17 },
        { "chance": 65, "item": "misc_smoking", "x": 13, "y": 15 },
        { "chance": 65, "item": "misc_smoking", "x": 9, "y": 10 },
        { "chance": 65, "item": "misc_smoking", "x": 3, "y": 10 },
        { "chance": 65, "item": "misc_smoking", "x": 14, "y": [ 6, 7 ] }
      ]
    }
  },
  {
    "type": "mapgen",
    "method": "json",
    "om_terrain": "headshop_roof",
    "object": {
      "fill_ter": "t_floor",
      "rows": [
        "                        ",
        "                        ",
        "  |22222222222222222223 ",
        "  |...................3 ",
        "  |...................3 ",
        "  |...................3 ",
        "  |...................3 ",
        "  |...................3 ",
        "  |...................3 ",
        "  |...................3 ",
        "  |...................3 ",
        "  |...................3 ",
        "  |...................3 ",
        "  |...................3 ",
        "  |-------5-|........43 ",
        "            %%%+%0%%%%% ",
        "            %r*****%II% ",
        "            %r**C%%%*h% ",
        "            %r*C*%y***0 ",
        "            %r***+****% ",
        "            %r**>%ffyB% ",
        "            %%0%%%%%0%% ",
        "                        ",
        "                        "
      ],
      "palettes": [ "roof_palette" ],
      "terrain": { "*": "t_floor", "%": "t_wall_p", "+": "t_door_locked", ">": "t_stairs_down", "0": "t_window_domestic" },
      "furniture": {
        "B": "f_bookcase",
        "f": "f_filing_cabinet",
        "I": "f_desk",
        "h": "f_chair",
        "y": [ "f_indoor_plant_y", "f_indoor_plant" ]
      },
      "items": {
        "I": { "item": "office", "chance": 30 },
        "f": { "item": "office_paper", "chance": 30 },
        "y": { "item": "trash", "chance": 20, "repeat": [ 2, 4 ] },
        "C": { "item": "stoner", "chance": 20, "repeat": [ 2, 4 ] },
        "r": { "item": "jar_weed", "chance": 20, "repeat": [ 2, 4 ] }
      },
      "place_nested": [
        {
          "chunks": [
            [ "null", 20 ],
            [ "roof_2x2_utilities_b", 15 ],
            [ "roof_2x2_utilities_c", 5 ],
            [ "roof_2x2_utilities_d", 40 ],
            [ "roof_2x2_utilities", 50 ],
            [ "roof_2x2_golf", 20 ],
            [ "roof_3x3_wine", 30 ]
          ],
          "x": [ 13, 18 ],
          "y": [ 9, 11 ]
        },
        {
          "chunks": [ [ "roof_4x4_party", 5 ], [ "roof_4x4_utility", 10 ], [ "roof_4x4_utility_1", 10 ], [ "roof_6x6_greenhouse_3", 80 ] ],
          "x": [ 4, 5 ],
          "y": 8
        },
        { "chunks": [ [ "roof_16x16_help", 20 ], [ "null", 80 ] ], "x": 4, "y": 3 }
      ]
    }
  },
  {
    "type": "mapgen",
    "method": "json",
    "om_terrain": "headshop_upper_roof",
    "object": {
      "fill_ter": "t_flat_roof",
      "rows": [
        "                        ",
        "                        ",
        "                        ",
        "                        ",
        "                        ",
        "                        ",
        "                        ",
        "                        ",
        "                        ",
        "                        ",
        "                        ",
        "                        ",
        "                        ",
        "                        ",
        "                        ",
        "            |--------53 ",
        "            |.........3 ",
        "            |......:..3 ",
        "            |.........3 ",
        "            |..&......3 ",
        "            |.......=.3 ",
        "            |.........3 ",
        "                        ",
        "                        "
      ],
      "palettes": [ "roof_palette" ]
    }
  },
  {
    "type": "mapgen",
    "method": "json",
    "nested_mapgen_id": "headshop_graffiti_snippet",
    "object": { "mapgensize": [ 1, 1 ], "place_graffiti": [ { "snippet": "headshop_graffiti", "x": 0, "y": 0 } ] }
  }
]
