[
  {
    "id": "pickup_corpses",
    "type": "vehicle",
    "name": "Pickup Truck",
    "blueprint": [
      [ "-o--+o-" ],
      [ "==='#'|" ],
      [ "==='#'|" ],
      [ "-o--+o-" ]
    ],
    "parts": [
      { "x": 0, "y": 0, "parts": [ "frame#cross", "seat#windshield_front", "seatbelt", "controls", "stereo" ] },
      { "x": 0, "y": 0, "parts": [ "dashboard", "vehicle_clock", "vehicle_alarm", "horn_car" ] },
      { "x": 0, "y": 0, "parts": [ "roof" ] },
      { "x": 0, "y": -1, "parts": [ "frame#vertical_left", "door#nw" ] },
      { "x": 0, "y": 1, "parts": [ "frame#cross", "seat#windshield_front", "seatbelt", "roof" ] },
      { "x": 0, "y": 2, "parts": [ "frame#vertical_right", "door#ne" ] },
      { "x": 1, "y": -1, "parts": [ "frame#vertical_T_left", "windshield#wheel_left" ] },
      { "x": 1, "y": -1, "parts": [ "wheel_mount_medium_steerable", "wheel" ] },
      { "x": 1, "y": 0, "parts": [ "frame#horizontal_2", "windshield#cover_left" ] },
      { "x": 1, "y": 1, "parts": [ "frame#horizontal_2", "windshield#cover_right" ] },
      { "x": 1, "y": 2, "parts": [ "frame#vertical_T_right", "windshield#wheel_right" ] },
      { "x": 1, "y": 2, "parts": [ "wheel_mount_medium_steerable", "wheel" ] },
      { "x": 2, "y": -1, "parts": [ "frame#nw", "halfboard#nw", "headlight" ] },
      { "x": 2, "y": 0, "parts": [ "frame#horizontal_front", "halfboard#cover_left" ] },
      { "x": 2, "y": 0, "parts": [ "engine_v6", "alternator_truck", "battery_car" ] },
      { "x": 2, "y": 1, "parts": [ "frame#horizontal_front", "halfboard#cover_right" ] },
      { "x": 2, "y": 2, "parts": [ "frame#ne", "halfboard#ne", "headlight" ] },
      { "x": -1, "y": -1, "parts": [ "frame#vertical_left", "windshield#sw" ] },
      { "x": -1, "y": 0, "parts": [ "frame#cross", "windshield#horizontal_rear", "roof" ] },
      { "x": -1, "y": 1, "parts": [ "frame#cross", "windshield#horizontal_rear", "roof" ] },
      { "x": -1, "y": 2, "parts": [ "frame#vertical_right", "windshield#se" ] },
      { "x": -2, "y": -1, "parts": [ "frame#vertical_left", "halfboard#vertical_left" ] },
      { "x": -2, "y": -1, "parts": [ { "part": "tank", "fuel": "gasoline" } ] },
      { "x": -2, "y": 0, "parts": [ "frame#cross", "cargo_space", "muffler" ] },
      { "x": -2, "y": 1, "parts": [ "frame#cross", "cargo_space" ] },
      { "x": -2, "y": 2, "parts": [ "frame#vertical_right", "halfboard#vertical_right" ] },
      { "x": -3, "y": -1, "parts": [ "frame#vertical_left", "halfboard#wheel_left" ] },
      { "x": -3, "y": -1, "parts": [ "wheel_mount_medium", "wheel" ] },
      { "x": -3, "y": 0, "parts": [ "frame#cross", "cargo_space" ] },
      { "x": -3, "y": 1, "parts": [ "frame#cross", "cargo_space" ] },
      { "x": -3, "y": 2, "parts": [ "frame#vertical_right", "halfboard#wheel_right" ] },
      { "x": -3, "y": 2, "parts": [ "wheel_mount_medium", "wheel" ] },
      { "x": -4, "y": -1, "parts": [ "frame#sw", "halfboard#sw" ] },
      { "x": -4, "y": 0, "parts": [ "frame#horizontal_rear", "cargo_space" ] },
      { "x": -4, "y": 1, "parts": [ "frame#horizontal_rear", "cargo_space" ] },
      { "x": -4, "y": 2, "parts": [ "frame#se", "halfboard#se" ] }
    ],
    "items": [
      { "x": -2, "y": 0, "chance": 90, "item_groups": [ "corpse_in_body_bag" ] },
      { "x": -2, "y": 1, "chance": 90, "item_groups": [ "corpse_in_body_bag" ] },
      { "x": -3, "y": 0, "chance": 90, "item_groups": [ "corpse_in_body_bag" ] },
      { "x": -3, "y": 1, "chance": 90, "item_groups": [ "corpse_in_body_bag" ] },
      { "x": -4, "y": 0, "chance": 90, "item_groups": [ "corpse_in_body_bag" ] },
      { "x": -4, "y": 1, "chance": 90, "item_groups": [ "corpse_in_body_bag" ] }
    ]
  },
  {
    "type": "mapgen",
    "method": "json",
    "nested_mapgen_id": "pile_bodybag_corpses",
    "object": {
      "mapgensize": [ 3, 3 ],
      "place_items": [ { "item": "corpse_in_body_bag", "x": [ 0, 2 ], "y": [ 0, 2 ], "chance": 100, "repeat": [ 20, 40 ] } ]
    }
  },
  {
    "type": "mapgen",
    "method": "json",
    "om_terrain": [
      [ "hospital_3", "hospital_2", "hospital_1" ],
      [ "hospital_6", "hospital_5", "hospital_4" ],
      [ "hospital_9", "hospital_8", "hospital_7" ]
    ],
    "weight": 250,
    "object": {
      "fill_ter": "t_dirt",
      "rows": [
        "_______________________________________________________########;########",
        "_______________________________________________________#...cT#...#Tc...#",
        "_:__=_:__=_:__=_:____=____:__=_:__=_:__=_:__=_:__=_:___#BB...+...+...BB#",
        "_:____:____:____:_________:____:____:____:____:____:___#BB...+...+...BB#",
        "_:____:____:____:_________:____:____:____:____:____:___#....l#...#l....#",
        "_:____:____:____:_________:____:____:____:____:____:___#######...#######",
        "_:____:____:____:_________:____:____:____:____:____:___#....l#...#l....#",
        "_:____:____:____:_________:____:____:____:____:____:___#BB...+...+...BB#",
        "_______________________________________________________#BB...+...+...BB#",
        "####################//####xxxxxxxxxxxxxxxxxxxxxxxxxx#;;#...cT#...#Tc...#",
        "#&#&#&#&#&#sssss#.........TbbbbTbbbbTbbbbTbbbbTbbbbT#``#######...#######",
        "#.#.#.#.#.#.....#..................................b#``#...cT#...#Tc...#",
        "#+#+#+#+#+#.....+..................................b#``#BB...+...+...BB#",
        "#...............+..................................b#``#BB...+...+...BB#",
        "#...............#..................................b#``#....l#...#l....#",
        "#################F........xCCCCCCCCCx..............T#``#######...#######",
        "#...............#.........x.c.c.c.c.x..............b#``#....l#...#l....#",
        "#...............+........./.........x..............b#``#BB...+...+...BB#",
        "#+#+#+#+#+#.....+........./.........x..............b#``#BB...+...+...BB#",
        "#.#.#.#.#.#.....#.........x.........x..............b#``#...cT#...#Tc...#",
        "#&#&#&#&#&#sssss#.D.....F.#rr###+####.DF.TbbbbTbbbbT#``#######///#######",
        "####################//########r....d#################``#l.rrr#...#rrr.l#",
        "#...ll...x...ll...x....#SSSTf#r...cd#s.&#&.s#s.&#&.s#``#l....!...!....l#",
        "#.TB..BT.x.TB..BT.x....#.....+.....L#...#...#...#...#``#l.rrr#...#rrr.l#",
        "#r.B..B.rxr.B..B.rx....#########!#####+###+###+###+##;;#######...#######",
        "#r......rxr......rx....................................................#",
        "#xxx//xxxxxxx//xxxx....................................................;",
        "#......................................................................#",
        "#......................####################...#######;;#######...#######",
        "#......................x...........l#8....#...#rrr.l#``#l.rrr#...#rrr.l#",
        "#....................../.....A..BT.l#8....!...!....l#``#l....!...!....l#",
        "#....................../.....?..B..r#88888#...#rrr.l#``#l.rrr#...#rrr.l#",
        "#5.....................x...........r#######///#######``#######///#######",
        "##X#################///##############...cT#...#Tc...#``#...cT#...#Tc...#",
        "#H.......H#.......l#...x...........l#BB...+...+...BB#``#BB...+...+...BB#",
        "#H.......H#r.TBBT..#.../.....TBBT...#BB...+...+...BB#``#BB...+...+...BB#",
        "#H.......H#r..BB...#.../......BB...r#....l#...#l....#``#....l#...#l....#",
        "#H.......H#........#...x...........r#######...#######``#######...#######",
        "###########xxx//xxx#...##############....l#...#l....#``#....l#...#l....#",
        "#l........x............x...........R#BB...+...+...BB#``#BB...+...+...BB#",
        "#R.TB..A../............/.....6.....R#BB...+...+...BB#``#BB...+...+...BB#",
        "#R..B..?../............/.....*.....R#...cT#...#Tc...#``#...cT#...#Tc...#",
        "#.........x............x.......22..R#######...#######``#######...#######",
        "###########xxx//xxx#...##############...cT#...#Tc...#``#...cT#...#Tc...#",
        "#..KKKKK..#........#...x...........r#BB...+...+...BB#``#BB...+...+...BB#",
        "#N........#r..BB...#.../......BB...r#BB...+...+...BB#``#BB...+...+...BB#",
        "#Y.......8#r.TBBT..#.../.....TBBT...#....l#...#l....#``#....l#...#l....#",
        "#...TT...8#.......l#...x...........l#######...#######``#######...#######",
        "#######!#############///#############....l#...#l....#``#....l#...#l....#",
        ";``````````````````;....bbb.bbb.bbb.#BB...+...+...BB#``#BB...+...+...BB#",
        ";``````````````````;...............b#BB...+...+...BB#``#BB...+...+...BB#",
        "######;;############...............b#...cT#...#Tc...#``#...cT#...#Tc...#",
        "#&..#....LLLLLLLLLL#...............b#######...#######``#######...#######",
        "#...+..............!................#...cT#...#Tc...#``#...cT#...#Tc...#",
        "#..s#.....bbb.rrrr.#...............b#BB...+...+...BB#``#BB...+...+...BB#",
        "#####....###########...............b#BB...#...+...BB#``#BB...#...+...BB#",
        "#kddd...C#d..ddd..d#...............b#....l#...#l....#``#....l#...#l....#",
        "w..c....C#dc..c..cd#................#######///#######;;#######///#######",
        "#.......C#d.......d#.............................................#88888#",
        "w........+.........!.............................................!....8#",
        "#SSSSSS.f#lllkkkrrr#.............................................#....8#",
        "####################xxxxxxxxxxxx///x##+###+###+###+##;;#######///#######",
        "x...................................#...#...#...#...#``#...cT#...#Tc...#",
        "x..bbbb..bbbb..bbbb..bbbb..bbbb....4#s.&#&.s#s.&#&.s#``#BB...+...+...BB#",
        "x..TTTT..TTTT..TTTT..TTTT..TTTT....4#################``#BB...+...+...BB#",
        "x..bbbb..bbbb..bbbb..bbbb..bbbb....4#44444#ssss#ssss#``#....l#...#l....#",
        "x...................................#...............#``#######...#######",
        "x..bbbb..bbbb..bbbb..bbbb..bbbb.....+......99999999.;``#....l#...#l....#",
        "x..TTTT..TTTT..TTTT..TTTT..TTTT.....+......99999999.;``#BB...+...+...BB#",
        "x..bbbb..bbbb..bbbb..bbbb..bbbb.....#...............#``#BB...+...+...BB#",
        "x...............................444.#44444#oooo#ffff#``#...cT#...#Tc...#",
        "xxxxxxxxxxxxxxxxxxxxxxxxxxxxxx#######################;;#################"
      ],
      "palettes": [ "hospital" ],
      "terrain": { "5": "t_floor", "H": "t_floor", "X": [ "t_door_metal_locked", "t_door_metal_elocked" ], "=": "t_pavement" },
      "furniture": { "H": "f_locker" },
      "vendingmachines": { "D": { "item_group": "vending_drink", "lootable": true }, "F": { "item_group": "vending_food", "lootable": true } },
      "computers": {
        "5": {
          "name": "Medical Supply Access",
          "security": 2,
          "options": [ { "name": "Unlock Door", "action": "unlock" } ],
          "failures": [ { "action": "shutdown" }, { "action": "alarm" } ]
        },
        "6": {
          "name": "Centrifuge",
          "options": [ { "name": "Analyze blood", "action": "blood_anal" } ],
          "failures": [ { "action": "destroy_blood" } ]
        }
      },
      "vehicles": { "=": { "vehicle": "pickup_corpses", "chance": 10, "rotation": 270, "status": 1 } },
      "nested": { "=": { "chunks": [ [ "null", 70 ], [ "pile_bodybag_corpses", 30 ] ] } },
      "items": {
        "b": { "item": "magazines", "chance": 50 },
        "B": { "item": "hospital_bed", "chance": 80 },
        "f": { "item": "SUS_fridge_breakroom", "chance": 90 },
        "d": { "item": "office", "chance": 80 },
        "C": { "item": "office", "chance": 20 },
        "S": { "item": "bed", "chance": 60 },
        "r": { "item": "hospital_medical_items", "chance": 30 },
        "R": { "item": "hospital_lab", "chance": 70 },
        "l": { "item": "surgery", "chance": 80 },
        "L": { "item": "allclothes", "chance": 90 },
        "8": { "item": "cleaning", "chance": 70 },
        "9": { "item": "produce", "chance": 40 },
        "T": { "item": "snacks", "chance": 50 },
        "2": { "item": "hospital_samples", "chance": 50 },
        "k": { "item": "doctors_books", "chance": 60 },
        "K": { "item": "hospital_oxygen", "chance": 85 },
        "H": [
          { "item": "harddrugs", "chance": 60 },
          { "item": "gear_medical", "chance": 60, "repeat": [ 1, 3 ] },
          { "item": "drugs_analgesic", "chance": 60, "repeat": [ 1, 3 ] },
          { "item": "drugs_rare", "chance": 60 },
          { "item": "surgery", "chance": 60 }
        ]
      },
      "monster": { "B": { "monster": "mon_civilian_icu", "chance": 10 } },
      "place_monster": [
        { "group": "GROUP_HOSPITAL", "x": [ 0, 23 ], "y": [ 0, 23 ], "repeat": [ 15, 20 ] },
        { "group": "GROUP_HOSPITAL", "x": [ 25, 46 ], "y": [ 1, 22 ], "repeat": [ 15, 20 ] },
        { "group": "GROUP_HOSPITAL", "x": [ 49, 70 ], "y": [ 1, 22 ], "repeat": [ 15, 20 ] },
        { "group": "GROUP_HOSPITAL", "x": [ 1, 22 ], "y": [ 25, 46 ], "repeat": [ 15, 20 ] },
        { "group": "GROUP_HOSPITAL", "x": [ 25, 46 ], "y": [ 25, 46 ], "repeat": [ 15, 20 ] },
        { "group": "GROUP_HOSPITAL", "x": [ 49, 70 ], "y": [ 25, 46 ], "repeat": [ 15, 20 ] },
        { "group": "GROUP_HOSPITAL", "x": [ 1, 22 ], "y": [ 49, 70 ], "repeat": [ 15, 20 ] },
        { "group": "GROUP_HOSPITAL", "x": [ 25, 46 ], "y": [ 49, 70 ], "repeat": [ 15, 20 ] },
        { "group": "GROUP_HOSPITAL", "x": [ 49, 70 ], "y": [ 49, 70 ], "repeat": [ 15, 20 ] }
      ]
    }
  },
  {
    "type": "mapgen",
    "method": "json",
    "om_terrain": [
      [ "hospital_3_roof", "hospital_2_roof", "hospital_1_roof" ],
      [ "hospital_6_roof", "hospital_5_roof", "hospital_4_roof" ],
      [ "hospital_9_roof", "hospital_8_roof", "hospital_7_roof" ]
    ],
    "weight": 250,
    "object": {
      "fill_ter": "t_flat_roof",
      "rows": [
        "                                                       -----------------",
        "                                                       -...............-",
        "                                                       -...............-",
        "                                                       -...............-",
        "                                                       -...............-",
        "                                                       -...............-",
        "                                                       -...............-",
        "                                                       -...............-",
        "                                                       -...............-",
        "--------------------------------------------------------...............-",
        "-......................................................................-",
        "-......................................................................-",
        "-......................................................................-",
        "-......................................................................-",
        "-......................................................................-",
        "-......................................................................-",
        "-......................................................................-",
        "-......................................................................-",
        "-......................................................................-",
        "-......................................................................-",
        "-......................................................................-",
        "-......................................................................-",
        "-......................................................................-",
        "-......................................................................-",
        "-......................................................................-",
        "-......................................................................-",
        "-......................................................................-",
        "-......................................................................-",
        "-......................................................................-",
        "-......................................................................-",
        "-......................................................................-",
        "-......................................................................-",
        "-......................................................................-",
        "-......................................................................-",
        "-......................................................................-",
        "-......................................................................-",
        "-......................................................................-",
        "-......................................................................-",
        "-......................................................................-",
        "-......................................................................-",
        "-......................................................................-",
        "-......................................................................-",
        "-......................................................................-",
        "-......................................................................-",
        "-......................................................................-",
        "-......................................................................-",
        "-......................................................................-",
        "-......................................................................-",
        "-......................................................................-",
        "-......................................................................-",
        "-......................................................................-",
        "-......................................................................-",
        "-......................................................................-",
        "-......................................................................-",
        "-......................................................................-",
        "-......................................................................-",
        "-......................................................................-",
        "-......................................................................-",
        "-......................................................................-",
        "-......................................................................-",
        "-......................................................................-",
        "-......................................................................-",
        "-......................................................................-",
        "-......................................................................-",
        "-......................................................................-",
        "-......................................................................-",
        "-......................................................................-",
        "-......................................................................-",
        "-......................................................................-",
        "-......................................................................-",
        "-......................................................................-",
        "------------------------------------------------------------------------"
      ],
      "palettes": [ "roof_palette" ]
    }
  }
]
