[
    {
        "type" : "mapgen",
        "om_terrain" : ["house"],
        "method" : "json",
        "weight" : 200,
        "object" : {
            "fill_ter" : "t_floor",
            "rows" : [
                ".........#ss#...........",
                ".........#ss#...........",
                ".........#ss#...........",
                ".........#ss#...........",
                ".........#ss#...........",
                ".........#ss#...........",
                ".|-v-v-|.#ss#.|-v-v-|...",
                ".| @@d |.#ss#.| d@@ |...",
                ".v @@  v.#ss#.v  @@ v...",
                ".|     v.#ss#.v     |...",
                ".v     v.#ss#.v     v...",
                ".|     |.#ss#.|     |...",
                ".|+|K  |-v;;v-|  K|+|...",
                ".|d|K P|P    P|P K|d|...",
                ".|-|-+-|o    o|-+-|-|...",
                "...|D             |.....",
                "...|c       ????? v.....",
                "...vO  Cch  ?   ? |.....",
                "...vc  Sch  ? n ? |-v-|.",
                "...|cfccch        +   |.",
                "...|--vv---+++--v-|S Bv.",
                "..........|LYW|...|t B|.",
                "..........|---|...|-v-|.",
                "........................"
            ],
            "terrain" : {
                "|" : "t_wall",
                "-" : "t_wall",
                "." : "t_grass",
                "#" : "t_shrub",
                "+" : "t_door_c",
                ";" : "t_door_locked",
                "?" : "t_floor",
                "@" : "t_floor",
                "B" : "t_floor",
                "C" : "t_floor",
                "c" : "t_floor",
                "D" : "t_floor",
                "d" : "t_floor",
                "f" : "t_floor",
                "h" : "t_floor",
                "K" : "t_floor",
                "L" : "t_floor",
                "n" : "t_floor",
                "O" : "t_floor",
                "o" : "t_floor",
                "P" : "t_floor",
                "S" : "t_floor",
                "s" : "t_sidewalk",
                "v" : "t_window_domestic",
                "W" : "t_floor",
                "Y" : "t_floor"
            },
            "furniture" : {
                "?" : "f_sofa",
                "@" : "f_bed",
                "B" : "f_bathtub",
                "C" : "f_cupboard",
                "c" : "f_counter",
                "D" : "f_trashcan",
                "d" : "f_dresser",
                "f" : "f_fridge",
                "h" : "f_chair",
                "K" : "f_armchair",
                "L" : "f_locker",
                "n" : "f_table",
                "O" : "f_oven",
                "o" : "f_bookcase",
                "P" : "f_indoor_plant",
                "S" : "f_sink",
                "W" : "f_washer",
                "Y" : "f_dryer"
            },
            "toilets" : {
                "t" : { }
            },
            "set" : [
                { "point" : "terrain", "id" : "t_dirt", "x" : [ 0, 0], "y" : [ 0,23], "repeat" : [5, 8] },
                { "point" : "terrain", "id" : "t_dirt", "x" : [ 1, 8], "y" : [ 0, 5], "repeat" : [8,14] },
                { "point" : "terrain", "id" : "t_dirt", "x" : [ 1, 2], "y" : [15,23], "repeat" : [4, 6] },
                { "point" : "terrain", "id" : "t_dirt", "x" : [ 3, 9], "y" : [21,23], "repeat" : [5, 7] },
                { "point" : "terrain", "id" : "t_dirt", "x" : [ 8, 8], "y" : [ 6,11], "repeat" : [0, 1] },
                { "point" : "terrain", "id" : "t_dirt", "x" : [10,23], "y" : [23,23], "repeat" : [3, 4] },
                { "point" : "terrain", "id" : "t_dirt", "x" : [13,13], "y" : [ 0,11], "repeat" : [2, 3] },
                { "point" : "terrain", "id" : "t_dirt", "x" : [14,23], "y" : [ 0, 5], "repeat" : [8,14] },
                { "point" : "terrain", "id" : "t_dirt", "x" : [15,17], "y" : [21,22], "repeat" : [0, 1] },
                { "point" : "terrain", "id" : "t_dirt", "x" : [19,23], "y" : [15,17], "repeat" : [3, 5] },
                { "point" : "terrain", "id" : "t_dirt", "x" : [21,23], "y" : [ 6,14], "repeat" : [6, 9] },
                { "point" : "terrain", "id" : "t_dirt", "x" : [23,23], "y" : [18,22], "repeat" : [0, 1] }
            ],
            "place_loot" : [
                { "group" : "livingroom", "chance" : 90, "x" : [10,17], "y" : [15,19], "repeat" : [1,6] },
                { "group" : "kitchen",    "chance" : 85, "x" : [ 4, 7], "y" : [16,19], "repeat" : [1,3] },
                { "group" : "fridge",     "chance" : 90, "x" : [ 5, 5], "y" : [19,19], "repeat" : [1,4] },
                { "group" : "oven",       "chance" : 75, "x" : [ 4, 4], "y" : [17,17], "repeat" : [1,3] },
                { "group" : "trash",      "chance" : 80, "x" : [ 4, 4], "y" : [15,15], "repeat" : [1,3] },
                { "group" : "dining",     "chance" : 75, "x" : [ 7, 8], "y" : [17,19], "repeat" : [1,4] },
                { "group" : "homebooks",  "chance" : 60, "x" : [13,13], "y" : [14,14], "repeat" : [1,2] },
                { "group" : "homebooks",  "chance" : 75, "x" : [ 8, 8], "y" : [14,14], "repeat" : [1,2] },
                { "group" : "allclothes", "chance" : 60, "x" : [12,13], "y" : [21,21], "repeat" : [1,4] },
                { "group" : "home_hw",    "chance" : 75, "x" : [11,11], "y" : [21,21], "repeat" : [1,3] },
                { "group" : "softdrugs",  "chance" : 75, "x" : [19,21], "y" : [19,21], "repeat" : [1,3] },
                { "group" : "cleaning",   "chance" : 90, "x" : [19,21], "y" : [19,21], "repeat" : [1,2] },
                { "group" : "bedroom",    "chance" : 80, "x" : [15,19], "y" : [ 7,11], "repeat" : [1,5] },
                { "group" : "bedroom",    "chance" : 80, "x" : [ 2, 6], "y" : [ 7,11], "repeat" : [1,4] },
                { "group" : "bed",        "chance" : 90, "x" : [17,18], "y" : [ 7, 8], "repeat" : [1,3] },
                { "group" : "bed",        "chance" : 90, "x" : [ 3, 4], "y" : [ 7, 8], "repeat" : [1,3] },
                { "group" : "dresser",    "chance" : 90, "x" : [19,19], "y" : [13,13], "repeat" : [1,2] },
                { "group" : "dresser",    "chance" : 80, "x" : [16,16], "y" : [ 7, 7], "repeat" : [1,3] },
                { "group" : "dresser",    "chance" : 90, "x" : [ 2, 2], "y" : [13,13], "repeat" : [1,2] },
                { "group" : "dresser",    "chance" : 80, "x" : [ 5, 5], "y" : [ 7, 7], "repeat" : [1,3] },
                { "group" : "magazines",  "chance" : 80, "x" : [14,14], "y" : [18,18], "repeat" : [1,3] }
            ],
            "place_monsters" : [
                { "monster":  "GROUP_ZOMBIE", "chance" : 6, "x" : [2,21],  "y" : [2,21] }
            ]
        }
    }
]
