[
    {
        "type" : "monstergroup",
        "name" : "GROUP_DOGS", "_comment" : "D'ya like dags?",
        "default" : "mon_null",
        "monsters" : [
            { "monster" : "mon_zombie_dog",     "freq" : 100, "cost_multiplier" : 0, "pack_size" : [5,8] },
            { "monster" : "mon_dog_zombie_rot", "freq" : 100, "cost_multiplier" : 0, "pack_size" : [1,4] },
            { "monster" : "mon_dog_skeleton",   "freq" :  70, "cost_multiplier" : 0, "pack_size" : [1,3] }
        ]
    },{
        "type" : "item_group",
        "subtype" : "collection",
        "id" : "dogfight",
        "entries" : [
            { "item" :  "postman_shirt" },
            { "item" :  "postman_shorts" },
            { "item" :  "postman_hat" },
            { "group" : "underwear" },
            { "item" :  "dress_shoes" },
            { "item" :  "corpse" }
        ]
    },{
        "type" : "mapgen",
        "om_terrain" : ["house"],
        "method" : "json",
        "weight" : 100,
        "object" : {
            "fill_ter" : "t_floor",
            "rows" : [
                ".###....................",
                ".#---v----v;v----------.",
                ".#|hk   | oooo       hv.",
                ".#| k   +       nnn  hv.",
                ".#|     |            h|.",
                ".|-----+|             v.",
                ".v      |         h   v.",
                ".|d @@  |       h   h |.",
                ".v  @@c |     | ---nn-|.",
                ".|-----+-     |       |.",
                ".|d           |      Ov.",
                ".|d           |   CfSC|.",
                ".|--+-|-+---+---v-----|.",
                ".vB  S|...............q.",
                ".|B  t|...............q.",
                ".------...............q.",
                ".q....................q.",
                ".q....................q.",
                ".q....................q.",
                ".q....................q.",
                ".q....................q.",
                ".q....................q.",
                ".QQQQQQQQQQQQQQQQQQQQQQ.",
                "........................"
            ],
            "terrain" : {
                "|" : "t_wall",
                "-" : "t_wall",
                "." : "t_grass",
                "#" : "t_shrub",
                "+" : "t_door_c",
                ";" : "t_door_locked",
                "@" : "t_floor",
                "B" : "t_floor",
                "C" : "t_floor",
                "c" : "t_floor",
                "d" : "t_floor",
                "f" : "t_floor",
                "h" : "t_floor",
                "k" : "t_floor",
                "n" : "t_floor",
                "O" : "t_floor",
                "o" : "t_floor",
                "Q" : "t_fence_h",
                "q" : "t_fence_v",
                "S" : "t_floor",
                "v" : "t_window_domestic"
            },
            "furniture" : {
                "@" : "f_bed",
                "B" : "f_bathtub",
                "C" : "f_cupboard",
                "c" : "f_counter",
                "d" : "f_dresser",
                "f" : "f_fridge",
                "h" : "f_chair",
                "k" : "f_desk",
                "n" : "f_table",
                "O" : "f_oven",
                "o" : "f_bookcase",
                "S" : "f_sink"
            },
            "toilets" : {
                "t" : { }
            },
            "set" : [
                { "point" : "terrain", "id" : "t_dirt",       "x" : [ 0, 0], "y" : [ 0,23], "repeat" : [5,10] },
                { "point" : "terrain", "id" : "t_dirt",       "x" : [23,23], "y" : [ 0,23], "repeat" : [5,10] },
                { "point" : "terrain", "id" : "t_dirt",       "x" : [ 0,23], "y" : [23,23], "repeat" : [5, 8] },
                { "point" : "terrain", "id" : "t_dirt",       "x" : [ 0,14], "y" : [ 0, 0], "repeat" : [5, 8] },
                { "point" : "terrain", "id" : "t_tree_apple", "x" : [ 0,14], "y" : [ 0, 0], "repeat" : [1, 2] },
                { "point" : "terrain", "id" : "t_tree",       "x" : [ 2,14], "y" : [17,21], "repeat" : [2, 6] },
                { "point" : "terrain", "id" : "t_tree_young", "x" : [ 2,14], "y" : [17,21], "repeat" : [3, 5] }
            ],
            "place_loot" : [
                { "group" : "bed",                "chance" : 90, "x" : [ 4, 5], "y" : [ 7, 8], "repeat" : [1,3] },
                { "group" : "bedroom",            "chance" : 80, "x" : [ 2, 8], "y" : [ 6, 8], "repeat" : [1,4] },
                { "group" : "livingroom",         "chance" : 90, "x" : [ 9,21], "y" : [ 2, 7], "repeat" : [1,5] },
                { "group" : "guns_pistol_common", "chance" :  5, "x" : [ 2, 2], "y" : [10,11], "magazine" : 100, "ammo" : 90 },
                { "group" : "dresser",            "chance" : 65, "x" : [ 2, 2], "y" : [10,11], "repeat" : [1,2] },
                { "group" : "dresser",            "chance" : 85, "x" : [ 2, 2], "y" : [ 7, 7], "repeat" : [1,4] },
                { "group" : "fridge",             "chance" : 90, "x" : [19,19], "y" : [11,11], "repeat" : [1,5] },
                { "group" : "kitchen",            "chance" : 85, "x" : [21,21], "y" : [11,11], "repeat" : [1,2] },
                { "group" : "kitchen",            "chance" : 80, "x" : [18,18], "y" : [11,11], "repeat" : [1,2] },
                { "group" : "kitchen",            "chance" : 65, "x" : [18,20], "y" : [ 7,10], "repeat" : [1,3] },
                { "group" : "oven",               "chance" : 75, "x" : [21,21], "y" : [10,10], "repeat" : [1,3] },
                { "group" : "cleaning",           "chance" : 90, "x" : [ 2, 5], "y" : [13,14], "repeat" : [1,2] },
                { "group" : "softdrugs",          "chance" : 75, "x" : [ 2, 5], "y" : [12,14], "repeat" : [1,3] },
                { "group" : "office",             "chance" : 75, "x" : [ 2, 7], "y" : [ 2, 4], "repeat" : [1,3] },
                { "group" : "dogfight",           "chance" : 95, "x" : [18,18], "y" : [17,17] }
            ],
            "place_monsters" : [
                { "monster" : "GROUP_DOGS", "chance" : 1, "x" : [7,21], "y" : [13,21] }
            ]
        }
    }
]
