[
    {
        "type" : "mapgen",
        "om_terrain" : ["house"],
        "method" : "json",
        "weight" : 200,
        "object" : {
            "fill_ter" : "t_floor",
            "rows" : [
                "sssssssssssssssssssssss.",
                ".|-vvv-|sssssss|-vvv-|..",
                ".|PcccP|sssssss|oo???|..",
                ".|     |v;-|-;v|     |..",
                ".v? nn |  r|P  | hhh v..",
                ".v? nn    o|r    nnn v..",
                ".v         |     nnn v..",
                ".|????     |     hhh |..",
                ".|         |         |..",
                ".|---      |      ---|..",
                ".|cc     | | |    fcc|..",
                ".vc      |d|d|      cv..",
                ".|O      |-|-|      O|..",
                ".vC      |L|L|      Cv..",
                ".|CCuf   |+|+|    cuC|..",
                ".|-----|   |   |-----|..",
                ".| oco |   |   |oo   |..",
                ".|h    +   |   +    d|..",
                ".vd    |-+-|-+-|   @@v..",
                ".vd    |SiB|BiS|   @@v..",
                ".|     |tiB|Bit|    d|..",
                ".| @@  |---|---|  h  |..",
                ".|d@@n +  r|r  + kkk |..",
                ".|-vv--|---|---|--vv-|.."
            ],
            "terrain" : {
                "|" : "t_wall",
                "-" : "t_wall",
                "." : "t_grass",
                "+" : "t_door_c",
                ";" : "t_door_locked",
                "?" : "t_floor",
                "@" : "t_floor",
                "B" : "t_linoleum_gray",
                "C" : "t_floor",
                "c" : "t_floor",
                "d" : "t_floor",
                "f" : "t_floor",
                "h" : "t_floor",
                "i" : "t_linoleum_gray",
                "k" : "t_floor",
                "L" : "t_floor",
                "n" : "t_floor",
                "O" : "t_floor",
                "o" : "t_floor",
                "P" : "t_floor",
                "r" : "t_floor",
                "S" : "t_linoleum_gray",
                "s" : "t_sidewalk",
                "t" : "t_linoleum_gray",
                "u" : "t_floor",
                "v" : "t_window_domestic"
            },
            "furniture" : {
                "?" : "f_sofa",
                "@" : "f_bed",
                "B" : "f_bathtub",
                "C" : "f_cupboard",
                "c" : "f_counter",
                "d" : "f_dresser",
                "f" : "f_fridge",
                "h" : "f_chair",
                "k" : "f_desk",
                "L" : "f_locker",
                "n" : "f_table",
                "O" : "f_oven",
                "o" : "f_bookcase",
                "P" : "f_indoor_plant",
                "r" : "f_rack",
                "S" : "f_sink",
                "u" : "f_sink"
            },
            "toilets" : {
                "t" : { }
            },
            "set" : [
                { "point" : "terrain", "id" : "t_dirt", "x" : [ 0, 0], "y" : [1,23], "repeat" : [ 5,10] },
                { "point" : "terrain", "id" : "t_dirt", "x" : [22,23], "y" : [1,23], "repeat" : [10,20] }
            ],
            "place_loot" : [
                { "group" : "homebooks",   "chance" : 70, "x" : [ 3, 3], "y" : [16,16], "repeat" : [1,2] },
                { "group" : "homebooks",   "chance" : 70, "x" : [ 5, 5], "y" : [16,16], "repeat" : [1,2] },
                { "group" : "homebooks",   "chance" : 70, "x" : [16,17], "y" : [16,16], "repeat" : [1,3] },
                { "group" : "magazines",   "chance" : 80, "x" : [ 4, 5], "y" : [ 4, 5], "repeat" : [1,3] },
                { "group" : "magazines",   "chance" : 90, "x" : [16,17], "y" : [ 2, 2], "repeat" : [1,4] },
                { "group" : "novels",      "chance" : 85, "x" : [10,10], "y" : [ 5, 5], "repeat" : [1,3] },
                { "group" : "office",      "chance" : 80, "x" : [17,19], "y" : [22,22], "repeat" : [1,3] },
                { "group" : "livingroom",  "chance" : 90, "x" : [ 2, 6], "y" : [ 3, 8], "repeat" : [1,5] },
                { "group" : "dining",      "chance" : 85, "x" : [17,19], "y" : [ 5, 6], "repeat" : [1,3] },
                { "group" : "dining",      "chance" : 70, "x" : [ 4, 4], "y" : [14,14], "repeat" : [1,5] },
                { "group" : "dining",      "chance" : 70, "x" : [19,19], "y" : [14,14], "repeat" : [1,4] },
                { "group" : "fridge",      "chance" : 90, "x" : [ 5, 5], "y" : [14,14], "repeat" : [1,4] },
                { "group" : "fridge",      "chance" : 90, "x" : [18,18], "y" : [10,10], "repeat" : [1,3] },
                { "group" : "oven",        "chance" : 75, "x" : [ 2, 2], "y" : [12,12], "repeat" : [1,3] },
                { "group" : "oven",        "chance" : 75, "x" : [20,20], "y" : [12,12], "repeat" : [1,3] },
                { "group" : "kitchen",     "chance" : 85, "x" : [ 2, 3], "y" : [10,14], "repeat" : [1,3] },
                { "group" : "kitchen",     "chance" : 85, "x" : [19,20], "y" : [10,14], "repeat" : [1,3] },
                { "group" : "dresser",     "chance" : 85, "x" : [ 2, 2], "y" : [18,19], "repeat" : [1,5] },
                { "group" : "dresser",     "chance" : 85, "x" : [ 2, 2], "y" : [22,22], "repeat" : [1,3] },
                { "group" : "allclothes",  "chance" : 30, "x" : [10,10], "y" : [11,11], "repeat" : [1,4] },
                { "group" : "allclothes",  "chance" : 30, "x" : [12,12], "y" : [11,11], "repeat" : [1,4] },
                { "group" : "allclothes",  "chance" : 95, "x" : [10,10], "y" : [22,22], "repeat" : [1,2] },
                { "group" : "allclothes",  "chance" : 95, "x" : [12,12], "y" : [22,22], "repeat" : [1,3] },
                { "group" : "dresser",     "chance" : 90, "x" : [20,20], "y" : [17,17], "repeat" : [1,3] },
                { "group" : "dresser",     "chance" : 90, "x" : [20,20], "y" : [20,20], "repeat" : [1,3] },
                { "group" : "softdrugs",   "chance" : 75, "x" : [ 8,10], "y" : [19,20], "repeat" : [1,3] },
                { "group" : "softdrugs",   "chance" : 75, "x" : [12,14], "y" : [19,20], "repeat" : [1,3] },
                { "group" : "harddrugs",   "chance" : 15, "x" : [ 8,10], "y" : [19,20], "repeat" : [1,2] },
                { "group" : "harddrugs",   "chance" : 15, "x" : [12,14], "y" : [19,20], "repeat" : [1,2] },
                { "group" : "cleaning",    "chance" : 90, "x" : [ 8,10], "y" : [19,20], "repeat" : [1,2] },
                { "group" : "cleaning",    "chance" : 90, "x" : [12,14], "y" : [19,20], "repeat" : [1,2] },
                { "group" : "guns_common", "chance" : 10, "x" : [10,10], "y" : [13,13], "ammo" : 85, "magazine" : 95 },
                { "group" : "guns_common", "chance" : 10, "x" : [12,12], "y" : [13,13], "ammo" : 85, "magazine" : 95 },
                { "group" : "home_hw",     "chance" : 80, "x" : [10,10], "y" : [13,13], "repeat" : [1,3] },
                { "group" : "home_hw",     "chance" : 80, "x" : [12,12], "y" : [13,13], "repeat" : [1,3] },
                { "group" : "cannedfood",  "chance" : 70, "x" : [10,10], "y" : [13,13], "repeat" : [1,4] },
                { "group" : "cannedfood",  "chance" : 70, "x" : [12,12], "y" : [13,13], "repeat" : [1,3] },
                { "group" : "jackets",     "chance" : 70, "x" : [10,10], "y" : [ 4, 4], "repeat" : [1,2] },
                { "group" : "jackets",     "chance" : 70, "x" : [12,12], "y" : [ 5, 5], "repeat" : [1,2] },
                { "group" : "bed",         "chance" : 90, "x" : [ 3, 4], "y" : [21,22], "repeat" : [1,3] },
                { "group" : "bed",         "chance" : 90, "x" : [19,20], "y" : [18,19], "repeat" : [1,3] },
                { "group" : "bedroom",     "chance" : 80, "x" : [ 2, 6], "y" : [16,22], "repeat" : [1,5] },
                { "group" : "bedroom",     "chance" : 80, "x" : [16,20], "y" : [16,22], "repeat" : [1,5] },
                { "item" :  "television",  "chance" : 70, "x" : [ 4, 4], "y" : [ 2, 2] },
                { "item" :  "television",  "chance" : 10, "x" : [ 4, 4], "y" : [16,16] }
            ],
            "place_monsters" : [
                { "monster" : "GROUP_ZOMBIE", "chance" : 8, "x" : [2,21], "y" : [2,21] }
            ]
        }
    }
]
