[
    {
        "type" : "item_group",
        "id" : "barbecue",
        "items" : [
            ["beer",               15],
            ["meat",               65],
            ["fish",               10],
            ["fish_smoked",         5],
            ["meat_smoked",        60],
            ["sausage",            35],
            ["hotdogs_frozen",     65],
            ["hotdogs_cooked",     65],
            ["chilidogs",          30],
            ["currywurst",         15],
            ["lettuce",            45],
            ["tomato",             45],
            ["onion",              30],
            ["corn",               20],
            ["irradiated_lettuce", 20],
            ["irradiated_tomato",  20],
            ["irradiated_onion",    5],
            ["irradiated_corn",    10],
            ["bacon",              20],
            ["potato_baked",       15],
            ["bread",              40],
            ["ketchup",            80],
            ["mustard",            75],
            ["pickle",             20],
            ["cheeseburger",       30],
            ["hamburger",          70],
            ["cheese",             45],
            ["ceramic_plate",      30],
            ["knife_steak",        45],
            ["tongs",              60]
        ]
    },
    {
        "type" : "mapgen",
        "om_terrain" : ["house"],
        "method" : "json",
        "weight" : 300,
        "object" : {
            "fill_ter" : "t_floor",
            "rows" : [
                ".sssssss...s............",
                ".sssssss.--;v--vv--vv--.",
                ".sssssss.|    oo ????n|.",
                ".sssssss.v            v.",
                ".sssssss.|   --   nnn |.",
                ".sssssss.|   hnh     D|.",
                ".sssssss.v   hnh      v.",
                ".sssssss.|           c|.",
                ".sssssss.|   -----|  c|.",
                ".ssssssss;   |U((t|  Sv.",
                ".sssssss.|   +((BB|fOC|.",
                ".........|   |----|---|.",
                ".........|   +    +  d|.",
                ".........v   |o   |---|.",
                "......1..v   |d     @@|.",
                ".........|-[----v---v-|.",
                ".........##ss##########.",
                "...........ss...........",
                "..#......ssssssssssss...",
                "...#.....sssHsHssssss...",
                ".T.......sssNNNssssss...",
                ".........sssHsHssssss...",
                "........................",
                "........................"
            ],
            "terrain" : {
                "|" : "t_wall",
                "-" : "t_wall",
                "." : "t_grass",
                "1" : "t_tree_peach",
                "#" : "t_shrub",
                "+" : "t_door_c",
                ";" : "t_door_locked",
                "[" : "t_door_glass_c",
                "(" : "t_linoleum_gray",
                "?" : "t_floor",
                "@" : "t_floor",
                "B" : "t_linoleum_gray",
                "C" : "t_floor",
                "c" : "t_floor",
                "D" : "t_floor",
                "d" : "t_floor",
                "f" : "t_floor",
                "H" : "t_sidewalk",
                "h" : "t_floor",
                "N" : "t_sidewalk",
                "n" : "t_floor",
                "O" : "t_floor",
                "o" : "t_floor",
                "S" : "t_floor",
                "s" : "t_sidewalk",
                "T" : "t_tree",
                "t" : "t_linoleum_gray",
                "U" : "t_linoleum_gray",
                "v" : "t_window_domestic"
            },
            "furniture" : {
                "?" : "f_sofa",
                "@" : "f_bed",
                "B" : "f_bathtub",
                "C" : "f_cupboard",
                "c" : "f_counter",
                "D" : "f_trashcan",
                "d" : "f_dresser",
                "f" : "f_fridge",
                "H" : "f_chair",
                "h" : "f_chair",
                "N" : "f_table",
                "n" : "f_table",
                "O" : "f_oven",
                "o" : "f_bookcase",
                "S" : "f_sink",
                "U" : "f_sink"
            },
            "toilets" : {
                "t" : { }
            },
            "set" : [
                { "point" : "terrain",   "id" : "t_tree_young", "x" : [13,22], "y" : [ 0, 0], "chance": 10 },
                { "point" : "terrain",   "id" : "t_dirt",       "x" : [23,23], "y" : [ 0,23], "repeat": [5,10] },
                { "point" : "terrain",   "id" : "t_dirt",       "x" : [ 0, 0], "y" : [ 0,23], "repeat": [5,10] },
                { "point" : "terrain",   "id" : "t_dirt",       "x" : [ 0,23], "y" : [22,23], "repeat": [9,17] },
                { "point" : "furniture", "id" : "f_dahlia",     "x" : [ 8, 8], "y" : [ 1, 8], "repeat": [ 1,2] }
            ],
            "place_vehicles" : [
                { "vehicle" : "suburban_home", "chance" : 10,  "x" : 5, "y" : 4, "rotation" : 90 }
            ],
            "place_loot" : [
                { "group" : "bedroom",     "chance" : 80, "x" : [15,17], "y" : [12,14], "repeat" : [1,4] },
                { "group" : "bed",         "chance" : 90, "x" : [20,21], "y" : [14,14], "repeat" : [1,2] },
                { "group" : "shirts",      "chance" : 90, "x" : [21,21], "y" : [12,12], "repeat" : [1,2] },
                { "group" : "dresser",     "chance" : 85, "x" : [14,14], "y" : [14,14], "repeat" : [1,4] },
                { "group" : "homebooks",   "chance" : 65, "x" : [14,15], "y" : [ 2, 2], "repeat" : [1,2] },
                { "group" : "homebooks",   "chance" : 75, "x" : [14,14], "y" : [13,13], "repeat" : [1,2] },
                { "group" : "fridge",      "chance" : 90, "x" : [19,19], "y" : [10,10], "repeat" : [1,5] },
                { "group" : "oven",        "chance" : 75, "x" : [20,20], "y" : [10,10], "repeat" : [1,3] },
                { "group" : "pasta",       "chance" : 50, "x" : [21,21], "y" : [10,10], "repeat" : [1,2] },
                { "group" : "cannedfood",  "chance" : 75, "x" : [21,21], "y" : [10,10], "repeat" : [1,3] },
                { "group" : "kitchen",     "chance" : 80, "x" : [21,21], "y" : [ 7, 8], "repeat" : [1,2] },
                { "group" : "trash",       "chance" : 75, "x" : [21,21], "y" : [ 5, 5], "repeat" : [1,3] },
                { "group" : "dining",      "chance" : 80, "x" : [14,14], "y" : [ 5, 6], "repeat" : [1,3] },
                { "group" : "livingroom",  "chance" : 90, "x" : [17,21], "y" : [ 2, 3], "repeat" : [1,4] },
                { "group" : "softdrugs",   "chance" : 75, "x" : [14,17], "y" : [ 9,10], "repeat" : [1,3] },
                { "group" : "cleaning",    "chance" : 90, "x" : [14,17], "y" : [ 9,10], "repeat" : [1,2] },
                { "group" : "barbecue",    "chance" : 75, "x" : [12,14], "y" : [20,20], "repeat" : [1,4] },
                { "item"  : "television",  "chance" : 75, "x" : [19,19], "y" : [ 4, 4] },
                { "item"  : "char_smoker", "chance" : 85, "x" : [18,18], "y" : [19,19] },
                { "item"  : "charcoal",    "chance" : 60, "x" : [18,18], "y" : [19,19], "repeat" : [1,3] }
            ]
        }
    }
]
