[
    {
        "type" : "mapgen",
        "om_terrain" : ["house"],
        "method" : "json",
        "weight" : 100,
        "object" : {
            "fill_ter" : "t_floor",
            "rows" : [
                "........................",
                ".--vv--;--vv-----------.",
                ".|           |ooooo   |.",
                ".|           |o       v.",
                ".|    nn     |o       v.",
                ".| h  nnh    |   K   r|.",
                ".|    nn    0|0      r|.",
                ".v    nnh    |   Kc  r|.",
                ".v    nn     |o       v.",
                ".| h        C|o       v.",
                ".|      h   C|oooo    |.",
                ".|h         C|----+---|.",
                ".|------ -----     K  |.",
                ".|f   c|    ?????    K|.",
                ".vO   c|        ?     v.",
                ".vC    +     n  ?     v.",
                ".|S    |              |.",
                ".|--+------+------+---|.",
                ".|B   |        |      |.",
                ".|B   +        |      v.",
                ".v   S|   @@   |  @@  v.",
                ".|t   |   @@d  |  @@ d|.",
                ".---------vv-----------.",
                "........................"
            ],
            "terrain" : {
                "|" : "t_wall",
                "-" : "t_wall",
                "." : "t_grass",
                "0" : "t_floor",
                "+" : "t_door_c",
                ";" : "t_door_locked",
                "?" : "t_floor",
                "@" : "t_floor",
                "B" : "t_floor",
                "C" : "t_floor",
                "c" : "t_floor",
                "d" : "t_floor",
                "f" : "t_floor",
                "h" : "t_floor",
                "k" : "t_floor",
                "n" : "t_floor",
                "O" : "t_floor",
                "o" : "t_floor",
                "r" : "t_floor",
                "S" : "t_floor",
                "v" : "t_window_domestic"
            },
            "furniture" : {
                "0" : "f_fireplace",
                "?" : "f_sofa",
                "@" : "f_bed",
                "B" : "f_bathtub",
                "C" : "f_cupboard",
                "c" : "f_counter",
                "d" : "f_dresser",
                "f" : "f_fridge",
                "h" : "f_chair",
                "K" : "f_armchair",
                "n" : "f_table",
                "O" : "f_oven",
                "o" : "f_bookcase",
                "r" : "f_rack",
                "S" : "f_sink"
            },
            "toilets" : {
                "t" : { }
            },
            "set" : [
                { "point" : "terrain", "id" : "t_dirt", "x" : [ 0, 0], "y" : [ 0,23], "repeat" : [5,10] },
                { "point" : "terrain", "id" : "t_dirt", "x" : [23,23], "y" : [ 0,23], "repeat" : [5,10] },
                { "point" : "terrain", "id" : "t_dirt", "x" : [ 0,23], "y" : [23,23], "repeat" : [5, 8] },
                { "point" : "terrain", "id" : "t_dirt", "x" : [ 0,14], "y" : [ 0, 0], "repeat" : [5, 8] }
            ],
            "place_loot" : [
                { "group" : "bed",                "chance" : 90, "x" : [10,11], "y" : [20,21], "repeat" : [1,3] },
                { "group" : "bed",                "chance" : 90, "x" : [18,19], "y" : [20,21], "repeat" : [1,3] },
                { "group" : "bedroom",            "chance" : 80, "x" : [ 7,21], "y" : [18,21], "repeat" : [1,6] },
                { "group" : "livingroom",         "chance" : 85, "x" : [ 8,21], "y" : [13,16], "repeat" : [1,5] },
                { "group" : "guns_pistol_common", "chance" :  5, "x" : [12,12], "y" : [21,21], "magazine" : 100, "ammo" : 90 },
                { "group" : "dresser",            "chance" : 85, "x" : [21,21], "y" : [21,21], "repeat" : [1,4] },
                { "group" : "dresser",            "chance" : 85, "x" : [12,12], "y" : [21,21], "repeat" : [1,3] },
                { "group" : "kitchen",            "chance" : 70, "x" : [ 2, 6], "y" : [13,16], "repeat" : [1,3] },
                { "group" : "kitchen",            "chance" : 90, "x" : [ 2, 2], "y" : [15,15], "repeat" : [1,2] },
                { "group" : "fridge",             "chance" : 80, "x" : [ 2, 2], "y" : [13,13], "repeat" : [1,4] },
                { "group" : "dining",             "chance" : 80, "x" : [ 6, 7], "y" : [ 4, 8], "repeat" : [1,4] },
                { "group" : "oven",               "chance" : 75, "x" : [ 2, 2], "y" : [14,14], "repeat" : [1,3] },
                { "group" : "softdrugs",          "chance" : 75, "x" : [ 2, 4], "y" : [18,21], "repeat" : [1,3] },
                { "group" : "cleaning",           "chance" : 90, "x" : [ 2, 4], "y" : [18,21], "repeat" : [1,2] },
                { "group" : "homebooks",          "chance" : 75, "x" : [15,18], "y" : [ 2, 2], "repeat" : [1,3] },
                { "group" : "novels",             "chance" : 90, "x" : [14,14], "y" : [ 2, 4], "repeat" : [1,4] },
                { "group" : "textbooks",          "chance" : 50, "x" : [14,14], "y" : [ 2, 4], "repeat" : [1,2] },
                { "group" : "novels",             "chance" : 90, "x" : [14,14], "y" : [ 8,10], "repeat" : [1,4] },
                { "group" : "textbooks",          "chance" : 50, "x" : [14,14], "y" : [ 8,10], "repeat" : [1,2] },
                { "group" : "homebooks",          "chance" : 75, "x" : [15,17], "y" : [10,10], "repeat" : [1,3] },
                { "group" : "homebooks",          "chance" : 40, "x" : [18,18], "y" : [ 7, 7], "repeat" : [1,2] },
                { "group" : "alcohol",            "chance" : 75, "x" : [21,21], "y" : [ 5, 7], "repeat" : [1,2] }
            ],
            "place_monsters" : [
                { "monster" : "GROUP_ZOMBIE", "chance" : 2, "x" : [2,21], "y" : [2,21] }
            ]
        }
    }
]
