[
    {
        "type" : "mapgen",
        "om_terrain" : ["house"],
        "method" : "json",
        "weight" : 300,
        "object" : {
            "fill_ter" : "t_floor",
            "rows" : [
                "...T####ss####T.........",
                ".---vvvv;;vvvv---------.",
                ".|oo          | rcccc |.",
                ".|      h     | r   c |.",
                ".|0     nnh   | r   c |.",
                ".|o    hnn    | r   c |.",
                ".|o       h   |       |.",
                ".|o           |+------|.",
                ".|            |      c|.",
                ".|    ?      o|  hcc Sv.",
                ".vn   ?      o|   cc Ov.",
                ".vn   ?      o|   cc f|.",
                ".|    ?       +       |.",
                ".| K  c       |  h    v.",
                ".|------      |n      v.",
                ".|t    +      |nnn   D|.",
                ".|     |--+--------+--|.",
                ".|BB   |   nndnn      |.",
                ".vBB   +              |.",
                ".vBB   +              |.",
                ".|    S|--+--|    @@  |.",
                ".|rr   |G   r|   d@@d |.",
                ".-----------------vv---.",
                "........................"
            ],
            "terrain" : {
                "|" : "t_wall",
                "-" : "t_wall",
                "." : "t_grass",
                "0" : "t_floor",
                "#" : "t_shrub",
                "+" : "t_door_c",
                ";" : "t_door_locked",
                "?" : "t_floor",
                "@" : "t_floor",
                "B" : "t_floor",
                "c" : "t_floor",
                "D" : "t_floor",
                "d" : "t_floor",
                "f" : "t_floor",
                "G" : "t_floor",
                "h" : "t_floor",
                "K" : "t_floor",
                "n" : "t_floor",
                "O" : "t_floor",
                "o" : "t_floor",
                "r" : "t_floor",
                "S" : "t_floor",
                "s" : "t_sidewalk",
                "T" : "t_tree",
                "v" : "t_window_domestic"
            },
            "furniture" : {
                "0" : "f_fireplace",
                "?" : "f_sofa",
                "@" : "f_bed",
                "B" : "f_bathtub",
                "c" : "f_counter",
                "D" : "f_trashcan",
                "d" : "f_dresser",
                "f" : "f_fridge",
                "G" : "f_gunsafe_ml",
                "h" : "f_chair",
                "K" : "f_armchair",
                "n" : "f_table",
                "O" : "f_oven",
                "o" : "f_bookcase",
                "r" : "f_rack",
                "S" : "f_sink"
            },
            "toilets" : {
                "t" : { }
            },
            "set" : [
                { "point" : "terrain", "id" : "t_dirt",       "x" : [ 0, 0], "y" : [ 0,23], "repeat" : [5,10] },
                { "point" : "terrain", "id" : "t_dirt",       "x" : [23,23], "y" : [ 0,23], "repeat" : [5,10] },
                { "point" : "terrain", "id" : "t_dirt",       "x" : [ 0,23], "y" : [23,23], "repeat" : [5, 8] },
                { "point" : "terrain", "id" : "t_dirt",       "x" : [ 0,14], "y" : [ 0, 0], "repeat" : [5, 8] },
                { "point" : "terrain", "id" : "t_tree_apple", "x" : [ 0,14], "y" : [ 0, 0], "repeat" : [1, 2], "chance" : 40 }
            ],
            "place_loot" : [
                { "group" : "bed",                  "chance" : 90, "x" : [18,19], "y" : [20,21], "repeat" : [1,3] },
                { "group" : "livingroom",           "chance" : 90, "x" : [ 1,10], "y" : [ 1,13], "repeat" : [1,5] },
                { "group" : "fridge",               "chance" : 40, "x" : [ 8, 9], "y" : [ 4, 5], "repeat" : [1,2] },
                { "group" : "consumer_electronics", "chance" : 50, "x" : [ 1, 6], "y" : [ 7,21], "repeat" : [1,3] },
                { "group" : "bedroom",              "chance" : 80, "x" : [15,21], "y" : [ 7,21], "repeat" : [1,5] },
                { "group" : "dresser",              "chance" : 70, "x" : [20,20], "y" : [21,21], "repeat" : [1,2] },
                { "group" : "dresser",              "chance" : 70, "x" : [17,17], "y" : [21,21], "repeat" : [1,2] },
                { "group" : "guns_pistol_common",   "chance" :  5, "x" : [ 8, 8], "y" : [21,21], "magazine" : 100, "ammo" : 90 },
                { "group" : "dresser",              "chance" : 90, "x" : [12,12], "y" : [21,21], "repeat" : [1,2] },
                { "group" : "dresser",              "chance" : 50, "x" : [13,13], "y" : [17,17], "repeat" : [1,2] },
                { "group" : "softdrugs",            "chance" : 75, "x" : [ 2, 3], "y" : [21,21], "repeat" : [1,3] },
                { "group" : "harddrugs",            "chance" : 15, "x" : [ 2, 3], "y" : [21,21], "repeat" : [1,2] },
                { "group" : "kitchen",              "chance" : 70, "x" : [15,21], "y" : [ 2,16], "repeat" : [1,3] },
                { "group" : "fridge",               "chance" : 90, "x" : [21,21], "y" : [11,11], "repeat" : [1,4] },
                { "group" : "oven",                 "chance" : 75, "x" : [21,21], "y" : [10,10], "repeat" : [1,3] },
                { "group" : "kitchen",              "chance" : 80, "x" : [21,21], "y" : [ 9, 9], "repeat" : [1,2] },
                { "group" : "trash_forest",         "chance" : 80, "x" : [21,21], "y" : [15,15], "repeat" : [1,3] },
                { "group" : "homebooks",            "chance" : 60, "x" : [ 2, 2], "y" : [ 5, 7], "repeat" : [1,3] },
                { "group" : "homebooks",            "chance" : 60, "x" : [13,13], "y" : [ 8,10], "repeat" : [1,3] },
                { "group" : "cannedfood",           "chance" : 80, "x" : [16,16], "y" : [ 2, 5], "repeat" : [1,2] },
                { "group" : "cannedfood",           "chance" : 75, "x" : [16,20], "y" : [ 2, 2], "repeat" : [1,2] },
                { "group" : "stash_food",           "chance" : 60, "x" : [16,16], "y" : [ 2, 5], "repeat" : [1,3] },
                { "group" : "pasta",                "chance" : 65, "x" : [20,20], "y" : [ 2, 5], "repeat" : [1,2] },
                { "group" : "stash_food",           "chance" : 60, "x" : [20,20], "y" : [ 2, 5], "repeat" : [1,3] }
            ],
            "place_monsters" : [
                { "monster" : "GROUP_ZOMBIE", "chance" : 2, "x" : [2,21], "y" : [2,21] }
            ]
        }
    }
]
