[
  {
    "type": "mapgen",
    "method": "json",
    "om_terrain": [ "lodge_ground" ],
    "weight": 100,
    "object": {
      "fill_ter": "t_floor",
      "rows": [
        ".*##W###W###W###W###+##W#################*.....",
        ".*#c B#c B#B c#B c#  #h s#   OOO   AA  >#*.....",
        ".*Wd B#d B#B d#B d#  #h T# O     O     bW*.....",
        ".*##=###=###=###=##  ##=## O  ZZ O     b#*.....",
        ".*#                        O  ZZ O     b#*.....",
        ".*W                                    bW*.....",
        ".*#    YY   YY  AAAAAAAA  a  OOO       >#*.....",
        ".*########+########################   ###*.....",
        ".*********G~~~~~~~~~~~~~~~~~~~~~~~#   #***.....",
        "~~~~~~~~~~G~~~~~~~~~~~*############   #*.......",
        "oooooooooooooooo~~~~~~*#              #*.......",
        "oooooooooooooooo~~~~~~*#Y             w*.......",
        "ooooooooooooooooGGGGGGG+    ttttt    bw*.......",
        "ooooooooooooooooGGGGGGG+    ttttt    bw*.......",
        "oooooooooooooooo~~~~~G*#              w*.......",
        "oooooooooooooooo~~~~~G*#Y             w*.......",
        "~~~~~~~~~~~~~~~~~~~~~G*#####   ########*.......",
        "~~~~~~~~~~~~~~~~~~~~~G***#<#   #********.......",
        "~~~~~~~~~~~~~~~~~~~~~GGGG+ #   #*****..........",
        "......*###-###-###-#########   #####*..........",
        "......*#UU URU URU URU #12C     5 F#*..........",
        "......*#R              +      C   uW*..........",
        "......*#UU URU URU URU #3CC&  4CVuF#*..........",
        "......*###-###-###-##########+######*.........."
      ],
      "palettes": [ "lodge_palette" ],
      "place_monsters": [ { "monster": "GROUP_ZOMBIE", "x": 7, "y": 4 } ],
      "place_nested": [ { "chunks": [ [ "lodge_pantry", 80 ], [ "lodge_cannibal", 20 ], [ "lodge_hunting", 50 ] ], "x": 8, "y": 19 } ]
    }
  },
  {
    "type": "mapgen",
    "method": "json",
    "om_terrain": [ "lodge_2ndfloor" ],
    "weight": 100,
    "object": {
      "fill_ter": "t_floor",
      "rows": [
        ".*##W###W###W###W###+##W#################*.....",
        ".*#c B#c B#B c#B c#  #h s#             <#*.....",
        ".*Wd B#d B#B d#B d#  #h T#              W*.....",
        ".*##=###=###=###=##  ##=##              #*.....",
        ".*#                                     #*.....",
        ".*W                                     W*.....",
        ".*#    YY   YY  AAAAAAAA  a  OOO       <#*.....",
        ".*########+########################   ###*.....",
        ".*********G~~~~~~~~~~~~~~~~~~~~~~~#   #***.....",
        "~~~~~~~~~~G~~~~~~~~~~~*############   #*.......",
        "oooooooooooooooo~~~~~~*#              #*.......",
        "oooooooooooooooo~~~~~~*#Y             w*.......",
        "ooooooooooooooooGGGGGGG+    ttttt    bw*.......",
        "ooooooooooooooooGGGGGGG+    ttttt    bw*.......",
        "oooooooooooooooo~~~~~G*#              w*.......",
        "oooooooooooooooo~~~~~G*#Y             w*.......",
        "~~~~~~~~~~~~~~~~~~~~~G*#####   ########*.......",
        "~~~~~~~~~~~~~~~~~~~~~G***#<#   #********.......",
        "~~~~~~~~~~~~~~~~~~~~~GGGG+ #   #*****..........",
        "......*###-###-###-#########   #####*..........",
        "......*#UU URU URU URU #12C     5 F#*..........",
        "......*#R              +      C   uW*..........",
        "......*#UU URU URU URU #3CC&  4CVuF#*..........",
        "......*###-###-###-##########+######*.........."
      ],
      "palettes": [ "lodge_2ndfloor_palette" ]
    }
  }
]
