[
  {
    "type": "mapgen",
    "method": "json",
    "om_terrain": [ "s_library" ],
    "weight": 500,
    "object": {
      "fill_ter": "t_floor",
      "rows": [
        "------------------------",
        "..pp----pp##o#######o##.",
        "..pp----pp#%dy|L[[| dd#.",
        "..pp----pp#dh |  [| h%#.",
        ".#:::**:::#||+|+|||+||#.",
        ".#[h      %           o.",
        ".#[h      ccc%ccc%ccc #.",
        ".#[h                  #.",
        ".#||||||              #.",
        ".o hhh +  h%[%h h%[%h #.",
        ".# [[[ |              o.",
        ".#||||||  h%[%h h%[%h #.",
        ".# hhh +              #.",
        ".o [[[ |  K  EW  QQ  P#.",
        ".# hhh |  K  JW  QQ  N#.",
        ".#||||||  K  JW  QQ  N#.",
        ".#cScSc|  U  OW  QQ  M#.",
        ".o     +  U  OW  QQ  M#.",
        ".#+|+|+|  U  TI  QQ  Q#.",
        ".# | | |  U  TI  QQ  Q#.",
        ".#t|t|t|             [#.",
        ".########o##o###o###o##.",
        ".....4..................",
        "........................"
      ],
      "palettes": [ "standard_building_shared_palette", "library_palette" ],
      "place_nested": [ { "chunks": [ [ "null", 199 ], [ "fire_field", 1 ] ], "x": [ 10, 20 ], "y": [ 9, 19 ] } ]
    }
  },
  {
    "type": "mapgen",
    "method": "json",
    "om_terrain": [ "s_library" ],
    "weight": 1000,
    "//": "vandalized variant.",
    "object": {
      "fill_ter": "t_floor",
      "rows": [
        "------------------------",
        "..pp----pp##o#######o##.",
        "..pp----pp#%dy|L[[| dd#.",
        "..pp----pp#dh |  [| h%#.",
        ".#:::**:::#||+|+|||+||#.",
        ".#[h      %           o.",
        ".#[h      ccc%ccc%ccc #.",
        ".#[h                  #.",
        ".#||||||              #.",
        ".o hhh +  h%[%h h%[%h #.",
        ".# [[[ |              o.",
        ".#||||||  h%[%h h%[%h #.",
        ".# hhh +              #.",
        ".o [[[ |  K  EW  QQ  P#.",
        ".# hhh |  K  JW  QQ  N#.",
        ".#||||||  K  JW  QQ  N#.",
        ".#cScSc|  U  OW  QQ  M#.",
        ".o     +  U  OW  QQ  M#.",
        ".#+|+|+|  U  TI  QQ  Q#.",
        ".# | | |  U  TI  QQ  Q#.",
        ".#t|t|t|             [#.",
        ".########o##o###o###o##.",
        ".....4..................",
        "........................"
      ],
      "palettes": [ "standard_building_shared_palette", "standard_building_vandalized_palette", "vandalized_library_palette" ],
      "place_rubble": [ { "x": [ 4, 21 ], "y": [ 5, 21 ], "repeat": [ 30, 100 ] } ],
      "place_nested": [ { "chunks": [ [ "null", 80 ], [ "fire_field", 20 ] ], "x": [ 10, 20 ], "y": [ 9, 19 ] } ]
    }
  },
  {
    "type": "mapgen",
    "method": "json",
    "om_terrain": "s_library_roof",
    "object": {
      "fill_ter": "t_flat_roof",
      "rows": [
        "                        ",
        "          ------------- ",
        "          -...........- ",
        "          -.R.........- ",
        " ----------........U..- ",
        " -....................- ",
        " -....................- ",
        " -....................- ",
        " -....................- ",
        " -....................- ",
        " -....................- ",
        " -....................- ",
        " -....................- ",
        " -....................- ",
        " -....................- ",
        " -....................- ",
        " -....................- ",
        " -....................- ",
        " -....................- ",
        " -....................- ",
        " -....................- ",
        " ----5----------------- ",
        "                        ",
        "                        "
      ],
      "palettes": [ "roof_palette" ],
      "place_items": [ { "item": "SUS_trash_roof", "x": [ 3, 18 ], "y": [ 6, 19 ], "chance": 50, "repeat": [ 1, 3 ] } ],
      "nested": { "U": { "chunks": [ "roof_2x2_infrastructure" ] }, "R": { "chunks": [ "roof_2x2_infrastructure_1" ] } },
      "place_nested": [
        {
          "chunks": [
            [ "null", 20 ],
            [ "roof_2x2_utilities_b", 15 ],
            [ "roof_2x2_utilities_c", 5 ],
            [ "roof_2x2_utilities_d", 40 ],
            [ "roof_2x2_utilities", 50 ]
          ],
          "x": [ 3, 15 ],
          "y": [ 6, 8 ]
        },
        {
          "chunks": [ [ "null", 20 ], [ "roof_4x4_utility", 40 ], [ "roof_6x6_utility", 20 ] ],
          "x": [ 3, 15 ],
          "y": [ 10, 14 ]
        }
      ]
    }
  },
  {
    "type": "mapgen",
    "method": "json",
    "om_terrain": [ "s_library_1" ],
    "weight": 500,
    "object": {
      "fill_ter": "t_floor",
      "rows": [
        "------------------------",
        "------------------------",
        "........--..............",
        ".ppppppp--ppppppppppppp.",
        ".#####::**:::::###oo###.",
        ".#d bc         | hh h #.",
        ".#d  %     h[h | [[[[ #.",
        ".#d bc     h[h |  hhh #.",
        ".#y  %         |+|||||#.",
        ".#   c                o.",
        ".o        h%%h   JJ  U#.",
        ".#M  WW   h%%h   JJ  I#.",
        ".#M  TT   h%%h   JJ  I#.",
        ".#M  PP   h%%h   OO  N#.",
        ".#E  AA   h%%h   OO  N#.",
        ".#                    #.",
        ".#QQQQQQQQQQQQQQ NNNNN#.",
        ".##########|||||+|||###.",
        ".....5...4#y cc| | [#...",
        "..........#C   : + S#...",
        "....5..5..#C   * |||#...",
        "..........o  B : + S#...",
        ".5.....5..#[[[y| | [#...",
        "..........######o####..."
      ],
      "palettes": [ "standard_building_shared_palette", "library_palette" ],
      "place_nested": [ { "chunks": [ [ "null", 199 ], [ "fire_field", 1 ] ], "x": [ 3, 22 ], "y": [ 10, 14 ] } ],
      "place_monsters": [ { "monster": "GROUP_MAYBE_ZOMBIE", "x": [ 16, 21 ], "y": [ 5, 7 ], "density": 1 } ]
    }
  },
  {
    "type": "mapgen",
    "method": "json",
    "om_terrain": [ "s_library_1" ],
    "weight": 1000,
    "//": "vandalized variant.",
    "object": {
      "fill_ter": "t_floor",
      "rows": [
        "------------------------",
        "------------------------",
        "........--..............",
        ".ppppppp--ppppppppppppp.",
        ".#####::**:::::###oo###.",
        ".#d bc         | hh h #.",
        ".#d  %     h[h | [[[[ #.",
        ".#d bc     h[h |  hhh #.",
        ".#y  %         |+|||||#.",
        ".#   c                o.",
        ".o        h%%h   JJ  U#.",
        ".#M  WW   h%%h   JJ  I#.",
        ".#M  TT   h%%h   JJ  I#.",
        ".#M  PP   h%%h   OO  N#.",
        ".#E  AA   h%%h   OO  N#.",
        ".#                    #.",
        ".#QQQQQQQQQQQQQQ NNNNN#.",
        ".##########|||||+|||###.",
        ".....5...4#y cc| | [#...",
        "..........#C   : + S#...",
        "....5..5..#C   * |||#...",
        "..........o  B : + S#...",
        ".5.....5..#[[[y| | [#...",
        "..........######o####..."
      ],
      "palettes": [ "standard_building_shared_palette", "standard_building_vandalized_palette", "vandalized_library_palette" ],
      "place_rubble": [ { "x": [ 4, 21 ], "y": [ 5, 21 ], "repeat": [ 30, 100 ] } ],
      "place_nested": [ { "chunks": [ [ "null", 80 ], [ "fire_field", 20 ] ], "x": [ 3, 22 ], "y": [ 10, 14 ] } ],
      "place_monsters": [ { "monster": "GROUP_MAYBE_ZOMBIE", "x": [ 16, 21 ], "y": [ 5, 7 ], "density": 1 } ]
    }
  },
  {
    "type": "mapgen",
    "method": "json",
    "om_terrain": "s_library_roof_1",
    "object": {
      "fill_ter": "t_flat_roof",
      "rows": [
        "                        ",
        "                        ",
        "                        ",
        " ---------------------- ",
        " -....................- ",
        " -....................- ",
        " -....................- ",
        " -....................- ",
        " -....................- ",
        " -....................- ",
        " -....................- ",
        " -....................- ",
        " -....................- ",
        " -....................- ",
        " -....................- ",
        " -....................- ",
        " -....................- ",
        " ---------5.........--- ",
        "          -......Z..-   ",
        "          -.........-   ",
        "          -..R......-   ",
        "          -.........-   ",
        "          -......U..-   ",
        "          -----------   "
      ],
      "palettes": [ "roof_palette" ],
      "nested": {
        "U": { "chunks": [ "roof_2x2_infrastructure" ] },
        "R": { "chunks": [ "roof_2x2_infrastructure_1" ] },
        "Z": { "chunks": [ "roof_2x2_infrastructure_2" ] }
      },
      "place_nested": [
        {
          "chunks": [
            [ "null", 20 ],
            [ "roof_2x2_utilities_b", 15 ],
            [ "roof_2x2_utilities_c", 5 ],
            [ "roof_2x2_utilities_d", 40 ],
            [ "roof_2x2_utilities", 50 ]
          ],
          "x": [ 5, 15 ],
          "y": [ 5, 7 ]
        },
        {
          "chunks": [ [ "null", 20 ], [ "roof_4x4_utility", 40 ], [ "roof_6x6_utility", 20 ] ],
          "x": [ 3, 13 ],
          "y": [ 9, 10 ]
        }
      ]
    }
  },
  {
    "type": "mapgen",
    "method": "json",
    "om_terrain": [ "s_library_2" ],
    "weight": 1000,
    "object": {
      "fill_ter": "t_floor",
      "rows": [
        "........................",
        "........................",
        "..###oo####++####oo###..",
        "..#           c b   [#..",
        "..#QQQQQQQ    c     y#..",
        "..#QQQQQQQ    ccccc y#..",
        "..o                  o..",
        "..o             h    o..",
        "..#OOOOOJJJJJ  [[h  Q#..",
        "..#OOOOOJJJJJ h[[h  Q#..",
        "..o                 Q#..",
        "..o                 Q#..",
        "..#UUUUUUUUUU h[[h  Q#..",
        "..#IIIIIIIIII  [[h  Q#..",
        "..o                 Q#..",
        "..o                 Q#..",
        "..#WWWWMMMMNNNEPy   Q#..",
        "..##########||||o+|||#..",
        "..G.......4#MAW   + S#..",
        "...........o b    | t#..",
        "...........oB  [ y|||#..",
        "...........o      | S#..",
        "...........#y CC  + t#..",
        "...........###########.."
      ],
      "palettes": [ "standard_building_shared_palette", "library_palette" ],
      "nested": { "G": { "chunks": [ "roof_6x6_garden_1" ] } },
      "place_nested": [ { "chunks": [ [ "null", 199 ], [ "fire_field", 1 ] ], "x": [ 5, 9 ], "y": [ 4, 16 ] } ],
      "terrain": { "G": "t_grass" },
      "place_monsters": [ { "monster": "GROUP_ZOMBIE", "x": [ 0, 0 ], "y": [ 23, 23 ], "chance": 2, "repeat": [ 2, 3 ] } ]
    }
  },
  {
    "type": "mapgen",
    "method": "json",
    "om_terrain": [ "s_library_2" ],
    "weight": 2000,
    "//": "vandalized variant.",
    "object": {
      "fill_ter": "t_floor",
      "rows": [
        "........................",
        "........................",
        "..###oo####++####oo###..",
        "..#           c b   [#..",
        "..#QQQQQQQ    c     y#..",
        "..#QQQQQQQ    ccccc y#..",
        "..o                  o..",
        "..o             h    o..",
        "..#OOOOOJJJJJ  [[h  Q#..",
        "..#OOOOOJJJJJ h[[h  Q#..",
        "..o                 Q#..",
        "..o                 Q#..",
        "..#UUUUUUUUUU h[[h  Q#..",
        "..#IIIIIIIIII  [[h  Q#..",
        "..o                 Q#..",
        "..o                 Q#..",
        "..#WWWWMMMMNNNEPy   Q#..",
        "..##########||||o+|||#..",
        "..G.......4#MAW   + S#..",
        "...........o b    | t#..",
        "...........oB  [ y|||#..",
        "...........o      | S#..",
        "...........#y CC  + t#..",
        "...........###########.."
      ],
      "palettes": [ "standard_building_shared_palette", "standard_building_vandalized_palette", "vandalized_library_palette" ],
      "place_rubble": [ { "x": [ 4, 21 ], "y": [ 5, 21 ], "repeat": [ 30, 100 ] } ],
      "nested": { "G": { "chunks": [ "roof_6x6_garden_1" ] } },
      "place_nested": [ { "chunks": [ [ "null", 199 ], [ "fire_field", 1 ] ], "x": [ 5, 9 ], "y": [ 4, 16 ] } ],
      "terrain": { "G": "t_grass" },
      "place_monsters": [ { "monster": "GROUP_ZOMBIE", "x": [ 0, 0 ], "y": [ 23, 23 ], "chance": 2, "repeat": [ 2, 3 ] } ]
    }
  },
  {
    "type": "mapgen",
    "method": "json",
    "om_terrain": "s_library_roof_2",
    "object": {
      "fill_ter": "t_flat_roof",
      "rows": [
        "                        ",
        "                        ",
        "  --------------------  ",
        "  -..................-  ",
        "  -..................-  ",
        "  -..................-  ",
        "  -..................-  ",
        "  -..................-  ",
        "  -..................-  ",
        "  -..................-  ",
        "  -..................-  ",
        "  -..................-  ",
        "  -..................-  ",
        "  -..................-  ",
        "  -..................-  ",
        "  -..................-  ",
        "  -..................-  ",
        "  ---------5.........-  ",
        "           -......Z..-  ",
        "           -.U.......-  ",
        "           -.....R...-  ",
        "           -.........-  ",
        "           -.........-  ",
        "           -----------  "
      ],
      "palettes": [ "roof_palette" ],
      "nested": {
        "U": { "chunks": [ "roof_2x2_infrastructure" ] },
        "R": { "chunks": [ "roof_2x2_infrastructure_1" ] },
        "Z": { "chunks": [ "roof_2x2_infrastructure_2" ] }
      },
      "place_nested": [
        {
          "chunks": [
            [ "null", 20 ],
            [ "roof_2x2_utilities_b", 15 ],
            [ "roof_2x2_utilities_c", 5 ],
            [ "roof_2x2_utilities_d", 40 ],
            [ "roof_2x2_utilities", 50 ]
          ],
          "x": [ 5, 15 ],
          "y": [ 13, 14 ]
        },
        {
          "chunks": [ [ "null", 20 ], [ "roof_4x4_utility", 40 ], [ "roof_6x6_utility", 20 ] ],
          "x": [ 4, 10 ],
          "y": [ 4, 6 ]
        }
      ]
    }
  },
  {
    "type": "mapgen",
    "method": "json",
    "om_terrain": [ "s_library_3" ],
    "weight": 500,
    "object": {
      "fill_ter": "t_floor",
      "rows": [
        "------------------------",
        "..pp----pp##o#######o##.",
        "..pp----pp#  KJ%J%JW  #.",
        "..pp----pp#           #.",
        ".#::#**#::#[h [h [h [h#.",
        ".#U                   o.",
        ".#U    OOMMNNUUPPAA   #.",
        ".#I                   #.",
        ".#T    QQKWJUUITKJW   #.",
        ".o                    #.",
        ".#||||||  [h [h [h [h o.",
        ".#cScSc|              #.",
        ".o     +  %U%I%T%J%E  #.",
        ".#+|+|+|              #.",
        ".# | | |  cc%cccc%cc  #.",
        ".#t|t|t|              #.",
        ".###########o####o#####.",
        ".pppp4ppppppppppppppppp.",
        "........................",
        "...5..p..5....5..p..5...",
        "........................",
        "...5..p..5....5..p..5...",
        "........................",
        "........................"
      ],
      "palettes": [ "standard_building_shared_palette", "library_palette" ],
      "place_nested": [ { "chunks": [ [ "null", 199 ], [ "fire_field", 1 ] ], "x": [ 10, 20 ], "y": [ 9, 19 ] } ]
    }
  },
  {
    "type": "mapgen",
    "method": "json",
    "om_terrain": [ "s_library_3" ],
    "weight": 1000,
    "//": "vandalized variant.",
    "object": {
      "fill_ter": "t_floor",
      "rows": [
        "------------------------",
        "..pp----pp##o#######o##.",
        "..pp----pp#  KJ%J%JW  #.",
        "..pp----pp#           #.",
        ".#::#**#::#[h [h [h [h#.",
        ".#U                   o.",
        ".#U    OOMMNNUUPPAA   #.",
        ".#I                   #.",
        ".#T    QQKWJUUITKJW   #.",
        ".o                    #.",
        ".#||||||  [h [h [h [h o.",
        ".#cScSc|              #.",
        ".o     +  %U%I%T%J%E  #.",
        ".#+|+|+|              #.",
        ".# | | |  cc%cccc%cc  #.",
        ".#t|t|t|              #.",
        ".###########o####o#####.",
        ".pppp4ppppppppppppppppp.",
        "........................",
        "...5..p..5....5..p..5...",
        "........................",
        "...5..p..5....5..p..5...",
        "........................",
        "........................"
      ],
      "palettes": [ "standard_building_shared_palette", "standard_building_vandalized_palette", "vandalized_library_palette" ],
      "place_nested": [ { "chunks": [ [ "null", 80 ], [ "fire_field", 20 ] ], "x": [ 10, 20 ], "y": [ 9, 19 ] } ]
    }
  },
  {
    "type": "mapgen",
    "method": "json",
    "om_terrain": "s_library_roof_3",
    "object": {
      "fill_ter": "t_flat_roof",
      "rows": [
        "                        ",
        "          ------------- ",
        "          -...........- ",
        "          -.R.........- ",
        " ----------........U..- ",
        " -....................- ",
        " -....................- ",
        " -....................- ",
        " -....................- ",
        " -....................- ",
        " -....................- ",
        " -....................- ",
        " -....................- ",
        " -....................- ",
        " -....................- ",
        " -....................- ",
        " ----5----------------- ",
        "                        ",
        "                        ",
        "                        ",
        "                        ",
        "                        ",
        "                        ",
        "                        "
      ],
      "palettes": [ "roof_palette" ],
      "place_items": [ { "item": "SUS_trash_roof", "x": [ 3, 18 ], "y": [ 6, 19 ], "chance": 50, "repeat": [ 1, 3 ] } ],
      "nested": { "U": { "chunks": [ "roof_2x2_infrastructure" ] }, "R": { "chunks": [ "roof_2x2_infrastructure_1" ] } },
      "place_nested": [
        {
          "chunks": [
            [ "null", 20 ],
            [ "roof_2x2_utilities_b", 15 ],
            [ "roof_2x2_utilities_c", 5 ],
            [ "roof_2x2_utilities_d", 40 ],
            [ "roof_2x2_utilities", 50 ]
          ],
          "x": [ 3, 15 ],
          "y": [ 6, 8 ]
        },
        {
          "chunks": [ [ "null", 20 ], [ "roof_4x4_utility", 40 ], [ "roof_6x6_utility", 20 ] ],
          "x": [ 3, 15 ],
          "y": [ 8, 11 ]
        }
      ]
    }
  }
]
