[
  {
    "type": "mapgen",
    "method": "json",
    "om_terrain": [ "s_library" ],
    "weight": 500,
    "object": {
      "fill_ter": "t_floor",
      "rows": [
        "~~~~~~~~~~~~~~~~~~~~~~~~",
        "**qq~~~~qq|-O-|---|-O-|*",
        "**qq~~~~qq|%dy|TTT|.dd|*",
        "**qq~~~~qq|dh.|..T|.h%|*",
        "*|===::===|--+|+--|+--|*",
        "*|Th......%...........O*",
        "*|Th......###%###%###.|*",
        "*|Th..................|*",
        "*|-----|..............|*",
        "*O.hhh.+..h%T%h.h%T%h.|*",
        "*|.TTT.|..............O*",
        "*|-----|..h%T%h.h%T%h.|*",
        "*|.hhh.+..............|*",
        "*O.TTT.|.a]aa]]aa]]aa]|*",
        "*|.hhh.|.a]aa]]aa]]aa]|*",
        "*O-----|.a]aa]]aa]]aa]|*",
        "*|#s#s#|.a]aa]]aa]]aa]|*",
        "*|.....+.a]aa]]aa]]aa]|*",
        "*|+|+|+|.a]aa]]aa]]aa]|*",
        "*|.|.|.|.a]aa]]aa]]aa]|*",
        "*|t|t|t|.............T|*",
        "*|-----|-O--O---O---O-|*",
        "*****4******************",
        "************************"
      ],
      "terrain": {
        "%": "t_console_broken",
        "*": "t_grass",
        "+": "t_door_c",
        "-": "t_wall_w",
        ".": "t_floor",
        ":": "t_door_glass_c",
        "=": "t_wall_glass",
        "O": "t_window",
        "q": "t_grass",
        "|": "t_wall_w",
        "~": "t_sidewalk",
        "4": "t_gutter_downspout"
      },
      "furniture": {
        "#": "f_counter",
        "T": "f_table",
        "]": "f_bookcase",
        "a": [
          "f_stool",
          "f_null",
          "f_null",
          "f_null",
          "f_null",
          "f_null",
          "f_null",
          "f_null",
          "f_null",
          "f_null",
          "f_null",
          "f_null",
          "f_null",
          "f_null",
          "f_null"
        ],
        "d": "f_desk",
        "h": "f_chair",
        "q": "f_bluebell",
        "s": "f_sink",
        "y": "f_indoor_plant_y"
      },
      "toilets": { "t": {  } },
      "place_items": [
        { "item": "magazines", "x": 10, "y": [ 13, 19 ], "chance": 90, "repeat": [ 3, 6 ] },
        { "item": "novels", "x": 13, "y": [ 13, 19 ], "chance": 98, "repeat": [ 12, 20 ] },
        { "item": "homebooks", "x": 14, "y": [ 13, 19 ], "chance": 90, "repeat": [ 3, 12 ] },
        { "item": "manuals", "x": 17, "y": [ 13, 19 ], "chance": 70, "repeat": [ 3, 6 ] },
        { "item": "textbooks", "x": 18, "y": [ 13, 19 ], "chance": 70, "repeat": [ 3, 6 ] },
        { "item": "novels", "x": 21, "y": [ 13, 15 ], "chance": 98, "repeat": [ 12, 20 ] },
        { "item": "mansion_books", "x": 21, "y": [ 16, 19 ], "chance": 20, "repeat": [ 2, 5 ] },
        { "item": "exotic_books", "x": 21, "y": [ 16, 19 ], "chance": 70, "repeat": [ 1, 5 ] },
        { "item": "library_elec", "x": [ 15, 17 ], "y": 2, "chance": 50, "repeat": [ 2, 3 ] },
        { "item": "office", "x": 11, "y": 3, "chance": 30 },
        { "item": "office", "x": 12, "y": 2, "chance": 30 },
        { "item": "office", "x": [ 20, 21 ], "y": 2, "chance": 80 }
      ]
    }
  },
  {
    "type": "mapgen",
    "method": "json",
    "om_terrain": "s_library_roof",
    "object": {
      "fill_ter": "t_flat_roof",
      "rows": [
        "                        ",
        "          |222222222223 ",
        "          |...........3 ",
        "          |.R.........3 ",
        " |22222222|........U..3 ",
        " |....................3 ",
        " |....................3 ",
        " |....................3 ",
        " |....................3 ",
        " |....................3 ",
        " |....................3 ",
        " |....................3 ",
        " |....................3 ",
        " |....................3 ",
        " |....................3 ",
        " |....................3 ",
        " |....................3 ",
        " |....................3 ",
        " |....................3 ",
        " |....................3 ",
        " |....................3 ",
        " |---5----------------3 ",
        "                        ",
        "                        "
      ],
      "palettes": [ "roof_palette" ],
      "place_items": [ { "item": "roof_trash", "x": [ 3, 18 ], "y": [ 6, 19 ], "chance": 50, "repeat": [ 1, 3 ] } ],
      "nested": { "U": { "chunks": [ "roof_2x2_infrastructure" ] }, "R": { "chunks": [ "roof_2x2_infrastructure_1" ] } },
      "place_nested": [
        {
          "chunks": [
            [ "null", 20 ],
            [ "roof_2x2_utilities_b", 15 ],
            [ "roof_2x2_utilities_c", 5 ],
            [ "roof_2x2_utilities_d", 40 ],
            [ "roof_2x2_utilities", 50 ]
          ],
          "x": [ 3, 15 ],
          "y": [ 6, 8 ]
        },
        {
          "chunks": [ [ "null", 20 ], [ "roof_4x4_utility", 40 ], [ "roof_6x6_utility", 20 ] ],
          "x": [ 3, 15 ],
          "y": [ 10, 14 ]
        }
      ]
    }
  },
  {
    "type": "mapgen",
    "method": "json",
    "om_terrain": [ "s_library_1" ],
    "weight": 500,
    "object": {
      "fill_ter": "t_floor",
      "rows": [
        "~~~~~~~~~~~~~~~~~~~~~~~~",
        "~~~~~~~~~~~~~~~~~~~~~~~~",
        "********~~**************",
        "*qrqrqrq~~qrqrqrqrqrqrq*",
        "*|----==::=====|--OO--|*",
        "*|d.b#.........|.hh.h.|*",
        "*|d..%.....hTh.|.TTTT.|*",
        "*|d.b#.....hTh.|..hhh.|*",
        "*|f..%.........|+-----|*",
        "*|...#................O*",
        "*O........h%%h...]]aa]|*",
        "*|]aa]]...h%%h...]]aa]|*",
        "*|]aa]]...h%%h...]]aa]|*",
        "*|]aa]]...h%%h...]]aa]|*",
        "*|]aa]]...h%%h...]]aa]|*",
        "*|....................|*",
        "*|]]]]]]]]]]]]]].]]]]]|*",
        "*|--------------+-----|*",
        "*****5***4|f.##|.|.t|***",
        "**********|@...=.+.s|***",
        "****5**5**|@...:.||||***",
        "**********O..U.=.+.s|***",
        "*5*****5**|LLLf|.|.t|***",
        "**********||||||O||||***"
      ],
      "terrain": {
        "%": "t_console_broken",
        "*": "t_grass",
        "+": "t_door_c",
        "-": "t_wall_w",
        ".": "t_floor",
        "5": "t_tree_pine",
        ":": "t_door_glass_c",
        ";": "t_door_locked",
        "=": "t_wall_glass",
        "O": "t_window",
        "q": "t_grass",
        "r": "t_grass",
        "|": "t_wall_w",
        "4": "t_gutter_downspout",
        "~": "t_sidewalk"
      },
      "furniture": {
        "#": "f_counter",
        "@": "f_sofa",
        "U": "f_armchair",
        "L": "f_locker",
        "T": "f_table",
        "]": "f_bookcase",
        "a": [
          "f_stool",
          "f_null",
          "f_null",
          "f_null",
          "f_null",
          "f_null",
          "f_null",
          "f_null",
          "f_null",
          "f_null",
          "f_null",
          "f_null"
        ],
        "b": "f_stool",
        "d": "f_desk",
        "s": "f_sink",
        "f": "f_indoor_plant",
        "h": "f_chair",
        "q": "f_bluebell",
        "r": "f_dahlia"
      },
      "toilets": { "t": {  } },
      "place_items": [
        { "item": "magazines", "x": 21, "y": [ 10, 14 ], "chance": 80, "repeat": [ 5, 12 ] },
        { "item": "novels", "x": [ 2, 21 ], "y": 16, "chance": 95, "repeat": [ 12, 20 ] },
        { "item": "homebooks", "x": [ 17, 18 ], "y": [ 10, 14 ], "chance": 80, "repeat": [ 4, 8 ] },
        { "item": "manuals", "x": 2, "y": [ 11, 14 ], "chance": 70, "repeat": [ 2, 4 ] },
        { "item": "textbooks", "x": 2, "y": [ 11, 14 ], "chance": 70, "repeat": 2 },
        { "item": "manuals", "x": [ 5, 6 ], "y": [ 11, 14 ], "chance": 70, "repeat": [ 2, 6 ] },
        { "item": "exotic_books", "x": [ 5, 6 ], "y": [ 11, 14 ], "chance": 60, "repeat": [ 1, 4 ] },
        { "item": "office", "x": 2, "y": [ 5, 7 ], "chance": 50, "repeat": [ 1, 3 ] }
      ],
      "place_monsters": [ { "monster": "GROUP_MAYBE_ZOMBIE", "x": [ 16, 21 ], "y": [ 5, 7 ], "density": 1 } ]
    }
  },
  {
    "type": "mapgen",
    "method": "json",
    "om_terrain": "s_library_roof_1",
    "object": {
      "fill_ter": "t_flat_roof",
      "rows": [
        "                        ",
        "                        ",
        "                        ",
        " |222222222222222222223 ",
        " |....................3 ",
        " |....................3 ",
        " |....................3 ",
        " |....................3 ",
        " |....................3 ",
        " |.....x..............3 ",
        " |....................3 ",
        " |....................3 ",
        " |....................3 ",
        " |....................3 ",
        " |....................3 ",
        " |....................3 ",
        " |....................3 ",
        " |--------5.........--3 ",
        "          |......Z..3   ",
        "          |.........3   ",
        "          |..R......3   ",
        "          |.........3   ",
        "          |......U..3   ",
        "          |---------3   "
      ],
      "palettes": [ "roof_palette" ],
      "nested": {
        "U": { "chunks": [ "roof_2x2_infrastructure" ] },
        "R": { "chunks": [ "roof_2x2_infrastructure_1" ] },
        "Z": { "chunks": [ "roof_2x2_infrastructure_2" ] }
      },
      "place_nested": [
        {
          "chunks": [
            [ "null", 20 ],
            [ "roof_2x2_utilities_b", 15 ],
            [ "roof_2x2_utilities_c", 5 ],
            [ "roof_2x2_utilities_d", 40 ],
            [ "roof_2x2_utilities", 50 ]
          ],
          "x": [ 5, 15 ],
          "y": [ 5, 7 ]
        },
        {
          "chunks": [ [ "null", 20 ], [ "roof_4x4_utility", 40 ], [ "roof_6x6_utility", 20 ] ],
          "x": [ 3, 13 ],
          "y": [ 9, 10 ]
        }
      ]
    }
  },
  {
    "type": "mapgen",
    "method": "json",
    "om_terrain": [ "s_library_2" ],
    "weight": 1000,
    "object": {
      "fill_ter": "t_floor",
      "rows": [
        "                        ",
        "                        ",
        "  ---ww----++----ww---  ",
        "  |...........c.t...B|  ",
        "  |bbbbbbb....c.....f|  ",
        "  |bbbbbbb....ccccc.f|  ",
        "  w..ss..............w  ",
        "  w.....s..s...CC....w  ",
        "  |bbbbbbbbbb.CddC..b|  ",
        "  |bbbbbbbbbb.CddC.sb|  ",
        "  w.......ss...CC..sb|  ",
        "  ws..ssss.....CC..sb|  ",
        "  |bbbbbbbbbb.CddC..b|  ",
        "  |bbbbbbbbbb.CddC..b|  ",
        "  w....sss.s...CC...b|  ",
        "  wsss........ss...sb|  ",
        "  |bbbbbbbbbbbbbf...b|  ",
        "  --------------w+----  ",
        "  M       4|VVV...+.S|  ",
        "           w.tt...|.&|  ",
        "           wX..t.f||||  ",
        "           w...t..|.t|  ",
        "           |ftt...+.&|  ",
        "           |||||||||||  "
      ],
      "nested": { "M": { "chunks": [ "roof_6x6_garden_1" ] } },
      "terrain": {
        " ": [ "t_grass", "t_grass", "t_grass", "t_dirt" ],
        "M": "t_grass",
        "+": "t_door_c",
        "-": "t_wall_b",
        ".": "t_floor",
        "w": "t_window_domestic",
        "|": "t_wall_b",
        "4": "t_gutter_downspout"
      },
      "furniture": {
        "b": "f_bookcase",
        "V": "f_bookcase",
        "B": "f_trashcan",
        "X": "f_armchair",
        "S": "f_sink",
        "c": "f_counter",
        "C": [ "f_chair", "f_null", "f_null" ],
        "d": "f_table",
        "f": "f_indoor_plant",
        "s": [ "f_stool", "f_null", "f_null", "f_null", "f_null", "f_null", "f_null" ],
        "t": "f_stool"
      },
      "toilets": { "&": {  } },
      "items": { "S": { "item": "softdrugs", "chance": 30 }, "V": { "item": "textbooks", "chance": 30 } },
      "place_items": [
        { "item": "magazines", "x": [ 3, 9 ], "y": 4, "chance": 90, "repeat": [ 5, 10 ] },
        { "item": "magazines", "x": 20, "y": [ 8, 16 ], "chance": 90, "repeat": [ 5, 10 ] },
        { "item": "novels", "x": [ 3, 9 ], "y": 5, "chance": 96, "repeat": [ 5, 10 ] },
        { "item": "homebooks", "x": [ 3, 9 ], "y": 5, "chance": 96, "repeat": [ 1, 8 ] },
        { "item": "novels", "x": [ 3, 12 ], "y": [ 8, 9 ], "chance": 96, "repeat": [ 5, 12 ] },
        { "item": "mansion_books", "x": [ 3, 12 ], "y": [ 8, 9 ], "chance": 40, "repeat": [ 1, 6 ] },
        { "item": "manuals", "x": [ 3, 12 ], "y": [ 12, 13 ], "chance": 92, "repeat": [ 1, 6 ] },
        { "item": "textbooks", "x": [ 3, 12 ], "y": [ 12, 13 ], "chance": 92, "repeat": [ 1, 6 ] },
        { "item": "textbooks", "x": [ 3, 12 ], "y": 16, "chance": 88, "repeat": [ 1, 6 ] },
        { "item": "exotic_books", "x": [ 3, 15 ], "y": 16, "chance": 50, "repeat": [ 1, 6 ] }
      ],
      "place_monsters": [ { "monster": "GROUP_ZOMBIE", "x": [ 0, 0 ], "y": [ 23, 23 ], "chance": 2, "repeat": [ 2, 3 ] } ]
    }
  },
  {
    "type": "mapgen",
    "method": "json",
    "om_terrain": "s_library_roof_2",
    "object": {
      "fill_ter": "t_flat_roof",
      "rows": [
        "                        ",
        "                        ",
        "  |2222222222222222223  ",
        "  |..................3  ",
        "  |..................3  ",
        "  |..................3  ",
        "  |..................3  ",
        "  |..................3  ",
        "  |..................3  ",
        "  |..................3  ",
        "  |..................3  ",
        "  |..................3  ",
        "  |..................3  ",
        "  |..................3  ",
        "  |..................3  ",
        "  |..................3  ",
        "  |..................3  ",
        "  |--------5.........3  ",
        "           |......Z..3  ",
        "           |.U.......3  ",
        "           |.....R...3  ",
        "           |.........3  ",
        "           |.........3  ",
        "           |---------3  "
      ],
      "palettes": [ "roof_palette" ],
      "nested": {
        "U": { "chunks": [ "roof_2x2_infrastructure" ] },
        "R": { "chunks": [ "roof_2x2_infrastructure_1" ] },
        "Z": { "chunks": [ "roof_2x2_infrastructure_2" ] }
      },
      "place_nested": [
        {
          "chunks": [
            [ "null", 20 ],
            [ "roof_2x2_utilities_b", 15 ],
            [ "roof_2x2_utilities_c", 5 ],
            [ "roof_2x2_utilities_d", 40 ],
            [ "roof_2x2_utilities", 50 ]
          ],
          "x": [ 5, 15 ],
          "y": [ 13, 14 ]
        },
        {
          "chunks": [ [ "null", 20 ], [ "roof_4x4_utility", 40 ], [ "roof_6x6_utility", 20 ] ],
          "x": [ 4, 10 ],
          "y": [ 4, 6 ]
        }
      ]
    }
  }
]
