[
  {
    "type": "palette",
    "id": "bunker",
    "terrain": {
      "#": "t_rock",
      "*": "t_chaingate_c",
      "+": "t_door_metal_c",
      "-": "t_scrap_wall",
      "_": "t_metal_floor",
      ",": "t_carpet_metal",
      "1": "t_column",
      "<": "t_stairs_up",
      "=": "t_chainfence",
      "|": "t_wall_metal",
      ":": "t_secretdoor_metal_c",
      ";": "t_secretdoor_metal_o",
      "~": "t_water_pump",
      "G": "t_generator_broken",
      "t": "t_metal_floor"
    },
    "furniture": {
      "A": "f_air_filter",
      "a": "f_standing_tank",
      "b": "f_bookcase",
      "B": "f_bed",
      "c": "f_counter",
      "C": "f_cupboard",
      "d": "f_dresser",
      "D": "f_desk",
      "e": "f_ergometer",
      "E": "f_exercise",
      "F": "f_fridge",
      "f": "f_sofa",
      "h": "f_chair",
      "H": "f_water_heater",
      "K": "f_sink",
      "l": "f_utility_shelf",
      "L": "f_table",
      "O": "f_oven",
      "P": "f_punching_bag",
      "r": "f_rack",
      "R": "f_rack",
      "s": "f_shower",
      "S": "f_woodstove",
      "T": "f_table",
      "U": "f_utility_shelf",
      "u": "f_utility_shelf",
      "v": "f_utility_shelf",
      "V": "f_utility_shelf",
      "w": "f_wardrobe",
      "W": "f_water_purifier",
      "Y": "f_rack_coat",
      "^": "f_rubble",
      "&": "f_trashcan",
      "{": "f_rack",
      "}": "f_bookcase"
    },
    "toilets": { "t": {  } }
  },
  {
    "type": "palette",
    "id": "empty_bunker_items",
    "items": {
      "b": [ { "item": "manuals", "chance": 60 }, { "item": "textbooks", "chance": 40 } ],
      "B": { "item": "bed", "chance": 70, "repeat": [ 1, 2 ] },
      "c": { "item": "hardware", "chance": 50 },
      "C": [ { "item": "dining", "chance": 30, "repeat": [ 1, 3 ] }, { "item": "oven", "chance": 20 } ],
      "d": { "item": "allclothes", "chance": 80, "repeat": [ 2, 4 ] },
      "D": { "item": "office", "chance": 70 },
      "l": { "item": "hardware", "chance": 50, "repeat": [ 1, 2 ] },
      "L": { "item": "dining", "chance": 30 },
      "r": { "item": "stash_wood", "chance": 85 },
      "R": { "item": "hardware", "chance": 80 },
      "S": { "item": "oven", "chance": 80 },
      "T": { "item": "tools_common", "chance": 60, "repeat": [ 1, 2 ] },
      "U": { "item": "gear_survival", "chance": 20, "repeat": [ 3, 5 ] },
      "u": [ { "item": "cannedfood", "chance": 20, "repeat": [ 1, 5 ] }, { "item": "pasta", "chance": 10, "repeat": [ 1, 3 ] } ],
      "v": { "item": "softdrugs", "chance": 50 },
      "V": { "item": "bags", "chance": 30 },
      "w": { "item": "allclothes", "chance": 80, "repeat": [ 2, 4 ] },
      "Y": [ { "item": "jackets", "chance": 15 }, { "item": "hats", "chance": 15 }, { "item": "winter", "chance": 10 } ],
      "^": { "item": "shelter", "chance": 30 },
      "{": [ { "item": "lmoe_guns", "chance": 80 }, { "item": "ammo", "y": 3, "chance": 15, "repeat": [ 3, 7 ] } ],
      "}": { "item": "novels", "chance": 90, "repeat": [ 3, 8 ] }
    }
  },
  {
    "type": "mapgen",
    "method": "json",
    "om_terrain": [ "lmoe" ],
    "//": "Above ground",
    "weight": 100,
    "object": {
      "rows": [
        "       S     S         S",
        "   S       S     S      ",
        " S     S            S   ",
        "          S             ",
        "   S    S SSSSS      S  ",
        "      SSSSSSSSSSSS      ",
        "     SS$$$$$$$$$$SS     ",
        "     S$$TTTTTTTT$$S   S ",
        "    SS$$T))))))T$$S     ",
        " S  SS$$T)####)T$$SS    ",
        "    SS$$T)#>>#)T$$SS    ",
        "    SS$$T)#..#)T$$SS    ",
        "    SS$$T)#+##)T$$SS   S",
        "  S  S$$T))_)))T$$SS    ",
        "     S$$$$$_$$$$$$S     ",
        "     SS$$$$_$$$$$SS  S  ",
        "      SSSSS_SSSSSS      ",
        "S      S S   SS S       ",
        "                 S    S ",
        "   S   S                ",
        "            S  S        ",
        "                       S",
        "    S      S            ",
        "                  S     "
      ],
      "terrain": {
        " ": [ [ "t_grass", 10 ], [ "t_grass_long", 2 ], [ "t_shrub", 1 ], [ "t_dirt", 5 ] ],
        "_": "t_dirt",
        "#": "t_rock",
        "$": [
          "t_tree",
          "t_tree_apple",
          "t_tree_peach",
          "t_tree_pear",
          "t_tree_hickory",
          "t_tree_beech",
          "t_tree_coffee",
          [ "t_tree_young", 14 ],
          [ "t_shrub", 20 ]
        ],
        "S": [
          [ "t_grass", 15 ],
          [ "t_tree_young", 2 ],
          [ "t_shrub", 2 ],
          "t_tree",
          "t_tree_apple",
          "t_tree_peach",
          "t_tree_pear",
          "t_tree_hickory",
          "t_tree_beech",
          "t_tree_coffee"
        ],
        "+": "t_door_metal_c",
        ".": "t_rock_floor",
        ">": "t_stairs_down",
        ")": "t_slope_up",
        "T": [ "t_tree", "t_tree_apple", "t_tree_peach", "t_tree_pear", "t_tree_hickory", "t_tree_beech", "t_tree_coffee" ]
      },
      "items": { " ": [ { "item": "forest", "chance": 1 }, { "item": "field", "chance": 2 } ] }
    }
  },
  {
    "type": "mapgen",
    "method": "json",
    "om_terrain": [ "lmoe_under_empty" ],
    "//": "Empty LMOE shelter that has been looted or used.",
    "//2": "This particular 2-bed shelter is a more professionally done, all metal bomb shelter with kitchen, secret safe room / gun locker, and workshop.",
    "weight": 100,
    "object": {
      "fill_ter": "t_metal_floor",
      "rows": [
        "########################",
        "########################",
        "##||||||||||||||||||||##",
        "##|{{{{{|UUUUUU|w__BB|##",
        "##|u____|U____U|d__BB|##",
        "##|u___h|U_UU_U|A,,,_|##",
        "##|u___D|=*==*=|_,,,}|##",
        "##|A____:______+_,,,}|##",
        "##|||||||_1,,1_|S__hD|##",
        "##|VVVVV=_e,,P_|||||||##",
        "##|_____*__,,____|s_K|##",
        "##|vvvvv=_E,,f___+__t|##",
        "##|||||||||++|||||||||##",
        "##|c_bbbbA|,,|CSCCKCC|##",
        "##|c______|,,|u_____C|##",
        "##|c_TT___|,,|u_hLh_F|##",
        "##|c_TTh__+__+_______|##",
        "##|c_TT___|__|rrrr__~|##",
        "##|c______|__|||||+|||##",
        "##|c______|__*__a|__A|##",
        "##|ccccccc|<<=G_a|HlW|##",
        "##||||||||||||||||||||##",
        "########################",
        "########################"
      ],
      "palettes": [ "bunker", "empty_bunker_items" ]
    }
  },
  {
    "type": "mapgen",
    "method": "json",
    "om_terrain": [ "lmoe_under_empty" ],
    "//": "Empty LMOE shelter that has been looted or used.",
    "//2": "This particular 4-bed shelter is definitely homemade, mostly carved out of bare rock, and seems to be incomplete.",
    "weight": 100,
    "object": {
      "fill_ter": "t_rock_floor",
      "rows": [
        "########################",
        "########################",
        "##<<..=...^#############",
        "##....*....^############",
        "##....=....^############",
        "##===###Y...^###########",
        "##G.R###-+|||####||||||#",
        "##a.l###A.|UUVVvv|{{{{|#",
        "##=*=###..|U.....:....|#",
        "##c..ll-..|Uuuu.u||||||#",
        "##c....+..|||||+||Dh..d#",
        "##c.h..-r.+......+...BB#",
        "##c.TTT-r.-r..h..------#",
        "#######--+-r.hLh.+...BB#",
        "#######-F.Sr..h..-Dh..d#",
        "#######-C.......-------#",
        "#######-CCKC.uu.+...hD-#",
        "#######-----.--+-}....-#",
        "#########W.~.-s.-}.BBS-#",
        "#########H...-&.-w.BBr-#",
        "#########l..A-Kt-------#",
        "#########--------#######",
        "########################",
        "########################"
      ],
      "palettes": [ "bunker", "empty_bunker_items" ]
    }
  },
  {
    "type": "mapgen",
    "method": "json",
    "om_terrain": [ "lmoe_under_empty" ],
    "//": "Empty LMOE shelter that has been looted or used.",
    "//2": "This is a commercially built 4-bed LMOE shelter based on IRL plans.",
    "//3": "There are extensive secret rooms which might contain a lot of treasure in the non-looted version.",
    "weight": 100,
    "object": {
      "fill_ter": "t_carpet_metal",
      "rows": [
        "##|||||#################",
        "##|__<|||||||###########",
        "##|Y_<|w,BBd|###########",
        "||||+||},BB,|###########",
        "|A,,,E|,,,,,|###########",
        "|f,,,,|+|||||||||||#####",
        "|f,,,e|,,,,b|lllll|#####",
        "|f,,,,|,,h,,|u___U|#####",
        "|Dh,,P|,hLh,|u_u_U|#####",
        "|,,,,,|,hLh,|u_u_U|#####",
        "|,,,,,+,,h,,|u_u_U|#####",
        "|,|||||~,,,u|u_u_U|#####",
        "|,+,,B|K,,,u:__v_U|#####",
        "|,|d,B|COC,u|u_v_U|#####",
        "|,||||||||+||u_v_U|#####",
        "|,+,,B|t,,,K|u___U|#####",
        "|}|d,B|WAv,s|AV_VU|#####",
        "|;|||||||||:|||+||||||||",
        "|_{|l__aa|{_|l,,RRRR=_G|",
        "|_{|l__aa||+|l,,,,,,*_a|",
        "|_{|l____ll_|l,,,,,c=_a|",
        "|_{|l_______+,,h,,,c=_l|",
        "|__+________|TTTcccc=_A|",
        "||||||||||||||||||||||||"
      ],
      "palettes": [ "bunker", "empty_bunker_items" ]
    }
  }
]
