[
  {
    "type": "mapgen",
    "method": "json",
    "om_terrain": [ "mass_grave" ],
	"weight": 100,
    "object": {
      "fill_ter": "t_dirt",
      "rows": [
        "                        ",
        " bbbbbbbbbbddbbbbbbbbbb ",
        " b                    b ",
        " b aaaaaaaaaaaaaaaaaa b ",
        " b aaaaaaaaaaaaaaaaaa b ",
        " b aaaaaaaaaaaaaaaaaa b ",
        " b aaaaaaaaaaaaaaaaaa b ",
        " b aaaaaaaaaaaaaaaaaa b ",
        " b aaaaaaaaaaaaaaaaaa b ",
        " b aaaaaaaaaaaaaaaaaa b ",
        " b aaaaaaaaaaaaaaaaaa b ",
        " d aaaaaaaaaaaaaaaaaa d ",
        " d aaaaaaaaaaaaaaaaaa d ",
        " b aaaaaaaaaaaaaaaaaa b ",
        " b aaaaaaaaaaaaaaaaaa b ",
        " b aaaaaaaaaaaaaaaaaa b ",
        " b aaaaaaaaaaaaaaaaaa b ",
        " b aaaaaaaaaaaaaaaaaa b ",
        " b aaaaaaaaaaaaaaaaaa b ",
        " b aaaaaaaaaaaaaaaaaa b ",
        " b aaaaaaaaaaaaaaaaaa b ",
        " b                    b ",
        " bbbbbbbbbbddbbbbbbbbbb ",
        "                        "
      ],
      "terrain": { "a": "t_pit_corpsed", "b": "t_fence_barbed", "d": "t_fence_barbed" },
      "furniture": {},
      "place_monsters": [
        {
          "monster": "GROUP_ZOMBIE",
          "chance": 1,
          "repeat": [ 1 ],
          "x": [ 3, 20 ],
          "y": [ 3, 20 ]
        }
      ]
    }
  }
]