[
  {
    "method": "json",
    "type": "mapgen",
    "weight": 100,
    "om_terrain": [
      [ "movietheater_0_0", "movietheater_1_0", "movietheater_2_0" ],
      [ "movietheater_0_1", "movietheater_1_1", "movietheater_2_1" ],
      [ "movietheater_0_2", "movietheater_1_2", "movietheater_2_2" ]
    ],
    "object": {
      "fill_ter": "t_thconc_floor",
      "rows": [
        "!!!!!!!!!!!!!!!!!!!!!!!!!!%%^^%%%%%^^%%%%%^^%%!!!!!!!!!!!!!!!!!!!!!!!!!!",
        "!TsTsTsTsTsTsTsTsTG....|........................|.......-....|..TT|.XXX!",
        "!......................|........................|.......-....+...T|...X!",
        "!......................|||%%^^%%%%%^^%%%%%^^%%|||....!!G-.-..|...T|...X!",
        "!+|+|+|+|+|+|+|+|+|+|..|...******************.vv|....!!G-.-..T...T|X..X!",
        "!&|&|&|&|&|&|&|&|&|&|..|...*$$$$$$$$$$$$$$$$*...........-.-..Tc..T|X...!",
        "!||||||||||||||||||||......*$**************$*...@%@.....-.-..T...g|....!",
        "!&|&|&|&|&|&|&|&|&|&|......*$$$$********$$$$*...@%@.....-.-..T...g|...X!",
        "!+|+|+|+|+|+|+|.....||||...****$********$****...@%@.....-.-..T...r|t..X!",
        "!...................||||......*$*|T%T%|*$*......@%@.......-..T...r|t..X!",
        "!.............................*$*d*e*e|*$*................-..|...o|....!",
        "!TsTsTsTsTsTsTsTTG..........!.*$*||||||*$*.!............RR-..|.........!",
        "!|||||||||||||||||||||||......*$********$*......@%@..........|.........!",
        "!vFvF|6.6.6...7.7..66..|......*$********$*......@%@..........|gg..|....!",
        "!....|c.c.c...........G|....!.*$********$*.!....@%@..!!G.....||||||{...!",
        "!.............................*$********$*......@%@..!!G.....|vFTT|{...!",
        "!......c........c.............*$********$*...................|...T|{...!",
        "!...66666....6666...........!.*$********$*.!.................|...T||+||!",
        "!...66666....6666.............*$********$*......@%@..............T|..{{!",
        "!...c.c.......c.......G|......*$********$*......@%@..............T|....!",
        "!....................c6|......*$********$*......@%@..!!G.........T|..ct!",
        "!7...................c6|......*$********$*......@%@..!!G.........T|..ct!",
        "!....................c6|......*$********$*...................|...T||+||!",
        "!...7.7.7.7.7.7.7.7....|......*$********$*...................|...T|<.XX!",
        "!|||||||||||||||||||||||||||||*$********$*|||||||||||||||||||||||||||||!",
        "!......................#|..tt|*$********$*|tt..|#......................!",
        "D........#.#.#.#.#.#.#.#|..tt|b$********$b|tt..|#.#.#.#.#.#.#.#........D",
        "!........#.#.#.#.#.#.#.#|....|b$***!!***$b|....|#.#.#.#.#.#.#.#........!",
        "!...H.H..#.#.#.#.#.#.#.#|....|b$***!!***$b|...c|#.#.#.#.#.#.#.#..H.H...!",
        "!...H.H..#.#.#.#.#.#.#.#|t...|b$********$b|...t|#.#.#.#.#.#.#.#..H.H...!",
        "!...H.H..#.#.#.#.#.#.#.#wt...|b$********$b|..ctw#.#.#.#.#.#.#.#..H.H...!",
        "!...H.H..#.#.#.#.#.#.#.#wZc..|b$********$b|...Zw#.#.#.#.#.#.#.#..H.H...!",
        "!...H.H..#.#.#.#.#.#.#.#|....|*$********$*|....|#.#.#.#.#.#.#.#..H.H...!",
        "!...H.H..#.#.#.#.#.#.#.#|...G|*$********$*|G...|#.#.#.#.#.#.#.#..H.H...!",
        "!...H.H..#.#.#.#.#.#.#.#|..|||*$********$*|||..|#.#.#.#.#.#.#.#..H.H...!",
        "!...H.H..#.#.#.#.#.#.#.#|..|a.*$********$*.F|..|#.#.#.#.#.#.#.#..H.H...!",
        "!...H.H..#.#.#.#.#.#.#.#|..|..*$********$*.y|..|#.#.#.#.#.#.#.#..H.H...!",
        "!...H.H..#.#.#.#.#.#.#.#|..|..*$********$*.v|..|#.#.#.#.#.#.#.#..H.H...!",
        "!...H.H..#.#.#.#.#.#.#.#|..|F.*$********$*.y|..|#.#.#.#.#.#.#.#..H.H...!",
        "!...H.H..#.#.#.#.#.#.#.#|..|y.*$***Ki***$*.F|..|#.#.#.#.#.#.#.#..H.H...!",
        "!........#.#.#.#.#.#.#.#|..|v.*$***iK***$*..|..|#.#.#.#.#.#.#.#........!",
        "!........#.#.#.#.#.#.#.#|l.|y.*$********$*..|.l|#.#.#.#.#.#.#.#........!",
        "!......................#|l.|F.*$********$*.a|.l|#......................!",
        "!.......----.-----||||||||+|||*$********$*|||+||||||||||----.-----.....!",
        "!.......................+******$********$******+.......................!",
        "!.......................|*$$$$$$********$$$$$$*|.......................!",
        "!.......................+******$********$******+.......................!",
        "!|||||||||||||||||||||||||||||*$********$*|||||||||||||||||||||||||||||!",
        "!|||||||||||||||||||||||||||||*$********$*|||||||||||||||||||||||||||||!",
        "!......................#|..tt|*$********$*|tt..|#......................!",
        "D........#.#.#.#.#.#.#.#|..tt|b$********$b|tt..|#.#.#.#.#.#.#.#........D",
        "!........#.#.#.#.#.#.#.#|....|b$***!!***$b|....|#.#.#.#.#.#.#.#........!",
        "!...H.H..#.#.#.#.#.#.#.#|....|b$***!!***$b|...c|#.#.#.#.#.#.#.#..H.H...!",
        "!...H.H..#.#.#.#.#.#.#.#|t...|b$********$b|...t|#.#.#.#.#.#.#.#..H.H...!",
        "!...H.H..#.#.#.#.#.#.#.#wt...|b$********$b|..ctw#.#.#.#.#.#.#.#..H.H...!",
        "!...H.H..#.#.#.#.#.#.#.#wZc..|b$********$b|...Zw#.#.#.#.#.#.#.#..H.H...!",
        "!...H.H..#.#.#.#.#.#.#.#|....|*$********$*|....|#.#.#.#.#.#.#.#..H.H...!",
        "!...H.H..#.#.#.#.#.#.#.#|...G|*$********$*|G...|#.#.#.#.#.#.#.#..H.H...!",
        "!...H.H..#.#.#.#.#.#.#.#|..|||*$********$*|||..|#.#.#.#.#.#.#.#..H.H...!",
        "!...H.H..#.#.#.#.#.#.#.#|..|a.*$********$*.v|..|#.#.#.#.#.#.#.#..H.H...!",
        "!...H.H..#.#.#.#.#.#.#.#|..|..*$********$*.y|..|#.#.#.#.#.#.#.#..H.H...!",
        "!...H.H..#.#.#.#.#.#.#.#|..|..*$********$*.F|..|#.#.#.#.#.#.#.#..H.H...!",
        "!...H.H..#.#.#.#.#.#.#.#|..|v.*$********$*.y|..|#.#.#.#.#.#.#.#..H.H...!",
        "!...H.H..#.#.#.#.#.#.#.#|..|y.*$***Ki***$*.v|..|#.#.#.#.#.#.#.#..H.H...!",
        "!........#.#.#.#.#.#.#.#|..|F.*$***iK***$*..|..|#.#.#.#.#.#.#.#........!",
        "!........#.#.#.#.#.#.#.#|l.|y.*$********$*..|.l|#.#.#.#.#.#.#.#........!",
        "!......................#|l.|v.*$********$*.a|.l|#......................!",
        "!.......----.-----||||||||+|||*$********$*|||+||||||||||----.-----.....!",
        "!.......................+******$********$******+.......................!",
        "!.......................|*$$$$$$$$$$$$$$$$$$$$*|.......................!",
        "!.......................+**********************+.......................!",
        "!!!!!!!!!!!!!!!!!!!!!!!!!!!!!!!!!!!!!!!!!!!!!!!!!!!!!!!!!!!!!!!!!!!!!!!!"
      ],
      "palettes": [ "movie_theater_palette.json" ],
      "terrain": { "#": "t_thconc_floor", "H": "t_thconc_floor", "y": "t_thconc_floor" },
      "toilets": { "&": {  } },
      "vendingmachines": { "v": { "item_group": "vending_drink", "lootable": true }, "F": { "item_group": "vending_food", "lootable": true } },
      "items": {
        "&": { "item": "alcohol", "chance": 10 },
        "T": { "item": "snacks", "chance": 5 },
        "X": { "item": "snacks", "chance": 30, "repeat": [ 6, 12 ] },
        "g": { "item": "fridgesnacks", "chance": 70, "repeat": [ 6, 12 ] },
        "G": { "item": "trash", "chance": 20, "repeat": [ 2, 4 ] },
        "t": [
          { "item": "snacks", "chance": 3 },
          { "item": "consumer_electronics", "chance": 4 },
          { "item": "cubical_office", "chance": 10 },
          { "item": "office_breakroom", "chance": 5 }
        ],
        "#": [
          { "item": "jackets", "chance": 3 },
          { "item": "bags", "chance": 4 },
          { "item": "trash_cart", "chance": 8 },
          { "item": "hatstore_accessories", "chance": 5 }
        ],
        "H": [
          { "item": "jackets", "chance": 3 },
          { "item": "bags", "chance": 4 },
          { "item": "trash_cart", "chance": 10 },
          { "item": "hatstore_accessories", "chance": 5 }
        ],
        "{": [
          { "item": "jackets", "chance": 3 },
          { "item": "bags", "chance": 4 },
          { "item": "consumer_electronics", "chance": 5 },
          { "item": "hatstore_accessories", "chance": 5 },
          { "item": "manuals", "chance": 5 },
          { "item": "textbooks", "chance": 5 }
        ],
        "l": [
          { "item": "softdrugs", "chance": 10 },
          { "item": "bags", "chance": 20 },
          { "item": "consumer_electronics", "chance": 5 },
          { "item": "alcohol", "chance": 5 },
          { "item": "manuals", "chance": 5 },
          { "item": "textbooks", "chance": 5 }
        ]
      },
      "place_items": [
        { "chance": 35, "item": "misc_smoking", "x": 5, "y": 7 },
        { "chance": 45, "item": "toy_store", "x": 21, "y": 22 },
        { "chance": 45, "item": "toy_store", "x": 8, "y": 14 },
        { "item": "cash_register_random", "x": 34, "y": 9, "chance": 100 },
        { "item": "cash_register_random", "x": 36, "y": 9, "chance": 100 },
        { "item": "cash_register_random", "x": 61, "y": [ 4, 9 ], "chance": 100 }
      ],
      "place_monsters": [
        { "density": 0.25, "monster": "GROUP_ZOMBIE", "x": 12, "y": 15 },
        { "density": 0.25, "monster": "GROUP_ZOMBIE", "x": 57, "y": 15 },
        { "density": 0.25, "monster": "GROUP_ZOMBIE", "x": 69, "y": 11 },
        { "density": 0.25, "monster": "GROUP_ZOMBIE", "x": 12, "y": 34 },
        { "density": 0.25, "monster": "GROUP_ZOMBIE", "x": 60, "y": 34 },
        { "density": 0.25, "monster": "GROUP_ZOMBIE", "x": 12, "y": 58 },
        { "density": 0.25, "monster": "GROUP_ZOMBIE", "x": 60, "y": 58 }
      ],
      "place_item": [
        { "item": "ketchup", "repeat": 1, "x": 65, "y": 16 },
        { "item": "ketchup", "repeat": 1, "x": 65, "y": 17 },
        { "item": "ketchup", "repeat": 1, "x": 65, "y": 18 },
        { "item": "mustard", "repeat": 1, "x": 65, "y": 20 },
        { "item": "mustard", "repeat": 1, "x": 65, "y": 21 },
        { "item": "mustard", "repeat": 1, "x": 65, "y": 22 },
        { "item": "vinegar", "repeat": 1, "x": 65, "y": 22 }
      ]
    }
  },
  {
    "method": "json",
    "type": "mapgen",
    "weight": 100,
    "om_terrain": [
      [ "movietheater_roof_0_0", "movietheater_roof_1_0", "movietheater_roof_2_0" ],
      [ "movietheater_roof_0_1", "movietheater_roof_1_1", "movietheater_roof_2_1" ],
      [ "movietheater_roof_0_2", "movietheater_roof_1_2", "movietheater_roof_2_2" ]
    ],
    "object": {
      "fill_ter": "t_thconc_floor",
      "rows": [
        "222222222222222222222222222222222222222222222222222222222222222222222222",
        "|......................................................................3",
        "|......=............................................................:..3",
        "|......................................................................3",
        "|......&..&..&.............................................&...........3",
        "|.................................................................=....3",
        "|......................................................................3",
        "|......&..&..&.............................................&...........3",
        "|......................................................................3",
        "|....=............................................................=....3",
        "|..........................................................&...........3",
        "|......................................................................3",
        "|......................................................................3",
        "|......................................................................3",
        "|......................................................................3",
        "|...........................................%%%D%%%%%%%%%%%%%%%%%%%%%..3",
        "|...........................................%...........AAAAA.AAAAA.%..3",
        "|...........................................%...YY..................%..3",
        "|...........................................%...YY...################..3",
        "|...........................................%........#6666______#pHH#..3",
        "|...........................................%........+__________#_HH#..3",
        "|...........................................%........#6666______+__p#..3",
        "|...........................................%........#__________#####..3",
        "|...........................................%........#__________#__>#..3",
        "|...........................................D........#__________##+##..3",
        "|...........................................%........#______________#..3",
        "|...........................................%........+__________CCC_#..3",
        "|...........................................%........#__C______CCC_p#..3",
        "|...........................................%..X.....#_CCC______C__p#..3",
        "|...........................................%........#___C_______CCC#..3",
        "|...........................................%%%%%%%%%################..3",
        "|......................................................................3",
        "|......................................................................3",
        "|......................................................................3",
        "|......................................................................3",
        "|......................................................................3",
        "|......................................................................3",
        "|......................................................................3",
        "|......................................................................3",
        "|......................................................................3",
        "|......................................................................3",
        "|......................................................................3",
        "|......................................................................3",
        "|......................................................................3",
        "|......................................................................3",
        "|......................................................................3",
        "|......................................................................3",
        "|......................................................................3",
        "|......................................................................3",
        "|......................................................................3",
        "|......................................................................3",
        "|......................................................................3",
        "|......................................................................3",
        "|......................................................................3",
        "|......................................................................3",
        "|......................................................................3",
        "|......................................................................3",
        "|......................................................................3",
        "|......................................................................3",
        "|......................................................................3",
        "|......................................................................3",
        "|......................................................................3",
        "|......................................................................3",
        "|......................................................................3",
        "|......................................................................3",
        "|......:..................................................:............3",
        "5......................................................................5",
        "|......................................................................3",
        "|......................................................................3",
        "|......................................................................3",
        "|......................................................................3",
        "|----------------------------------------------------------------------3"
      ],
      "palettes": [ "roof_palette" ],
      "liquids": { "6": { "liquid": "water_clean", "amount": [ 0, 100 ] }, "Y": { "liquid": "water_clean", "amount": [ 100, 1000 ] } },
      "terrain": {
        ">": "t_ladder_down",
        "_": "t_thconc_floor",
        "#": "t_brick_wall",
        "+": "t_door_metal_c",
        "D": "t_chaingate_l",
        "%": "t_chainfence",
        "&": "t_flat_roof",
        "A": "t_flat_roof",
        ":": "t_flat_roof",
        "Y": "t_flat_roof",
        "X": "t_flat_roof",
        "=": "t_flat_roof"
      },
      "furniture": {
        "H": "f_generator_broken",
        "Y": "f_standing_tank",
        "6": "f_water_heater",
        "7": "f_roof_turbine_vent",
        "p": "f_machinery_old"
      },
      "items": { "C": { "item": "snacks", "chance": 30, "repeat": [ 6, 12 ] } }
    }
  }
]
