[
  {
    "method": "json",
    "type": "mapgen",
    "om_terrain": [
      [ "movietheater_0_0", "movietheater_1_0", "movietheater_2_0" ],
      [ "movietheater_0_1", "movietheater_1_1", "movietheater_2_1" ],
      [ "movietheater_0_2", "movietheater_1_2", "movietheater_2_2" ]
    ],
    "object": {
      "fill_ter": "t_thconc_floor",
      "rows": [
        "##########################%%^^%%%%%^^%%%%%^^%%##########################",
        "#TsTsTsTsTsTsTsTsTG....|........N......N........|.......-....|..TT|.XXX#",
        "#......................|........................|.......-....+...T|...X#",
        "#......................|||%%^^%%%%%^^%%%%%^^%%|||....##G-.-..|...T|...X#",
        "#+|+|+|+|+|+|+|+|+|+|..|...******************.vv|....##G-.-..T...T|X..X#",
        "#&|&|&|&|&|&|&|&|&|&|..|...*$$$$$$$$$$$$$$$$*...........-.-..Tc..T|X...#",
        "#||||||||||||||||||||..+...*$**************$*...@%@.....-.-..T...g|....#",
        "#&|&|&|&|&|&|&|&|&|&|..|...*$$$$********$$$$*...@%@.....-.-..T...g|...X#",
        "#+|+|+|+|+|+|+|.....||||...****$********$****...@%@.....-.-..T...r|t..X#",
        "#...................||||......*$*|T%T%|*$*......@%@.......-..T...r|t..X#",
        "#......................+......*$*d*e*e|*$*................-..|...o|....#",
        "#TsTsTsTsTsTsTsTTG.....|....#.*$*||||||*$*.#............RR-..|.........#",
        "#|||||||||||||||||||||||......*$********$*......@%@..........|.........#",
        "#vFvF|6.6.6...7.7..66..|......*$********$*......@%@.........N|gg..|....#",
        "#....|c.c.c...........G|....#.*$********$*.#....@%@..##G....N||||||{...#",
        "#.............................*$********$*......@%@..##G....N|vFTT|{...#",
        "#......c........c.............*$********$*...................|...T|{...#",
        "#...66666....6666...........#.*$********$*.#.................|...T||+||#",
        "#...66666....6666.............*$********$*......@%@..............T|..{{#",
        "#...c.c.......c.......G|......*$********$*......@%@..............T|....#",
        "#....................c6|......*$********$*......@%@..##G.........T|..ct#",
        "#7...................c6|......*$********$*......@%@..##G.........T|..ct#",
        "#....................c6|......*$********$*...................|...T||+||#",
        "#...7.7.7.7.7.7.7.7....|......*$********$*..NNN..............|...T|<.XX#",
        "#|||||||||||||||||||||||||||||*$********$*|||||||||||||||||||||||||||||#",
        "#......................C|..tt|*$********$*|tt..|C......................#",
        "D........C.C.C.C.H.C.C.C|..tt|b$********$b|tt..|C.C.C.H.C.C.C.C........D",
        "#........C.C.C.C.H.C.C.C|....|b$***##***$b|....|C.C.C.H.C.C.C.C..C.C...#",
        "#...C.C..C.C.C.C.H.C.C.C|....|b$***##***$b|...c|C.C.C.H.C.C.C.C..C.C...#",
        "#...C.C..C.C.C.C.H.C.C.C|t...|b$********$b|...t|C.C.C.H.C.C.C.C..C.C...#",
        "#...C.C..C.C.C.C.H.C.C.Cwt...|b$********$b|..ctwC.C.C.H.C.C.C.C..C.C...#",
        "#...C.C..C.C.C.C.H.C.C.CwZc..|b$********$b|...ZwC.C.C.H.C.C.C.C..C.C...#",
        "#...C.C..C.C.C.C.H.C.C.C|....|*$********$*|....|C.C.C.H.C.C.C.C..C.C...#",
        "#...C.C..C.C.C.C.H.C.C.C|...G|*$********$*|G...|C.C.C.H.C.C.C.C..C.C...#",
        "#...C.C..C.C.C.C.H.C.C.C|..|||*$********$*|||..|C.C.C.H.C.C.C.C..C.C...#",
        "#...C.C..C.C.C.C.H.C.C.C|..|a.*$********$*.F|..|C.C.C.H.C.C.C.C..C.C...#",
        "#...C.C..C.C.C.C.H.C.C.C|..|..*$********$*.y|..|C.C.C.H.C.C.C.C..C.C...#",
        "#...C.C..C.C.C.C.H.C.C.C|..|..*$********$*.v|..|C.C.C.H.C.C.C.C..C.C...#",
        "#...C.C..C.C.C.C.H.C.C.C|..|F.*$********$*.y|..|C.C.C.H.C.C.C.C..C.C...#",
        "#...C.C..C.C.C.C.H.C.C.C|..|y.*$***Ki***$*.F|..|C.C.C.H.C.C.C.C..C.C...#",
        "#...C.C..C.C.C.C.H.C.C.C|..|v.*$***iK***$*..|..|C.C.C.H.C.C.C.C..C.C...#",
        "#........C.C.C.C.H.C.C.C|l.|y.*$********$*..|.l|C.C.C.H.C.C.C.C........#",
        "#......................C|l.|F.*$********$*.a|.l|C......................#",
        "#.......----.-----||||||||d|||*$********$*|||d||||||||||----.-----.....#",
        "#.......................+******$********$******+.......................#",
        "#.......................|*$$$$$$********$$$$$$*|.......................#",
        "#.......................+******$********$******+.......................#",
        "#|||||||||||||||||||||||||||||*$********$*|||||||||||||||||||||||||||||#",
        "#|||||||||||||||||||||||||||||*$********$*|||||||||||||||||||||||||||||#",
        "#......................C|..tt|*$********$*|tt..|C......................#",
        "D........C.C.C.C.H.C.C.C|..tt|b$********$b|tt..|C.C.C.H.C.C.C.C........D",
        "#...C.C..C.C.C.C.H.C.C.C|....|b$***##***$b|....|C.C.C.H.C.C.C.C..C.C...#",
        "#...C.C..C.C.C.C.H.C.C.C|....|b$***##***$b|...c|C.C.C.H.C.C.C.C..C.C...#",
        "#...C.C..C.C.C.C.H.C.C.C|t...|b$********$b|...t|C.C.C.H.C.C.C.C..C.C...#",
        "#...C.C..C.C.C.C.H.C.C.Cwt...|b$********$b|..ctwC.C.C.H.C.C.C.C..C.C...#",
        "#...C.C..C.C.C.C.H.C.C.CwZc..|b$********$b|...ZwC.C.C.H.C.C.C.C..C.C...#",
        "#...C.C..C.C.C.C.H.C.C.C|....|*$********$*|....|C.C.C.H.C.C.C.C..C.C...#",
        "#...C.C..C.C.C.C.H.C.C.C|...G|*$********$*|G...|C.C.C.H.C.C.C.C..C.C...#",
        "#...C.C..C.C.C.C.H.C.C.C|..|||*$********$*|||..|C.C.C.H.C.C.C.C..C.C...#",
        "#...C.C..C.C.C.C.H.C.C.C|..|a.*$********$*.v|..|C.C.C.H.C.C.C.C..C.C...#",
        "#...C.C..C.C.C.C.H.C.C.C|..|..*$********$*.y|..|C.C.C.H.C.C.C.C..C.C...#",
        "#...C.C..C.C.C.C.H.C.C.C|..|..*$********$*.F|..|C.C.C.H.C.C.C.C..C.C...#",
        "#...C.C..C.C.C.C.H.C.C.C|..|v.*$********$*.y|..|C.C.C.H.C.C.C.C..C.C...#",
        "#...C.C..C.C.C.C.H.C.C.C|..|y.*$***Ki***$*.v|..|C.C.C.H.C.C.C.C..C.C...#",
        "#...C.C..C.C.C.C.H.C.C.C|..|F.*$***iK***$*..|..|C.C.C.H.C.C.C.C..C.C...#",
        "#........C.C.C.C.H.C.C.C|l.|y.*$********$*..|.l|C.C.C.H.C.C.C.C........#",
        "#......................C|l.|v.*$********$*.a|.l|C......................#",
        "#.......----.-----||||||||d|||*$********$*|||d||||||||||----.-----.....#",
        "#.......................+******$********$******+.......................#",
        "#.......................|*$$$$$$$$$$$$$$$$$$$$*|.......................#",
        "#.......................+**********************+.......................#",
        "########################################################################"
      ],
      "palettes": [ "movie_theater_palette.json" ],
      "terrain": { "C": "t_thconc_floor", "H": "t_thconc_floor", "y": "t_thconc_floor" },
      "toilets": { "&": {  } },
      "vendingmachines": { "v": { "item_group": "vending_drink", "lootable": true }, "F": { "item_group": "vending_food", "lootable": true } },
      "items": {
        "&": [ { "item": "alcohol", "chance": 10 }, { "item": "SUS_toilet", "chance": 50 } ],
        "T": { "item": "snacks", "chance": 5 },
        "X": { "item": "snacks", "chance": 30, "repeat": [ 6, 12 ] },
        "g": { "item": "fridgesnacks", "chance": 70, "repeat": [ 6, 12 ] },
        "G": { "item": "SUS_trash_trashcan_public", "chance": 20, "repeat": [ 2, 4 ] },
        "t": [
          { "item": "snacks", "chance": 3 },
          { "item": "consumer_electronics", "chance": 4 },
          { "item": "cubical_office", "chance": 10 },
          { "item": "office_breakroom", "chance": 5 }
        ],
        "#": [
          { "item": "jackets", "chance": 3 },
          { "item": "bags", "chance": 4 },
          { "item": "SUS_trash_floor_light", "chance": 8 },
          { "item": "hatstore_accessories", "chance": 5 }
        ],
        "H": [
          { "item": "jackets", "chance": 3 },
          { "item": "bags", "chance": 4 },
          { "item": "SUS_trash_floor_light", "chance": 10 },
          { "item": "hatstore_accessories", "chance": 5 }
        ],
        "{": [
          { "item": "jackets", "chance": 3 },
          { "item": "bags", "chance": 4 },
          { "item": "consumer_electronics", "chance": 5 },
          { "item": "hatstore_accessories", "chance": 5 },
          { "item": "manuals", "chance": 5 },
          { "item": "textbooks", "chance": 5 }
        ],
        "l": [
          { "item": "softdrugs", "chance": 10 },
          { "item": "bags", "chance": 20 },
          { "item": "consumer_electronics", "chance": 5 },
          { "item": "alcohol", "chance": 5 },
          { "item": "manuals", "chance": 5 },
          { "item": "textbooks", "chance": 5 }
        ]
      },
      "item": { "N": { "item": "movie_poster", "chance": 100 } },
      "place_items": [
        { "chance": 35, "item": "misc_smoking", "x": 5, "y": 7 },
        { "chance": 45, "item": "toy_store", "x": 21, "y": 22 },
        { "chance": 45, "item": "toy_store", "x": 8, "y": 14 },
        { "item": "cash_register_random", "x": 34, "y": 9, "chance": 100 },
        { "item": "cash_register_random", "x": 36, "y": 9, "chance": 100 },
        { "item": "cash_register_random", "x": 61, "y": [ 4, 9 ], "chance": 100 }
      ],
      "place_monsters": [
        { "density": 0.25, "monster": "GROUP_ZOMBIE", "x": 12, "y": 15 },
        { "density": 0.25, "monster": "GROUP_ZOMBIE", "x": 57, "y": 15 },
        { "density": 0.25, "monster": "GROUP_ZOMBIE", "x": 69, "y": 11 },
        { "density": 0.25, "monster": "GROUP_ZOMBIE", "x": 12, "y": 34 },
        { "density": 0.25, "monster": "GROUP_ZOMBIE", "x": 60, "y": 34 },
        { "density": 0.25, "monster": "GROUP_ZOMBIE", "x": 12, "y": 58 },
        { "density": 0.25, "monster": "GROUP_ZOMBIE", "x": 60, "y": 58 }
      ],
      "place_item": [
        { "item": "ketchup", "repeat": 1, "x": 65, "y": 16 },
        { "item": "ketchup", "repeat": 1, "x": 65, "y": 17 },
        { "item": "ketchup", "repeat": 1, "x": 65, "y": 18 },
        { "item": "mustard", "repeat": 1, "x": 65, "y": 20 },
        { "item": "mustard", "repeat": 1, "x": 65, "y": 21 },
        { "item": "mustard", "repeat": 1, "x": 65, "y": 22 },
        { "item": "vinegar", "repeat": 1, "x": 65, "y": 22 }
      ]
    }
  },
  {
    "method": "json",
    "type": "mapgen",
    "om_terrain": [
      [ "movietheater_roof_0_0", "movietheater_roof_1_0", "movietheater_roof_2_0" ],
      [ "movietheater_roof_0_1", "movietheater_roof_1_1", "movietheater_roof_2_1" ],
      [ "movietheater_roof_0_2", "movietheater_roof_1_2", "movietheater_roof_2_2" ]
    ],
    "object": {
      "fill_ter": "t_thconc_floor",
      "rows": [
        "------------------------------------------------------------------------",
        "-......................................................................-",
        "-......=............................................................:..-",
        "-......................................................................-",
        "-......&..&..&.............................................&...........-",
        "-.................................................................=....-",
        "-......................................................................-",
        "-......&..&..&.............................................&...........-",
        "-......................................................................-",
        "-....=............................................................=....-",
        "-..........................................................&...........-",
        "-......................................................................-",
        "-......................................................................-",
        "-......................................................................-",
        "-......................................................................-",
        "-...........................................%%%D%%%%%%%%%%%%%%%%%%%%%..-",
        "-...........................................%...........AAAAA.AAAAA.%..-",
        "-...........................................%...ЯЯ..................%..-",
        "-...........................................%...ЯЯ...################..-",
        "-...........................................%........#WWWW______#p_H#..-",
        "-...........................................%........+__________#___#..-",
        "-...........................................%........#WWWW______+__p#..-",
        "-...........................................%........#__________#####..-",
        "-...........................................%........#__________#__v#..-",
        "-...........................................D........#__________##+##..-",
        "-...........................................%........#______________#..-",
        "-...........................................%........+__________CCC_#..-",
        "-...........................................%........#__C______CCC_p#..-",
        "-...........................................%..X.....#_CCC______C__p#..-",
        "-...........................................%........#___C_______CCC#..-",
        "-...........................................%%%%%%%%%################..-",
        "-......................................................................-",
        "-......................................................................-",
        "-......................................................................-",
        "-......................................................................-",
        "-......................................................................-",
        "-......................................................................-",
        "-......................................................................-",
        "-......................................................................-",
        "-......................................................................-",
        "-......................................................................-",
        "-......................................................................-",
        "-......................................................................-",
        "-......................................................................-",
        "-......................................................................-",
        "-......................................................................-",
        "-......................................................................-",
        "-......................................................................-",
        "-......................................................................-",
        "-......................................................................-",
        "-......................................................................-",
        "-......................................................................-",
        "-......................................................................-",
        "-......................................................................-",
        "-......................................................................-",
        "-......................................................................-",
        "-......................................................................-",
        "-......................................................................-",
        "-......................................................................-",
        "-......................................................................-",
        "-......................................................................-",
        "-......................................................................-",
        "-......................................................................-",
        "-......................................................................-",
        "-......................................................................-",
        "-......:..................................................:............-",
        "5......................................................................5",
        "-......................................................................-",
        "-......................................................................-",
        "-......................................................................-",
        "-......................................................................-",
        "------------------------------------------------------------------------"
      ],
      "palettes": [ "roof_palette", "parametrized_walls_palette" ],
      "liquids": { "Я": { "liquid": "water_clean", "amount": [ 100, 1000 ] } },
      "terrain": {
        "_": "t_thconc_floor",
        "+": "t_door_metal_c",
        "D": "t_chaingate_l",
        "%": "t_chainfence",
        "&": "t_flat_roof",
        "A": "t_flat_roof",
        ":": "t_flat_roof",
        "Я": "t_flat_roof",
        "X": "t_flat_roof",
        "=": "t_flat_roof"
      },
      "furniture": {
        "H": [ [ "f_generator_broken", 25 ], [ "f_diesel_generator", 5 ], [ "f_12000_gasoline_generator", 5 ] ],
        "p": "f_machinery_old"
      },
      "items": { "C": { "item": "snacks", "chance": 30, "repeat": [ 6, 12 ] } }
    }
  },
  {
    "method": "json",
    "type": "mapgen",
    "om_terrain": [ [ "movietheater_2_2_0" ], [ "movietheater_2_2_1" ] ],
    "object": {
      "rows": [
        "                        ",
        "                        ",
        "                        ",
        "                        ",
        "                        ",
        "                        ",
        "                        ",
        "                        ",
        "                        ",
        "                        ",
        "                        ",
        "                        ",
        "                        ",
        "                        ",
        "                        ",
        "                        ",
        "                        ",
        "                        ",
        "     ----------------   ",
        "     -..............-   ",
        "     -..............-   ",
        "     -..............-   ",
        "     -..............-   ",
        "     -..............-   ",
        "     -..............-   ",
        "     -..............-   ",
        "     -..............-   ",
        "     -..............-   ",
        "     -..............-   ",
        "     -..............-   ",
        "     ----------------   ",
        "                        ",
        "                        ",
        "                        ",
        "                        ",
        "                        ",
        "                        ",
        "                        ",
        "                        ",
        "                        ",
        "                        ",
        "                        ",
        "                        ",
        "                        ",
        "                        ",
        "                        ",
        "                        ",
        "                        "
      ],
      "palettes": [ "roof_palette" ]
    }
  }
]
