[
  {
    "id": "record_patient",
    "type": "item_group",
    "items": [
      [ "record_patient", 100 ]
    ]
  },
  {
    "type": "mapgen",
    "method": "json",
    "om_terrain": [ "office_doctor" ],
    "weight": 1000,
    "object": {
      "fill_ter": "t_dirt",
      "rows": [
        "                        ",
        "   |---|----|--------|  ",
        "   |..C|.T.s|..eccScc|  ",
        "   |...+....+........D$ ",
        "   |--------|.......5|r ",
        "   |o.......|..|--X--|r ",
        "   |d.hd.h..+..|H...6|  ",
        "   |o.......|..|H...O|  ",
        "   |--------|..|H...O|  ",
        "   |I....ccS|..|HHllO|  ",
        "   |I..t....+..|-----|  ",
        "   |I.......|..|....I|  ",
        "   |--|-----|..|.t..I|  ",
        "   |T.|d.......+....I|  ",
        "   |s.|d.h..|..|Scc..|  ",
        "   |-+|-ccc-|++|-----|  ",
        "   |.................|  ",
        "   w....####....####.w  ",
        "   w.................w  ",
        "   |....####....####.|  ",
        "   |.................|  ",
        "   |-++--wwww-wwww---|  ",
        "     $$                 ",
        "     $$                 "
      ],
      "palettes": [
        "office_doctor"
      ],
      "items": {
        "C": { "item": "cleaning", "chance": 50 },
        "H": { "item": "harddrugs", "chance": 60 },
        "I": { "item": "dissection", "chance": 60 },
        "O": { "item": "softdrugs", "chance": 60 },
        "S": { "item": "gear_medical", "chance": 30 },
        "c": { "item": "gear_medical", "chance": 30 },
        "e": { "item": "fridge", "chance": 50 },
        "t": { "item": "gear_medical", "chance": 30 }
      },
      "place_items": [
        { "item": "record_patient", "x": 7, "y": 6, "chance": 50 }
      ],
      "computers": {
        "5": {
          "name": "Medical Supply Access", "options": [
            { "name": "Unlock Door", "action": "unlock" }
          ],"failures": [
            { "action": "shutdown" },
            { "action": "alarm" }
          ]
        },
        "6": {
          "name": "Medical Supply Access", "options": [
            { "name": "Lock Door", "action": "lock" },
            { "name": "Unlock Door", "action": "unlock" }
          ],"failures": [
            { "action": "shutdown" },
            { "action": "alarm" }
          ]
        }
      }
    }
  }
]
