[
  {
    "type": "mapgen",
    "method": "json",
    "om_terrain": [
      [ "office_tower_2_a1", "office_tower_2_a2", "office_tower_2_a3" ],
      [ "office_tower_2_b1", "office_tower_2_b2", "office_tower_2_b3" ]
    ],
    "object": {
      "fill_ter": "t_linoleum_white",
      "rows": [
        "ssssssssssssssssssssssssssssssssssssssssssssssssssssssssssssssssssssssss",
        "ss%%%%%%%%%%%%%%%%%%%%%%%%%%%%%%%%%%%%%%%%%%%%%%%ss____________________s",
        "s%%                                             %%s_s_ssssssssssssss_s_s",
        "s% ###VVV###VVV###VVV###VVV###VVV###VVV###VVV### %s___ssssssssssssss___s",
        "s% #....................................w^....^# %s_ssssssssssssssssss_s",
        "s% #....................................w...M..# %s_ssssssssssssssssss_s",
        "s% #....................................w..hnh.# %s_ssssssssssssssssss_s",
        "s% #....................................+..hnh.# %s_ssssssssssssssssss_s",
        "s% V....................................w..hnh.V %s_ssssssssssssssssss_s",
        "s% V....................................wf..M..V %s_ssssssssssssssssss_s",
        "s% #....................................wf.....# %s_ssssssssssssssssss_s",
        "s% #....................................######## %s_ssssssssssssssssss_s",
        "s% #....................................w^.AAAA# %s_ssssssssssssssssss_s",
        "s% V....................................w......V %s_ssssssssssssssssss_s",
        "s% V....................................w.Md...V %s_ssssssssssssssssss_s",
        "s% #....................................+..dM.a# %s_ssssssssssssssssss_s",
        "s% #....................................w.Md..f# %s_ssssssssssssssssss_s",
        "s% #....................................w..x..f# %s_ssssssssssssssssss_s",
        "s% #....................................w^....f#%%s___ssssssssssssss___s",
        "s% ####-###.............................########VVGGV_ssssssssssssss_s_s",
        "s%%%%#'''<#...............................#iiiiV^...G__________________s",
        "sssss-''RR#...............................-i..iV.ii.Gsssssssssssssssssss",
        "s%%%%#''''#...............................-i..iG.ii.V%%%%%%%%%%%%%%%%%ss",
        "s% ####-###################################i..iG...^V%               %%s",
        "s% #........................#A..x.^#.....f#i..iVGGVV##VVVVVVVVVVVVV## %s",
        "s% #........................#A..dh.#.hhh.f#i..iiiiiiiiiiiiiiiiiiiiii# %s",
        "s% #........................#A..dh.#hnnnh.#i......................^iV %s",
        "s% #........................#..Md..#hnnnh.#i...........???..??.....iV %s",
        "s% V........................#......#.hhh..#i...........?n...n?.....iV %s",
        "s% V........................#ff...Y#.....^#iiiiiiiiiii.........iii.i# %s",
        "s% #........................#wwww+w#w+wwww##--##xCCC#i...Y.....i#i.i# %s",
        "s% #...........................................#dh..Ci.......?.iii.i# %s",
        "s% #...........................................#d...Ci.?n...n?.....iV %s",
        "s% V...........................................#..h.Ci.???..??.....iV %s",
        "s% V...........................................#....#i............^iV %s",
        "s% #...........................................#ff...i.........iiiii# %s",
        "s% #......................................###########i.........i##### %s",
        "s% #......................................#T#T#T#SSS#i.........i#HEEV %s",
        "s% V......................................#+#+#+#...+i.........i-EEEV %s",
        "s% V......................................#........a#i.........i-EEEV %s",
        "s% #......................................###########i.........i##### %s",
        "s% #......................................#........a#i.........i-EEEV %s",
        "s% #......................................#+#+#+#...+i.........i-EEEV %s",
        "s% #......................................#T#T#T#SSS#iiii<<<iiii#HEEV %s",
        "s% ###VVV###VVV###VVV###VVV###VVV###VVV#-############################ %s",
        "s%%                                    %s%                           %%s",
        "ss%%%%%%%%%%%%%%%%%%%%%%%%%%%%%%%%%%%%%%s%%%%%%%%%%%%%%%%%%%%%%%%%%%%%ss",
        "ssssssssssssssssssssssssssssssssssssssssssssssssssssssssssssssssssssssss"
      ],
      "palettes": [ "office_palette" ],
      "terrain": { " ": "t_region_groundcover", "_": "t_sidewalk", "i": "t_linoleum_gray", ".": "t_linoleum_white" },
      "furniture": {  }
    }
  },
  {
    "type": "mapgen",
    "method": "json",
    "om_terrain": [
      [ "office_tower_2_a1_1", "office_tower_2_a2_1", "office_tower_2_a3_1" ],
      [ "office_tower_2_b1_1", "office_tower_2_b2_1", "office_tower_2_b3_1" ]
    ],
    "object": {
      "fill_ter": "t_linoleum_white",
      "rows": [
        "                                                                        ",
        "                                                                        ",
        "                                                                        ",
        "   ###VVV###VVV###VVV###VVV###VVV###VVV###VVV###                        ",
        "   #....................................wfff..^#                        ",
        "   #....................................w......#                        ",
        "   #....................................w....M.#                        ",
        "   #....................................+..xddd#                        ",
        "   V....................................wY..h.hV                        ",
        "   V....................................w......V                        ",
        "   #....................................w^.AAAA#                        ",
        "   #....................................########                        ",
        "   #....................................wf..^..#                        ",
        "   V....................................wf...h.V                        ",
        "   V....................................w..xdddV                        ",
        "   #....................................+..****#                        ",
        "   #....................................w..xddd#                        ",
        "   #....................................wf..h..#                        ",
        "   #....................................wf....a#                        ",
        "   ####-###.............................########_____                   ",
        "    _#'''>#...............................#iiiiV_____                   ",
        "    _#''RR#...............................-i..iV_____                   ",
        "    _#'''<#...............................-i..iV_____                   ",
        "   ####-###################################i..iV_____                   ",
        "   #........................#.^..ff#A.fff^#i..i##VVVVVVVVVVVVVVVVVV##   ",
        "   #........................#..h...#A.....#i..iR////////////////////#   ",
        "   #........................#..nnh.#A...M.#i..iR////////////////////V   ",
        "   #........................#.hnn..#..xddd#i..iR////////////////////V   ",
        "   #........................#...h.?#...MM.#i..iR////////////////////V   ",
        "   #........................#ff...?#^....a#i..iR////////////////////#   ",
        "   #........................#wwww+w#w+wwww#i..iRRRRRRRRRRRRRRRRRR///#   ",
        "   #......................................#i..iiiiiiiiiiiiiiiiiiR///#   ",
        "   V......................................#i....^MMM...........<R///V   ",
        "   V......................................-i...................<R///V   ",
        "   V......................................-i..............^....<R///V   ",
        "   #......................................#iiiiiiiiiii....C....iR///#   ",
        "   #......................................###########i...?C?...i#####   ",
        "   #......................................#T#T#T#SSS#i...?C?...i#HEEV   ",
        "   #......................................#+#+#+#...+i...?C?...i-EEEV   ",
        "   #......................................#........a#i....C....i-EEEV   ",
        "   #......................................###########i....^....i#####   ",
        "   #......................................#........a#i.........i-EEEV   ",
        "   #......................................#+#+#+#...+i.........i-EEEV   ",
        "   #......................................#T#T#T#SSS#iiii>>>iiii#HEEV   ",
        "   ###VVV###VVV###VVV###VVV###VVV###VVV##############################   ",
        "                                                                        ",
        "                                                                        ",
        "                                                                        "
      ],
      "palettes": [ "office_palette" ],
      "terrain": { " ": "t_open_air", "/": "t_open_air_rooved", "_": "t_glass_roof", "i": "t_linoleum_gray", ".": "t_linoleum_white" },
      "furniture": {  }
    }
  },
  {
    "type": "mapgen",
    "method": "json",
    "om_terrain": [
      [ "office_tower_2_a1_2", "office_tower_2_a2_2", "null" ],
      [ "office_tower_2_b1_2", "office_tower_2_b2_2", "office_tower_2_b3_2" ]
    ],
    "object": {
      "fill_ter": "t_linoleum_white",
      "rows": [
        "                                                                        ",
        "                                                                        ",
        "                                                                        ",
        "   ###VVV###VVV###VVV###VVV###VVV###VVV###VVV###                        ",
        "   #....................................w^....f#                        ",
        "   #....................................w..hh.f#                        ",
        "   #....................................w.hnnh.#                        ",
        "   #....................................+.hnnh.#                        ",
        "   V....................................w.hnnh.V                        ",
        "   V....................................w..hh..V                        ",
        "   #....................................w^....f#                        ",
        "   #....................................########                        ",
        "   #....................................whh.d..#                        ",
        "   V....................................w...dM.V                        ",
        "   V....................................wY..d..V                        ",
        "   #....................................+...x.f#                        ",
        "   #....................................w.....A#                        ",
        "   #....................................w.MnM.A#                        ",
        "   #....................................w^....A#                        ",
        "   ####-###.............................########                        ",
        "     #'''<#...............................#iiiiV                        ",
        "     #''RR#...............................-i.^iV                        ",
        "     #'''>#...............................-i..iV                        ",
        "   ####-###################################i..iV                        ",
        "   #........................#AAAfff#f.ff.f#i..i##VVVVVVVVVVVVVVVVVV##   ",
        "   #........................#......#f.ff.f#i..iR////////////////////#   ",
        "   #........................#?...M.#f.ff.f#i..iR////////////////////V   ",
        "   #........................#?.xddd#f.ff.f#i..iR////////////////////V   ",
        "   V........................#?..hh.#f.ff.f#i..iR////////////////////V   ",
        "   V........................#^....Y#f....f#i..iR////////////////////#   ",
        "   #........................#wwww+w#w+wwww#i..iRRRRRRRRRRRRRRRRRR///#   ",
        "   #......................................#i..iiiiiiiiiiiiiiiiiiR///#   ",
        "   #......................................#i...................>R///V   ",
        "   V......................................-i...................>R///V   ",
        "   V......................................-i...................>R///V   ",
        "   #......................................#iiiiiiiiiii.........iR///#   ",
        "   #......................................###########i.........i#####   ",
        "   #......................................#T#T#T#SSS#i.........i#HEEV   ",
        "   V......................................#+#+#+#...+i.........i-EEEV   ",
        "   V......................................#........a#i...MnM...i-EEEV   ",
        "   #......................................###########i.........i#####   ",
        "   #......................................#........a#i.........i-EEEV   ",
        "   #......................................#+#+#+#...+i..??^??..i-EEEV   ",
        "   #......................................#T#T#T#SSS#iiiiiiiiiii#HEEV   ",
        "   ###VVV###VVV###VVV###VVV###VVV###VVV##############################   ",
        "                                                                        ",
        "                                                                        ",
        "                                                                        "
      ],
      "palettes": [ "office_palette" ],
      "terrain": { " ": "t_open_air", "/": "t_open_air_rooved", "i": "t_linoleum_gray", ".": "t_linoleum_white" },
      "furniture": {  }
    }
  },
  {
    "type": "mapgen",
    "method": "json",
    "om_terrain": [
      [ "office_tower_2_a1_roof", "office_tower_2_a2_roof", "null" ],
      [ "office_tower_2_b1_roof", "office_tower_2_b2_roof", "office_tower_2_b3_roof" ]
    ],
    "object": {
      "fill_ter": "t_flat_roof",
      "rows": [
        "                                                                        ",
        "                                                                        ",
        "                                                                        ",
        "   5-------------------------------------------5                        ",
        "   -...........................................-                        ",
        "   -...........................................-                        ",
        "   -..:.....................................:..-                        ",
        "   -...........................................-                        ",
        "   -...........................................-                        ",
        "   -...........................................-                        ",
        "   -...........................................-                        ",
        "   -...........................................-                        ",
        "   -..................A..A..A..&...............-                        ",
        "   -...........................................-                        ",
        "   -...........................................-                        ",
        "   -..................A..A..A..................-                        ",
        "   -...........................................-                        ",
        "   -...........................................-                        ",
        "   -...........................................-                        ",
        "   5--..###....................................-                        ",
        "     -..#>#....................................-                        ",
        "     -..###....................................-                        ",
        "     -.........................................-                        ",
        "   5--.........................................-                        ",
        "   -...........................................---------------------5   ",
        "   -................................................................-   ",
        "   -..................A..A..A...................oooo.oooo.oooo.oooo.-   ",
        "   -............................................oooo.oooo.oooo.oooo.-   ",
        "   -............................................oooo.oooo.oooo.oooo.-   ",
        "   -..................A..A..A..&................oooo.oooo.oooo.oooo.-   ",
        "   -................................................................-   ",
        "   -............................................oooo.oooo.oooo.oooo.-   ",
        "   -............................................oooo.oooo.oooo.oooo.-   ",
        "   -............................................oooo.oooo.oooo.oooo.-   ",
        "   -............................................oooo.oooo.oooo.oooo.-   ",
        "   -................................................................-   ",
        "   -................................................................-   ",
        "   -................................................................-   ",
        "   -................................................................-   ",
        "   -..........................................=.....................-   ",
        "   -................................................................-   ",
        "   -..:..X..........................................................-   ",
        "   -................................................................-   ",
        "   -................................................................-   ",
        "   5----------------------------------------------------------------5   ",
        "                                                                        ",
        "                                                                        ",
        "                                                                        "
      ],
      "palettes": [ "roof_palette" ],
      "terrain": { ">": "t_stairs_down" },
      "furniture": {  }
    }
  },
  {
    "type": "mapgen",
    "method": "json",
    "om_terrain": [ "office_tower_2_a1_tower_lab" ],
    "object": {
      "rows": [
        "ssssssssssssssssssssssss",
        "ss%%%%%%%%%%%%%%%%%%%%%%",
        "s%%                     ",
        "s% ###VVV###VVV###VVV###",
        "s% #....................",
        "s% #....................",
        "s% #....................",
        "s% #....................",
        "s% V....................",
        "s% V....................",
        "s% #....................",
        "s% #....................",
        "s% #....................",
        "s% V....................",
        "s% V....................",
        "s% #....................",
        "s% #....................",
        "s% #....................",
        "s% #....................",
        "s% ####--##.............",
        "s%   #''''#.............",
        "s%   #''''#.............",
        "s%   #@<<@#.............",
        "s% #####################"
      ],
      "palettes": [ "office_palette" ],
      "terrain": { " ": "t_region_groundcover", ".": "t_linoleum_white", "@": "t_thconc_floor" },
      "place_monster": [ { "monster": "mon_zombie_scientist", "x": [ 7, 21 ], "y": [ 4, 10 ], "repeat": [ 1, 3 ] } ],
      "monster": { "@": { "monster": "mon_turret_riot" } }
    }
  },
  {
    "//": "Because north and west walls are part of the adjacent tile, the corner-most square in an L-shaped inner corner can be missing.",
    "//2": "This map adds it back in, to prevent an open air-gap where players can fall into sky.",
    "type": "mapgen",
    "method": "json",
    "om_terrain": [ "office_tower_open_air_corner" ],
    "weight": 100,
    "object": { "fill_ter": "t_open_air", "place_terrain": [ { "ter": "t_concrete_wall", "x": 0, "y": 23 } ] }
  }
]
