[
  {
    "type": "mapgen",
    "method": "json",
    "om_terrain": [ "outcrop" ],
    "//": "Above ground",
    "weight": 100,
    "object": {
      "rows": [
        "       S     S         S",
        "   S       S     S      ",
        " S     S            S   ",
        "          S             ",
        "   S    S SSSSS      S  ",
        "      SSSSSSSSSSSS      ",
        "     SS$$$$$$$$$$SS     ",
        "     S$$TTTTTTTT$$S   S ",
        "    SS$$T))))))T$$S     ",
        " S  SS$$T)####)T$$SS    ",
        "    SS$$T)####)T$$SS    ",
        "    SS$$T)####)T$$SS    ",
        "    SS$$T)####)T$$SS   S",
        "  S  S$$T))T)))T$$SS    ",
        "     S$$TTTTTTTT$$S     ",
        "     SS$$$$$$$$$$SS  S  ",
        "      SSSSSSSSSSSS      ",
        "S      S S   SS S       ",
        "                 S    S ",
        "   S   S                ",
        "            S  S        ",
        "                       S",
        "    S      S            ",
        "                  S     "
      ],
      "palettes": [ "bunker_ext" ]
    }
  },
  {
    "type": "mapgen",
    "method": "json",
    "om_terrain": [ "outcrop_roof" ],
    "//": "Above ground",
    "weight": 100,
    "object": {
      "fill_ter": "t_region_groundcover_barren",
      "rows": [
        "vvvvvvvvvvvvvvvvvvvvvvvv",
        "vvvvvvvvvvvvvvvvvvvvvvvv",
        "vvvvvvvvvvvvvvvvvvvvvvvv",
        "vvvvvvvvvvvvvvvvvvvvvvvv",
        "vvvvvvvvvvvvvvvvvvvvvvvv",
        "vvvvvvvvvvvvvvvvvvvvvvvv",
        "vvvvvvvvvvvvvvvvvvvvvvvv",
        "vvvvvvvvvvvvvvvvvvvvvvvv",
        "vvvvvvvvv((((((vvvvvvvvv",
        "vvvvvvvvv(◈◈◈◈(vvvvvvvvv",
        "vvvvvvvvv(◈◈◈◈(vvvvvvvvv",
        "vvvvvvvvv(◈◈◈◈(vvvvvvvvv",
        "vvvvvvvvv(◈◈◈◈(vvvvvvvvv",
        "vvvvvvvvv((v(((vvvvvvvvv",
        "vvvvvvvvvvvvvvvvvvvvvvvv",
        "vvvvvvvvvvvvvvvvvvvvvvvv",
        "vvvvvvvvvvvvvvvvvvvvvvvv",
        "vvvvvvvvvvvvvvvvvvvvvvvv",
        "vvvvvvvvvvvvvvvvvvvvvvvv",
        "vvvvvvvvvvvvvvvvvvvvvvvv",
        "vvvvvvvvvvvvvvvvvvvvvvvv",
        "vvvvvvvvvvvvvvvvvvvvvvvv",
        "vvvvvvvvvvvvvvvvvvvvvvvv",
        "vvvvvvvvvvvvvvvvvvvvvvvv"
      ],
      "palettes": [ "bunker_ext" ],
      "terrain": { "◈": "t_rock_floor_no_roof" }
    }
  }
]
