[
  {
    "type": "palette",
    "id": "parking_palette",
    "terrain": {
      " ": "t_thconc_floor",
      "-": "t_thconc_y",
      "=": "t_concrete_railing",
      "z": "t_tar_flat_roof",
      "'": "t_strconc_floor",
      "x": "t_strconc_floor",
      "+": "t_door_c",
      "!": "t_door_metal_locked",
      ".": "t_region_groundcover_urban",
      "w": "t_window",
      "W": "t_reinforced_glass",
      "_": "t_pavement",
      "y": "t_pavement_y",
      "s": "t_concrete",
      "|": "t_concrete_wall",
      ":": "t_linoleum_white",
      ";": "t_grate",
      "/": "t_ladder_up_down",
      "F": "t_linoleum_white",
      "d": "t_linoleum_white",
      "h": "t_linoleum_white",
      "c": "t_linoleum_white",
      ">": "t_stairs_down",
      "<": "t_stairs_up",
      "f": "t_chainfence",
      "g": "t_chaingate_l",
      "#": "t_soil",
      "*": "t_open_air",
      "E": "t_elevator"
    },
    "furniture": { "x": "f_console_broken", "c": "f_counter", "d": "f_desk", "h": "f_chair", "F": "f_filing_cabinet" },
    "items": { "d": { "item": "SUS_office_desk", "chance": 33 }, "F": { "item": "SUS_office_filing_cabinet", "chance": 33 } },
    "vehicles": {
      "N": { "vehicle": "parking_garage", "chance": 25, "rotation": 270 },
      "S": { "vehicle": "parking_garage", "chance": 25, "rotation": 90 }
    }
  },
  {
    "type": "mapgen",
    "method": "json",
    "om_terrain": [ [ "parking_garage_down_0", "parking_garage_down_1" ] ],
    "weight": 250,
    "object": {
      "fill_ter": "t_thconc_floor",
      "rows": [
        "|||||||||||||||||||||||||||||||||||||||||||||###",
        "|EEEEEEE!       ''''''''''''''''''''''''''''|###",
        "|EEEEEEE!       ''''''''''''''''''''''''''''|###",
        "|EEEEEEE!       -    -    -    -    -    -''|###",
        "|EEEEEEE!       - N  -    -  N -  N -  N -''|###",
        "|EEEEEEE!       -    -    -    -    -    -''|###",
        "|EEEEEEE!       -    -    -    -    -    -''|###",
        "||||||x||x'     -    -    -    -    -    -''|###",
        "#|'<'|||'''                               ''|###",
        "#|'''''''''                               ''|###",
        "#|'''''''''                               ''|###",
        "#|'''''''''                               ''|###",
        "#|'''''''''                               ''|###",
        "#|'''''''''                               ''|###",
        "#|'''|||'''                               ''|###",
        "||||||x||x'     -    -    -    -    -    -''|###",
        "|EEEEEEE!       -    -    -    -    -    -''|###",
        "|EEEEEEE!       -    -    -    -    -    -''|###",
        "|EEEEEEE!       -  S -    -  S -  S -  S -''|###",
        "|EEEEEEE!       -    -    -    -    -    -''|###",
        "|EEEEEEE!       ''''''''''''''''''''''''''''|###",
        "|EEEEEEE!       ''''''''''''''''''''''''''''|###",
        "|||||||||||||||||||||||||||||||||||||||||||||###",
        "################################################"
      ],
      "palettes": [ "parking_palette" ],
      "place_monster": [ { "group": "GROUP_ZOMBIE", "x": [ 3, 17 ], "y": [ 13, 15 ], "chance": 20, "repeat": [ 1, 3 ] } ]
    }
  },
  {
    "type": "mapgen",
    "method": "json",
    "om_terrain": [ [ "parking_garage_0_0", "parking_garage_0_1" ] ],
    "weight": 250,
    "object": {
      "fill_ter": "t_thconc_floor",
      "rows": [
        "|||||||||       |====|====|====|====|       |ww|",
        "|EEEEEEE!       '''''''''''''''''''''       c:d|",
        "WEEEEEEE!       '''''''''''''''''''''       chdw",
        "WEEEEEEE!       -    -    -    -    -       |:Fw",
        "WEEEEEEE!       - N  -    -  N -  N -       +:F|",
        "WEEEEEEE!       -    -    -    -    -       |ww|",
        "|EEEEEEE!       -    -    -    -    -       |...",
        "||||||x||x'     -    -    -    -    -       |...",
        ".|'>'|||'''                                 |...",
        ".='''''''''                                 |...",
        ".='''''''''                                 |...",
        ".='''''''''                                 |...",
        ".='''''''''                                 |...",
        ".='''''''''                                 |...",
        ".|'<'|||'''                                 |...",
        "||||||x||x'     -    -    -    -    -    - -=...",
        "|EEEEEEE!       -    -    -    -    -    -- =...",
        "WEEEEEEE!       -    -    -    -    -    - -=...",
        "WEEEEEEE!       -  S -    -  S -  S -  S -- =...",
        "WEEEEEEE!       -    -    -    -    -    - -=...",
        "WEEEEEEE!       ''''''''''''''''''''''''''''|...",
        "|EEEEEEE!       ''''''''''''''''''''''''''''|...",
        "||||||||||||====|====|====|====|====|====||||...",
        "................................................"
      ],
      "palettes": [ "parking_palette" ],
      "place_monster": [ { "group": "GROUP_ZOMBIE", "x": [ 3, 17 ], "y": [ 13, 15 ], "chance": 20, "repeat": [ 1, 3 ] } ],
      "place_loot": [ { "group": "cash_register_random", "x": 44, "y": [ 1, 2 ] } ]
    }
  },
  {
    "type": "mapgen",
    "method": "json",
    "om_terrain": [ [ "parking_garage_1_0", "parking_garage_1_1" ] ],
    "weight": 250,
    "object": {
      "fill_ter": "t_thconc_floor",
      "rows": [
        "||||||||||||====|====|====|====|====|====||||zzz",
        "|EEEEEEE!       ''''''''''''''''''''''''''''|zzz",
        "WEEEEEEE!       ''''''''''''''''''''''''''''|zzz",
        "WEEEEEEE!       -    -    -    -    -    -''=/zz",
        "WEEEEEEE!       - N  -    -  N -  N -  N -''=zzz",
        "WEEEEEEE!       -    -    -    -    -    -''=zzz",
        "|EEEEEEE!       -    -    -    -    -    -''=***",
        "||||||x||x'     -    -    -    -    -    -''=***",
        "*|'<'|||'''                               ''|***",
        "*='''''''''                               ''|***",
        "*='''''''''                               ''|***",
        "*='''''''''                               ''|***",
        "*='''''''''                               ''|***",
        "*='''''''''                               ''|***",
        "*|'>'|||'''                               ''|***",
        "||||||x||x'     -    -    -    -    -    -''=***",
        "|EEEEEEE!       -    -    -    -    -    -''=***",
        "WEEEEEEE!       -    -    -    -    -    -''=***",
        "WEEEEEEE!       -  S -    -  S -  S -  S -''=***",
        "WEEEEEEE!       -    -    -    -    -    -''=***",
        "WEEEEEEE!       ''''''''''''''''''''''''''''|***",
        "|EEEEEEE!       ''''''''''''''''''''''''''''|***",
        "||||||||||||====|====|====|====|====|====||||***",
        "************************************************"
      ],
      "palettes": [ "parking_palette" ],
      "terrain": { "/": "t_ladder_up" },
      "place_monster": [ { "group": "GROUP_ZOMBIE", "x": [ 3, 17 ], "y": [ 13, 15 ], "chance": 20, "repeat": [ 1, 3 ] } ]
    }
  },
  {
    "type": "mapgen",
    "method": "json",
    "om_terrain": [ [ "parking_garage_2_0", "parking_garage_2_1" ] ],
    "weight": 250,
    "object": {
      "fill_ter": "t_thconc_floor",
      "rows": [
        "||||||||||||====|====|====|====|====|====||||***",
        "|EEEEEEE!       ''''''''''''''''''''''''''''|***",
        "WEEEEEEE!       ''''''''''''''''''''''''''''|;;*",
        "WEEEEEEE!       -    -    -    -    -    -''=/;*",
        "WEEEEEEE!       - N  -    -  N -  N -  N -''=;;*",
        "WEEEEEEE!       -    -    -    -    -    -''=***",
        "|EEEEEEE!       -    -    -    -    -    -''=***",
        "||||||x||x'     -    -    -    -    -    -''=***",
        "*|'>'|||'''                               ''|***",
        "*='''''''''                               ''|***",
        "*='''''''''                               ''|***",
        "*='''''''''                               ''|***",
        "*='''''''''                               ''|***",
        "*='''''''''                               ''|***",
        "*|'<'|||'''                               ''|***",
        "||||||x||x'     -    -    -    -    -    -''=***",
        "|EEEEEEE!       -    -    -    -    -    -''=***",
        "WEEEEEEE!       -    -    -    -    -    -''=***",
        "WEEEEEEE!       -  S -    -  S -  S -  S -''=***",
        "WEEEEEEE!       -    -    -    -    -    -''=***",
        "WEEEEEEE!       ''''''''''''''''''''''''''''|***",
        "|EEEEEEE!       ''''''''''''''''''''''''''''|***",
        "||||||||||||====|====|====|====|====|====||||***",
        "************************************************"
      ],
      "palettes": [ "parking_palette" ],
      "place_monster": [ { "group": "GROUP_ZOMBIE", "x": [ 3, 17 ], "y": [ 13, 15 ], "chance": 20, "repeat": [ 1, 3 ] } ]
    }
  },
  {
    "type": "mapgen",
    "method": "json",
    "om_terrain": [ [ "parking_garage_roof_0", "parking_garage_roof_1" ] ],
    "weight": 250,
    "object": {
      "fill_ter": "t_pavement",
      "rows": [
        "|||||||||====================================***",
        "|EEEEEEE!_______ssssssssssssssssssssssssssssf***",
        "WEEEEEEE!_______ssssssssssssssssssssssssssssf;;*",
        "WEEEEEEE!_______y____y____y____y____y____yssg/;*",
        "WEEEEEEE!_______y_N__y____y__N_y__N_y__N_yssf;;*",
        "WEEEEEEE!_______y____y____y____y____y____yssf***",
        "|EEEEEEE!_______y____y____y____y____y____yss=***",
        "||||||x||x'_____y____y____y____y____y____yss=***",
        "*|'''|||'''_______________________________ss=***",
        "*='''''''''_______________________________ss=***",
        "*='''''''''_______________________________ss=***",
        "*='''''''''_______________________________ss=***",
        "*='''''''''_______________________________ss=***",
        "*='''''''''_______________________________ss=***",
        "*|'>'|||'''_______________________________ss=***",
        "||||||x||x'_____y____y____y____y____y____yss=***",
        "|EEEEEEE!_______y____y____y____y____y____yss=***",
        "WEEEEEEE!_______y____y____y____y____y____yss=***",
        "WEEEEEEE!_______y__S_y____y__S_y__S_y__S_yss=***",
        "WEEEEEEE!_______y____y____y____y____y____yss=***",
        "WEEEEEEE!_______ssssssssssssssssssssssssssss=***",
        "|EEEEEEE!_______ssssssssssssssssssssssssssss=***",
        "|||||||||====================================***",
        "************************************************"
      ],
      "palettes": [ "parking_palette" ],
      "terrain": { "/": "t_ladder_down" },
      "place_monster": [ { "group": "GROUP_ZOMBIE", "x": [ 3, 17 ], "y": [ 13, 15 ], "chance": 20, "repeat": [ 1, 3 ] } ]
    }
  },
  {
    "type": "mapgen",
    "method": "json",
    "om_terrain": [ "parking_garage_roof_top" ],
    "object": {
      "fill_ter": "t_tar_flat_roof",
      "rows": [
        "5-------5               ",
        "-.......-               ",
        "-.......-               ",
        "-..ooo..-               ",
        "-..ooo..-               ",
        "-.......-               ",
        "-.......-               ",
        "--.........             ",
        " -.MM.MM...             ",
        " -.MM.MM...             ",
        " -.........             ",
        " -.........             ",
        " -.........             ",
        " -.MM.MM...             ",
        " -.MM.MM...             ",
        "--.........             ",
        "-.......-               ",
        "-.......-               ",
        "-..ooo..-               ",
        "-..ooo..-               ",
        "-.......-               ",
        "-.......-               ",
        "5-------5               ",
        "                        "
      ],
      "palettes": [ "roof_palette" ]
    }
  }
]
