[
  {
    "type": "mapgen",
    "method": "json",
    "om_terrain": [ [ "parking_2x1_0", "parking_2x1_1" ] ],
    "weight": 250,
    "object": {
      "fill_ter": "t_floor",
      "rows": [
        "................................................",
        "....____-____-____-____-____-____-____-____-....",
        "...-____-____-____-____-____-____-____-____-_...",
        ".._-____-____-____-____-____-____-____-____-__..",
        ".__-____-____-____-____-____-____-____-____-___.",
        ".__-____-____-____-____-____-____-____-____-___.",
        ".__-____-____-____-____-____-____-____-____-___.",
        ".______________________________________________.",
        ".______________________________________________.",
        ".______________________________________________.",
        ".______________________________________________.",
        ".______________________________________________.",
        ".______________________________________________.",
        ".______________________________________________.",
        ".______________________________________________.",
        ".______________________________________________.",
        ".______________________________________________.",
        ".__-___-____-____-____-____-___________________.",
        ".__-___-____-____-____-____-___________________.",
        ".__-___-____-____-____-____-___________________.",
        ".._-___-____-____-____-____-__________________..",
        "...-___-____-____-____-____-_________________...",
        "....___-____-____-____-____-________________....",
        "............................_______--_______...."
      ],
      "terrain": { ".": [ [ "t_grass", 6 ], [ "t_dirt", 5 ] ], "_": "t_pavement", "-": "t_pavement_y" }
    }
  },
  {
    "type": "mapgen",
    "method": "json",
    "om_terrain": [ [ "parking_3x1_0", "parking_3x1_1", "parking_3x1_2" ] ],
    "weight": 250,
    "object": {
      "fill_ter": "t_floor",
      "rows": [
        "........................................................................",
        "....___-____-____-____-____-____-____-____-____-____-____-____-____-....",
        "...____-____-____-____-____-____-____-____-____-____-____-____-____-_...",
        ".._____-____-____-____-____-____-____-____-____-____-____-____-____-__..",
        ".______-____-____-____-____-____-____-____-____-____-____-____-____-___.",
        ".______-____-____-____-____-____-____-____-____-____-____-____-____-___.",
        ".______-____-____-____-____-____-____-____-____-____-____-____-____-___.",
        ".______________________________________________________________________.",
        ".______________________________________________________________________.",
        ".______________________________________________________________________.",
        ".______________________________________________________________________.",
        ".______________________________________________________________________.",
        ".______________________________________________________________________.",
        ".______________________________________________________________________.",
        ".______________________________________________________________________.",
        ".______________________________________________________________________.",
        ".______________________________________________________________________.",
        "._____-____-____-____-____-____-____-____-____-____-___________________.",
        "._____-____-____-____-____-____-____-____-____-____-___________________.",
        "._____-____-____-____-____-____-____-____-____-____-___________________.",
        "..____-____-____-____-____-____-____-____-____-____-__________________..",
        "...___-____-____-____-____-____-____-____-____-____-_________________...",
        "....__-____-____-____-____-____-____-____-____-____-________________....",
        "...................................................._______--_______...."
      ],
      "terrain": { ".": [ [ "t_grass", 6 ], [ "t_dirt", 5 ] ], "_": "t_pavement", "-": "t_pavement_y" }
    }
  },
  {
    "type": "mapgen",
    "method": "json",
    "om_terrain": [ [ "parking_2x2_0_0", "parking_2x2_1_0" ], [ "parking_2x2_0_1", "parking_2x2_1_1" ] ],
    "weight": 250,
    "object": {
      "fill_ter": "t_floor",
      "rows": [
        "................................................",
        "....__-____-____-____-____-_________________....",
        "...___-____-____-____-____-__________________...",
        "..____-____-____-____-____-___________________..",
        "._____-____-____-____-____-____________________.",
        "._____-____-____-____-____-____________________.",
        "._____-____-____-____-____-____________________.",
        ".______________________________________________.",
        ".______________________________________________.",
        ".______________________________________________.",
        ".______________________________________________.",
        ".______________________________________________.",
        ".______________________________________________.",
        ".______________________________________________.",
        ".______________________________________________.",
        ".______________________________________________.",
        ".______________________________________________.",
        "._____-____-____-____-____-____________________.",
        "._____-____-____-____-____-____________________.",
        "._____-____-____-____-____-____________________.",
        "._____-____-____-____-____-____________________.",
        "._____-____-____-____-____-____________________.",
        "._____-____-____-____-____-____________________.",
        ".,,,,,,,,,,,,,,,,,,,,,,,,,,____________________.",
        "..........................,____________________.",
        ".,,,,,,,,,,,,,,,,,,,,,,,,,,____________________.",
        "._____-____-____-____-____-____________________.",
        "._____-____-____-____-____-____________________.",
        "._____-____-____-____-____-____________________.",
        "._____-____-____-____-____-____________________.",
        "._____-____-____-____-____-____________________.",
        "._____-____-____-____-____-____________________.",
        ".______________________________________________.",
        ".______________________________________________.",
        ".______________________________________________.",
        ".______________________________________________.",
        ".______________________________________________.",
        ".______________________________________________.",
        ".______________________________________________.",
        ".______________________________________________.",
        ".______________________________________________.",
        ".______________________________________________.",
        "._____-____-____-____-____-____________________.",
        "._____-____-____-____-____-____________________.",
        "._____-____-____-____-____-____________________.",
        "..____-____-____-____-____-___________________..",
        "...___-____-____-____-____-__________________...",
        "....__-____-____-____-____-_________________....",
        "..........................._______--_______....."
      ],
      "terrain": { ".": [ [ "t_grass", 6 ], [ "t_dirt", 5 ] ], "_": "t_pavement", "-": "t_pavement_y", ",": "t_concrete" }
    }
  }
]
