[
  {
    "type": "palette",
    "id": "parking_garage2x2_palette",
    "terrain": {
      " ": "t_thconc_floor",
      "-": "t_thconc_y",
      "=": "t_concrete_railing",
      "1": "t_gutter_west",
      "2": "t_gutter_east",
      "3": "t_gutter_north",
      "4": "t_gutter_south",
      "5": "t_gutter_drop",
      "'": "t_strconc_floor",
      "+": "t_door_c",
      "!": "t_door_metal_locked",
      ".": "t_region_groundcover_urban",
      "w": "t_window",
      "W": "t_reinforced_glass",
      "_": "t_pavement",
      "y": "t_pavement_y",
      "z": "t_zebra",
      "s": "t_concrete",
      "|": "t_concrete_wall",
      ":": "t_linoleum_white",
      ";": "t_grate",
      "i": "t_stairs_up",
      "j": "t_stairs_down",
      "/": "t_ladder_up_down",
      "F": "t_linoleum_white",
      "d": "t_linoleum_white",
      "h": "t_linoleum_white",
      "D": "t_strconc_floor",
      "c": "t_linoleum_white",
      "r": "t_linoleum_white",
      ">": "t_ramp_down_high",
      "O": "t_ramp_down_low",
      "<": "t_ramp_up_low",
      "o": "t_ramp_up_high",
      "I": "t_column",
      "f": "t_chainfence",
      "g": "t_chaingate_l",
      "#": "t_soil",
      "*": "t_open_air",
      "E": "t_elevator",
      "e": "t_elevator_control"
    },
    "furniture": {
      "x": "f_console_broken",
      "@": "f_generator_broken",
      "&": "f_machinery_heavy",
      "c": "f_counter",
      "d": "f_desk",
      "D": "f_dumpster",
      "h": "f_chair",
      "F": "f_filing_cabinet",
      "%": "f_solar_unit"
    },
    "items": {
      "D": { "item": "office", "chance": 45, "repeat": [ 1, 2 ] },
      "Y": { "item": "jackets", "chance": 55, "repeat": [ 1, 6 ] },
      "l": { "item": "cleaning", "chance": 75, "repeat": [ 1, 3 ] },
      "r": { "item": "trash", "chance": 60, "repeat": [ 1, 2 ] },
      "F": { "item": "file_room", "chance": 70, "repeat": [ 1, 3 ] }
    },
    "toilets": { "T": {  } }
  },
  {
    "type": "mapgen",
    "method": "json",
    "om_terrain": [
      [ "parking_garage2x2_down_0", "parking_garage2x2_down_1" ],
      [ "parking_garage2x2_down_2", "parking_garage2x2_down_3" ]
    ],
    "weight": 250,
    "object": {
      "fill_ter": "t_thconc_floor",
      "rows": [
        "################################################",
        "|||||||||||||||||||||||||||||||||||||||||||||###",
        "|EE|s                                       |###",
        "|EE!s                                       |###",
        "|||es                                       |###",
        "|ssss                                       |###",
        "|É                                          |###",
        "|                  zzzzzzzzzzzzzzz          |###",
        "|                zz               zz        |###",
        "|-----          zz                  z       |###",
        "|     Á        zz                   z       |###",
        "|              z                    z       |###",
        "|              z                    z       |###",
        "|              z        É           z       |###",
        "|                       sssss       z<<<<<<<|###",
        "|                       sIsIs       zooooooo|###",
        "|-----                  sssss               |###",
        "|      Á                É           |||||||||###",
        "|                                           |###",
        "|                            Ésssss         |###",
        "|                             sIsIs         |###",
        "|                             sssss         |###",
        "|                                           |###",
        "|-----           --------            -------|###",
        "|                                           |###",
        "|                                           |###",
        "|                                           |###",
        "|                                           |###",
        "|                                           |###",
        "|                --------            -------|###",
        "|-----                                      |###",
        "|       Á                            Á      |###",
        "|                 Á                         |###",
        "|                                           |###",
        "|                                           |###",
        "|                --------            -------|###",
        "|                                    Á      |###",
        "|-----                                      |###",
        "|      Á                                    |###",
        "|                                           |###",
        "|                                    -------|###",
        "|         -Á    -Á    -     -Á    -         |###",
        "|         -     -     -     -     -         |###",
        "|         -     -     -     -     -         |###",
        "|-----    -     -     -     -     -       ss|###",
        "|         -     -     -     -     -       si|###",
        "|||||||||||||||||||||||||||||||||||||||||||||###",
        "################################################"
      ],
      "palettes": [ "parking_garage2x2_palette" ],
      "place_monsters": [ { "monster": "GROUP_ZOMBIE", "x": [ 3, 17 ], "y": [ 13, 15 ], "chance": 20 } ],
      "vehicles": {
        "Á": { "vehicle": "parking_garage", "chance": 33, "rotation": 270 },
        "É": { "vehicle": "motorcycle", "chance": 33, "rotation": 90 }
      }
    }
  },
  {
    "type": "mapgen",
    "method": "json",
    "om_terrain": [ [ "parking_garage2x2_0_0", "parking_garage2x2_0_1" ], [ "parking_garage2x2_0_2", "parking_garage2x2_0_3" ] ],
    "weight": 250,
    "object": {
      "fill_ter": "t_thconc_floor",
      "rows": [
        "|||||||||       |====|====|====|====|       |ww|",
        "|EE|s             sssssssssssssssss         cxd|",
        "|EE!s               --                      chdw",
        "|||es               --                      |:Fw",
        "=ssss               --                      +:F|",
        "=-------            ss                      |ww|",
        "|   Á               ss                      |...",
        "|                   ss                      |...",
        "|                   ss                      |...",
        "|                   ss                      |...",
        "|-------          sssss                     |...",
        "|   Á             sIsIs             I<<<<<<<|...",
        "|                 sIsIs              ooooooo|...",
        "|                 sssss          ||||||||||||...",
        "|                 sssss              OOOOOOO|...",
        "|-------          sIsIs             I>>>>>>>|...",
        "|   Á             sIsIs                     |...",
        "=                 sssss                     |...",
        "=                     ss                    |...",
        "=                      ss                   |...",
        "=-------               ssssss               =...",
        "|                       sIsIs               =...",
        "|                       sIsIs               =...",
        "|                       sssss               =...",
        "|                  ---------------          =...",
        "|-------                                    =...",
        "=                                           =...",
        "=                                           |...",
        "=                  Á                        |...",
        "=                  ---------------          |...",
        "|-------                                    |...",
        "|    Á                                      |...",
        "|                                           |...",
        "|                  Á                        |...",
        "|                  ---------------          |...",
        "|-------                                    |...",
        "|    Á                                      |...",
        "|                                           |...",
        "|                                           |...",
        "=-------                                    =...",
        "=      -                               -    =...",
        "=      -                               -  É =...",
        "=      -   É   -   É   -   É   -   É   -    =...",
        "=      -       -       -       -       -    =...",
        "|      -       -       -       -       -ssss|...",
        "|ssssssssssssssssssssssssssssssssssssssssis/|...",
        "||||||||||||====|====|====|====|====|====||||...",
        "................................................"
      ],
      "palettes": [ "parking_garage2x2_palette" ],
      "place_monsters": [ { "monster": "GROUP_ZOMBIE", "x": [ 3, 17 ], "y": [ 13, 15 ], "chance": 20 } ],
      "vehicles": {
        "Á": { "vehicle": "parking_garage", "chance": 33, "rotation": 270 },
        "É": { "vehicle": "motorcycle", "chance": 33, "rotation": 90 }
      },
      "place_loot": [ { "group": "cash_register_random", "x": 44, "y": [ 1, 2 ] } ]
    }
  },
  {
    "type": "mapgen",
    "method": "json",
    "om_terrain": [ [ "parking_garage2x2_1_0", "parking_garage2x2_1_1" ], [ "parking_garage2x2_1_2", "parking_garage2x2_1_3" ] ],
    "weight": 250,
    "object": {
      "fill_ter": "t_thconc_floor",
      "rows": [
        "||||||||||||====|====|====|====|====|====||||335",
        "|EE|s                                       |zz2",
        "=EE!s                                       |iz2",
        "=||es                                       =zz2",
        "=ssss                                       =zz2",
        "=                                           =zz2",
        "|                  zzzzzzzzzzzzzzz          =***",
        "|                zz               zz        =***",
        "|-----          zz                  z       |***",
        "|              zz                   z       |***",
        "|              z                    z||||||||***",
        "|              z                    zOOOOOOO|***",
        "|              z                    z>>>>>>>|***",
        "|                       sssss       z       |***",
        "|                       sIsIs       z       |***",
        "|-----                  sssss               |***",
        "|                                           |***",
        "|                                           |***",
        "|                             sssss         |***",
        "|                             sIsIs         |***",
        "|                             sssss         |***",
        "|-----          <o|                         |***",
        "|               <o|                         |***",
        "|               <o|                         |***",
        "|               <o|                         |***",
        "|               <o|                         |***",
        "W               <o|                         |***",
        "W               <o|                         =***",
        "W-----                                 -----=***",
        "W                                           =***",
        "|                                           =***",
        "|                                           =***",
        "=                                           |***",
        "=                                           |***",
        "=                                           |***",
        "=-----                                 -----|***",
        "=                                           |***",
        "=                                           |***",
        "|                                           |***",
        "|                                           =***",
        "|                                           =***",
        "W                                           =***",
        "W-----               -                 -----=***",
        "W                    -                      =***",
        "W                    -                  ssss|***",
        "|                    -                  s/si|***",
        "||||||||||||====|====|====|====|====|====||||***",
        "************************************************"
      ],
      "palettes": [ "parking_garage2x2_palette" ],
      "place_monsters": [ { "monster": "GROUP_ZOMBIE", "x": [ 3, 17 ], "y": [ 13, 15 ], "chance": 20 } ],
      "place_vehicles": [
        { "vehicle": "parking_garage", "x": 18, "y": 5, "chance": 25, "rotation": 270 },
        { "vehicle": "parking_garage", "x": 28, "y": 5, "chance": 25, "rotation": 270 },
        { "vehicle": "parking_garage", "x": 33, "y": 5, "chance": 25, "rotation": 270 },
        { "vehicle": "parking_garage", "x": 38, "y": 5, "chance": 25, "rotation": 270 },
        { "vehicle": "parking_garage", "x": 19, "y": 18, "chance": 25, "rotation": 90 },
        { "vehicle": "parking_garage", "x": 29, "y": 18, "chance": 25, "rotation": 90 },
        { "vehicle": "parking_garage", "x": 34, "y": 18, "chance": 25, "rotation": 90 },
        { "vehicle": "parking_garage", "x": 39, "y": 18, "chance": 25, "rotation": 90 }
      ]
    }
  },
  {
    "type": "mapgen",
    "method": "json",
    "om_terrain": [ [ "parking_garage2x2_2_0", "parking_garage2x2_2_1" ], [ "parking_garage2x2_2_2", "parking_garage2x2_2_3" ] ],
    "weight": 250,
    "object": {
      "fill_ter": "t_thconc_floor",
      "rows": [
        "||||||||||||====|====|====|====|====|====||||***",
        "|EE|s                                       |;;*",
        "=EE!s                                       |iz2",
        "=||es                                       =i;*",
        "=ssss                                       =/;*",
        "=                                           =;;*",
        "|                  zzzzzzzzzzzzzzz          =***",
        "|                zz               zz        =***",
        "|-----          zz                  z       |***",
        "|              zz                   z       |***",
        "|              z                    z       |***",
        "|              z                    z       |***",
        "|              z                    z       |***",
        "|                       sssss       z       |***",
        "|                       sIsIs       z       |***",
        "|-----                  sssss               |***",
        "|                                           |***",
        "|                                           |***",
        "|                             sssss         |***",
        "|                             sIsIs         |***",
        "|                             sssss         |***",
        "|               |O>                         |***",
        "|               |O>                         |***",
        "|               |O>                         |***",
        "|               |O>                         |***",
        "|               |O>                         |***",
        "|               |O>                         |***",
        "W               |O>                         |***",
        "W                                           =***",
        "W                                           =***",
        "W                                           =***",
        "|                                           =***",
        "|                                           =***",
        "=                                           |***",
        "=                                           |***",
        "=                                           |***",
        "=                                           |***",
        "=                                           |***",
        "=                                           |***",
        "|                                           |***",
        "|                                           =***",
        "|                                           =***",
        "W                                           =***",
        "W                                           =***",
        "W                                           =***",
        "W                                       ssss|***",
        "|                                       s/si|***",
        "||||||||||||====|====|====|====|====|====||||***"
      ],
      "palettes": [ "parking_garage2x2_palette" ],
      "place_monsters": [ { "monster": "GROUP_ZOMBIE", "x": [ 3, 17 ], "y": [ 13, 15 ], "chance": 20 } ],
      "vehicles": {
        "Á": { "vehicle": "parking_garage", "chance": 33, "rotation": 270 },
        "É": { "vehicle": "motorcycle", "chance": 33, "rotation": 90 }
      }
    }
  },
  {
    "type": "mapgen",
    "method": "json",
    "om_terrain": [ [ "parking_garage_roof_0", "parking_garage_roof_1" ] ],
    "weight": 250,
    "object": {
      "fill_ter": "t_thconc_floor",
      "rows": [
        "|||||||||====================================***",
        "|EEEEEEE!_______ssssssssssssssssssssssssssssf;;*",
        "WEEEEEEE!_______ssssssssssssssssssssssssssssf;;*",
        "WEEEEEEE!_______y____y____y____y____y____yssg;;*",
        "WEEEEEEE!_______y____y____y____y____y____yssf/;*",
        "WEEEEEEE!_______y____y____y____y____y____yssf;;*",
        "|EEEEEEE!_______y____y____y____y____y____yss=***",
        "||||||x||x'_____y____y____y____y____y____yss=***",
        "*|'''|||'''_______________________________ss=***",
        "*='''''''''_______________________________ss=***",
        "*='''''''''_______________________________ss=***",
        "*='''''''''_______________________________ss=***",
        "*='''''''''_______________________________ss=***",
        "*='''''''''_______________________________ss=***",
        "*|'>'|||'''_______________________________ss=***",
        "||||||x||x'_____y____y____y____y____y____yss=***",
        "|EEEEEEE!_______y____y____y____y____y____yss=***",
        "WEEEEEEE!_______y____y____y____y____y____yss=***",
        "WEEEEEEE!_______y____y____y____y____y____yss=***",
        "WEEEEEEE!_______y____y____y____y____y____yss=***",
        "WEEEEEEE!_______ssssssssssssssssssssssssssss=***",
        "|EEEEEEE!_______ssssssssssssssssssssssssssss=***",
        "|||||||||====================================***",
        "************************************************"
      ],
      "palettes": [ "parking_garage2x2_palette" ],
      "place_monsters": [ { "monster": "GROUP_ZOMBIE", "x": [ 3, 17 ], "y": [ 13, 15 ], "chance": 20 } ],
      "vehicles": {
        "Á": { "vehicle": "parking_garage", "chance": 33, "rotation": 270 },
        "É": { "vehicle": "motorcycle", "chance": 33, "rotation": 90 }
      }
    }
  },
  {
    "type": "mapgen",
    "method": "json",
    "om_terrain": [ "parking_garage_roof_top" ],
    "weight": 250,
    "object": {
      "fill_ter": "t_tar_flat_roof",
      "rows": [
        "533333335***************",
        "1zzzzzzz2***************",
        "1zzz@@zz2***************",
        "1zzz@@zz2***************",
        "1zzz@@zz2***************",
        "1zzzzzzz2***************",
        "1zzzzzzz2***************",
        "11zzzzzzzzz*************",
        "*1z%%z%%zzz*************",
        "*1z%%z%%zzz*************",
        "*1zzzzzzzzz*************",
        "*1zzzzzzzzz*************",
        "*1zzzzzzzzz*************",
        "*1z%%z%%zzz*************",
        "*1z%%z%%zzz*************",
        "11zzzzzzzzz*************",
        "1zzzzzzz2***************",
        "1zzzzzzz2***************",
        "1zzz@@zz2***************",
        "1zzz@@zz2***************",
        "1zzz@@zz2***************",
        "1zzzzzzz2***************",
        "544444445***************",
        "************************"
      ],
      "palettes": [ "parking_palette" ]
    }
  }
]
