[
    {
    "type": "mapgen",
        "om_terrain": [
            "pond_field"
        ],
        "method": "json",
        "weight": 100,
        "object": {
            "fill_ter": "t_dirt",
            "rows": [
            "                        ",
            "                        ",
            "  ????????????????????  ",
            "  ?]]]]]]]]]]]]]]]]]]?  ",
            "  ?]****************]?  ",
            "  ?]****************]?  ",
            "  ?]****************]?  ",
            "  ?]****************]?  ",
            "  ?]****[[[[[[[[****]?  ",
            "  ?]****[~~~~~~[****]?  ",
            "  ?]****[~~~~~~[****]?  ",
            "  ?]****[~~~~~~[****]?  ",
            "  ?]****[~~~~~~[****]?  ",
            "  ?]****[~~~~~~[****]?  ",
            "  ?]****[~~~~~~[****]?  ",
            "  ?]****[[[[[[[[****]?  ",
            "  ?]****************]?  ",
            "  ?]****************]?  ",
            "  ?]****************]?  ",
            "  ?]****************]?  ",
            "  ?]]]]]]]]]]]]]]]]]]?  ",
            "  ????????????????????  ",
            "                        ",
            "                        "
            ],
            "terrain": {
                "~": "t_water_dp",
                "[": ["t_water_dp", "t_water_dp", "t_water_sh", "t_water_sh", "t_water_sh"],
                "*": "t_water_sh",
                "]": ["t_water_sh", "t_water_sh", "t_water_sh", "t_water_sh", "t_water_sh", "t_water_sh", "t_water_sh", "t_water_sh", "t_dirt", "t_grass"],
                "?": ["t_water_sh", "t_water_sh", "t_water_sh", "t_dirt", "t_dirt", "t_dirt", "t_dirt", "t_dirt", "t_dirt", "t_dirt", "t_grass", "t_grass", "t_grass",
                      "t_grass", "t_grass", "t_grass", "t_grass", "t_grass", "t_grass", "t_grass", "t_grass", "t_grass", "t_grass", "t_shrub", "t_tree"],
                " ": ["t_water_sh", "t_water_sh", "t_water_sh", "t_dirt", "t_dirt", "t_dirt", "t_dirt", "t_dirt", "t_dirt", "t_dirt", "t_grass", "t_grass", "t_grass",
                      "t_grass", "t_grass", "t_grass", "t_grass", "t_grass", "t_grass", "t_grass", "t_grass", "t_grass", "t_grass", "t_shrub"]
            }
        }
    },{
    "type": "mapgen",
        "om_terrain": [
            "pond_forest"
        ],
        "method": "json",
        "weight": 100,
        "object": {
            "fill_ter": "t_dirt",
            "rows": [
            "                        ",
            "                        ",
            "  ????????????????????  ",
            "  ?]]]]]]]]]]]]]]]]]]?  ",
            "  ?]****************]?  ",
            "  ?]****************]?  ",
            "  ?]****************]?  ",
            "  ?]****************]?  ",
            "  ?]****[[[[[[[[****]?  ",
            "  ?]****[~~~~~~[****]?  ",
            "  ?]****[~~~~~~[****]?  ",
            "  ?]****[~~~~~~[****]?  ",
            "  ?]****[~~~~~~[****]?  ",
            "  ?]****[~~~~~~[****]?  ",
            "  ?]****[~~~~~~[****]?  ",
            "  ?]****[[[[[[[[****]?  ",
            "  ?]****************]?  ",
            "  ?]****************]?  ",
            "  ?]****************]?  ",
            "  ?]****************]?  ",
            "  ?]]]]]]]]]]]]]]]]]]?  ",
            "  ????????????????????  ",
            "                        ",
            "                        "
            ],
            "terrain": {
                "~": "t_water_dp",
                "[": ["t_water_dp", "t_water_dp", "t_water_sh", "t_water_sh", "t_water_sh"],
                "*": "t_water_sh",
                "]": ["t_water_sh", "t_water_sh", "t_water_sh", "t_water_sh", "t_water_sh", "t_water_sh", "t_water_sh", "t_water_sh", "t_dirt", "t_grass"],
                "?": ["t_water_sh", "t_water_sh", "t_water_sh", "t_dirt", "t_dirt", "t_dirt", "t_dirt", "t_dirt", "t_grass", "t_grass", "t_grass", "t_grass", "t_grass",
                      "t_grass", "t_shrub", "t_shrub", "t_tree_young", "t_tree", "t_tree", "t_tree_willow"],
                " ": ["t_dirt", "t_dirt", "t_dirt", "t_grass", "t_grass", "t_grass", "t_shrub", "t_tree_young", "t_tree_young", "t_tree", "t_tree"]
            }
        }
    },{
    "type": "mapgen",
        "om_terrain": [
            "pond_swamp"
        ],
        "method": "json",
        "weight": 100,
        "object": {
            "fill_ter": "t_dirt",
            "rows": [
            "                        ",
            "                        ",
            "  ????????????????????  ",
            "  ?]]]]]]]]]]]]]]]]]]?  ",
            "  ?]****************]?  ",
            "  ?]****************]?  ",
            "  ?]****************]?  ",
            "  ?]****************]?  ",
            "  ?]****[[[[[[[[****]?  ",
            "  ?]****[~~~~~~[****]?  ",
            "  ?]****[~~~~~~[****]?  ",
            "  ?]****[~~~~~~[****]?  ",
            "  ?]****[~~~~~~[****]?  ",
            "  ?]****[~~~~~~[****]?  ",
            "  ?]****[~~~~~~[****]?  ",
            "  ?]****[[[[[[[[****]?  ",
            "  ?]****************]?  ",
            "  ?]****************]?  ",
            "  ?]****************]?  ",
            "  ?]****************]?  ",
            "  ?]]]]]]]]]]]]]]]]]]?  ",
            "  ????????????????????  ",
            "                        ",
            "                        "
            ],
            "terrain": {
                "~": "t_water_dp",
                "[": ["t_water_dp", "t_water_dp", "t_water_sh", "t_water_sh", "t_water_sh"],
                "*": "t_water_sh",
                "]": ["t_water_sh", "t_water_sh", "t_water_sh", "t_water_sh", "t_water_sh", "t_water_sh", "t_water_sh", "t_water_sh", "t_dirt", "t_grass", "t_tree_willow"],
                "?": ["t_water_sh", "t_water_sh", "t_water_sh", "t_dirt", "t_dirt", "t_dirt", "t_dirt", "t_dirt", "t_grass", "t_grass", "t_grass", "t_grass", "t_grass", "t_grass",
                      "t_shrub", "t_shrub", "t_tree_young", "t_tree", "t_tree_willow", "t_tree_willow"],
                " ": ["t_water_dp", "t_water_sh", "t_water_sh", "t_dirt", "t_dirt", "t_dirt", "t_dirt", "t_grass", "t_grass", "t_grass", "t_grass", "t_grass", "t_grass", "t_shrub",
                      "t_shrub", "t_tree_young", "t_tree", "t_tree_willow"]
            }
        }
    }
]
