[
  {
    "id": "GROUP_MAPGEN_POOL",
    "type": "monstergroup",
    "monsters": [ { "monster": "mon_null", "weight": 1 }, { "monster": "mon_zombie_swimmer_base", "weight": 4 } ]
  },
  {
    "method": "json",
    "object": {
      "furniture": {
        "#": "f_bench",
        "&": "f_trashcan",
        "O": "f_dive_block",
        "S": "f_shower",
        "P": "f_sign",
        "T": "f_toilet",
        "a": "f_trashcan",
        "{": "f_locker"
      },
      "place_item": [ { "chance": 10, "repeat": 3, "item": "goggles_swim", "x": [ 15, 19 ], "y": 2 } ],
      "place_items": [
        { "chance": 25, "repeat": 2, "item": "allclothes", "x": 14, "y": 18 },
        { "chance": 25, "repeat": 2, "item": "allclothes", "x": 15, "y": 18 },
        { "chance": 25, "repeat": 2, "item": "allclothes", "x": 8, "y": 18 },
        { "chance": 25, "repeat": 2, "item": "allclothes", "x": 9, "y": 18 },
        { "chance": 25, "repeat": 2, "item": "allclothes", "x": 10, "y": 18 },
        { "chance": 25, "repeat": 2, "item": "allclothes", "x": 11, "y": 18 },
        { "chance": 25, "repeat": 2, "item": "allclothes", "x": 12, "y": 18 },
        { "chance": 15, "item": "homebooks", "x": 13, "y": 18 },
        { "chance": 15, "item": "homebooks", "x": 17, "y": 2 },
        { "chance": 25, "item": "shoes", "x": 18, "y": 2 },
        { "chance": 25, "repeat": [ 1, 3 ], "item": "SUS_trash_trashcan_public", "x": 21, "y": 18 },
        { "chance": 25, "repeat": [ 1, 3 ], "item": "SUS_trash_trashcan_public", "x": 2, "y": 18 },
        { "chance": 25, "repeat": [ 1, 3 ], "item": "SUS_trash_trashcan_public", "x": 21, "y": 2 },
        { "chance": 25, "repeat": [ 1, 3 ], "item": "SUS_trash_trashcan_public", "x": 2, "y": 2 },
        { "chance": 15, "item": "magazines", "x": 6, "y": 2 }
      ],
      "place_toilets": [ { "x": 3, "y": 20 }, { "x": 20, "y": 20 } ],
      "place_monster": [ { "group": "GROUP_MAPGEN_POOL", "x": [ 6, 17 ], "y": [ 6, 15 ], "repeat": [ 2, 6 ] } ],
      "fill_ter": "t_concrete",
      "rows": [
        "ssssssssssssssssssssssss",
        " ----------++---------- ",
        " -&P#####......#####P&- ",
        " -....................- ",
        " -....................- ",
        " -..wwOwwwwwwwwwwOww..- ",
        " -..wwwwwwwwwwwwwwww..- ",
        " -..wwwwwwwwwwwwwwww..- ",
        " -..wwwwwwwwwwwwwwww..- ",
        " -..wwwwwwwwwwwwwwww..- ",
        " -..wwwwwwwwwwwwwwww..- ",
        " -..wwwwwwwwwwwwwwww..- ",
        " -..wwwwwwwwwwwwwwww..- ",
        " -..wwwwwwwwwwwwwwww..- ",
        " -..wwwwwwwwwwwwwwww..- ",
        " -..wwwwwwwwwwwwwwww..- ",
        " -..wwOwwwwwwwwwwOww..- ",
        " -....................- ",
        " -&.....{{{{{{{{.....&- ",
        " -||d|.||||||||||.|d||- ",
        " -|Tt|..SS.SS.SS..|tT|- ",
        " -||||............||||- ",
        " ---------------------- ",
        "                        "
      ],
      "palettes": [ "parametrized_walls_palette" ],
      "terrain": {
        "+": "t_chaingate_c",
        "-": "t_chainfence",
        ".": "t_concrete",
        "O": "t_water_pool",
        "T": "t_thconc_floor",
        " ": "t_region_groundcover_urban",
        "d": "t_door_c",
        "s": "t_sidewalk",
        "t": "t_thconc_floor",
        "w": "t_water_pool"
      },
      "place_signs": [ { "signage": "NO lifeguard on duty!", "x": 3, "y": 2 }, { "signage": "NO running!", "x": 20, "y": 2 } ]
    },
    "om_terrain": "pool",
    "//": "Outdoor pool",
    "type": "mapgen"
  },
  {
    "type": "mapgen",
    "method": "json",
    "om_terrain": "pool_roof",
    "object": {
      "fill_ter": "t_open_air",
      "rows": [
        "                        ",
        "                        ",
        "                        ",
        "                        ",
        "                        ",
        "                        ",
        "                        ",
        "                        ",
        "                        ",
        "                        ",
        "                        ",
        "                        ",
        "                        ",
        "                        ",
        "                        ",
        "                        ",
        "                        ",
        "                        ",
        "                        ",
        "  ....            ....  ",
        "  ....            ....  ",
        "  ....            ....  ",
        "                        ",
        "                        "
      ],
      "terrain": { ".": "t_tar_flat_roof" }
    }
  },
  {
    "method": "json",
    "object": {
      "furniture": { "b": "f_bench", "&": "f_toilet", "S": "f_sink", "t": "f_trashcan", "{": "f_locker" },
      "vendingmachines": {
        "v": { "item_group": "vending_food_items", "lootable": true },
        "V": { "item_group": "vending_drink_items", "lootable": true }
      },
      "place_items": [
        { "chance": 20, "repeat": 2, "item": "clothing_male", "x": 18, "y": 6 },
        { "chance": 20, "repeat": 2, "item": "clothing_male", "x": 19, "y": 6 },
        { "chance": 20, "repeat": 2, "item": "clothing_male", "x": 20, "y": 6 },
        { "chance": 25, "item": "male_underwear", "x": 21, "y": 6 },
        { "chance": 25, "item": "male_underwear", "x": 17, "y": 6 },
        { "chance": 25, "item": "female_underwear", "x": 6, "y": 6 },
        { "chance": 25, "item": "female_underwear", "x": 3, "y": 6 },
        { "chance": 15, "item": "shoes", "x": 18, "y": 8 },
        { "chance": 15, "item": "shoes", "x": 6, "y": 8 },
        { "chance": 15, "item": "shoes", "x": 4, "y": 8 },
        { "chance": 20, "repeat": 2, "item": "SUS_trash_trashcan_public", "x": 16, "y": 3 },
        { "chance": 20, "repeat": 2, "item": "SUS_trash_trashcan_public", "x": 7, "y": 3 },
        { "chance": 20, "repeat": 2, "item": "clothing_female", "x": 4, "y": 6 },
        { "chance": 20, "repeat": 2, "item": "clothing_female", "x": 5, "y": 6 },
        { "chance": 20, "repeat": 2, "item": "clothing_female", "x": 2, "y": 6 }
      ],
      "place_toilets": [ { "x": 2, "y": 3 }, { "x": 4, "y": 3 }, { "x": 19, "y": 3 }, { "x": 21, "y": 3 } ],
      "place_monster": [ { "group": "GROUP_MAPGEN_POOL", "x": [ 4, 19 ], "y": [ 11, 19 ], "repeat": [ 2, 6 ] } ],
      "fill_ter": { "param": "linoleum_color", "fallback": "t_linoleum_gray" },
      "rows": [
        "ssssssssssssssssssssssss",
        "ssssssssssssssssssssssss",
        " ##########rr########## ",
        " #&#&#StS#ffff#StS#&#&# ",
        " #+#+#fff+ffff+fff#+#+# ",
        " #fffffff#ffff#fffffff# ",
        " #{{{{{ff#vffV#ff{{{{{# ",
        " #######+##rr##+####### ",
        " -.bbbb..........bbbb4- ",
        " -....................- ",
        " -.wwwwwwwwwwwwwwwwww.- ",
        " -.wwwwwwwwwwwwwwwwww.- ",
        " -.wwwwwwwwwwwwwwwwww.- ",
        " -.wwwwwwwwwwwwwwwwww.- ",
        " -.wwwwwwwwwwwwwwwwww.- ",
        " -.wwwwwwwwwwwwwwwwww.- ",
        " -.wwwwwwwwwwwwwwwwww.- ",
        " -.wwwwwwwwwwwwwwwwww.- ",
        " -.wwwwwwwwwwwwwwwwww.- ",
        " -.wwwwwwwwwwwwwwwwww.- ",
        " -.wwwwwwwwwwwwwwwwww.- ",
        " -....................- ",
        " ---------------------- ",
        "                        "
      ],
      "palettes": [ "parametrized_linoleum_palette", "parametrized_walls_palette" ],
      "terrain": {
        "b": "t_concrete",
        "+": [ "t_door_o", "t_door_c" ],
        "-": "t_chainfence",
        ".": "t_concrete",
        " ": "t_region_groundcover_urban",
        "f": { "param": "linoleum_color", "fallback": "t_linoleum_gray" },
        "r": "t_reinforced_door_glass_c",
        "s": "t_sidewalk",
        "w": "t_water_pool",
        "4": "t_gutter_downspout"
      }
    },
    "om_terrain": "pool_1",
    "//": "Indoor pool",
    "type": "mapgen"
  },
  {
    "type": "mapgen",
    "method": "json",
    "om_terrain": "pool_roof_1",
    "object": {
      "fill_ter": "t_flat_roof",
      "rows": [
        "                        ",
        "                        ",
        " ---------------------- ",
        " -....................- ",
        " -....:.........&.....- ",
        " -....................- ",
        " -....................- ",
        " --------------------5- ",
        "                        ",
        "                        ",
        "                        ",
        "                        ",
        "                        ",
        "                        ",
        "                        ",
        "                        ",
        "                        ",
        "                        ",
        "                        ",
        "                        ",
        "                        ",
        "                        ",
        "                        ",
        "                        "
      ],
      "palettes": [ "roof_palette" ]
    }
  },
  {
    "method": "json",
    "object": {
      "furniture": {
        "B": "f_bench",
        "&": "f_sink",
        "O": "f_dive_block",
        "P": "f_sign",
        "S": "f_sign",
        "T": "f_trashcan",
        "a": "f_table",
        "b": "f_bigmirror",
        "t": "f_toilet",
        "{": "f_locker"
      },
      "place_item": [
        { "chance": 10, "repeat": [ 1, 4 ], "item": "goggles_swim", "x": 2, "y": [ 6, 11 ] },
        { "chance": 10, "repeat": [ 1, 4 ], "item": "goggles_swim", "x": 21, "y": [ 6, 11 ] }
      ],
      "place_items": [
        { "chance": 3, "item": "creepy", "x": 17, "y": 3 },
        { "chance": 10, "repeat": [ 1, 4 ], "item": "clothing_female", "x": 21, "y": 6 },
        { "chance": 10, "repeat": [ 1, 4 ], "item": "clothing_female", "x": 21, "y": 7 },
        { "chance": 10, "repeat": [ 1, 4 ], "item": "clothing_female", "x": 21, "y": 8 },
        { "chance": 10, "repeat": [ 1, 4 ], "item": "clothing_female", "x": 21, "y": 9 },
        { "chance": 10, "repeat": [ 1, 4 ], "item": "clothing_female", "x": 21, "y": 10 },
        { "chance": 10, "repeat": [ 1, 4 ], "item": "clothing_female", "x": 21, "y": 11 },
        { "chance": 10, "repeat": [ 1, 4 ], "item": "clothing_male", "x": 2, "y": 6 },
        { "chance": 10, "repeat": [ 1, 4 ], "item": "clothing_male", "x": 2, "y": 7 },
        { "chance": 10, "repeat": [ 1, 4 ], "item": "clothing_male", "x": 2, "y": 8 },
        { "chance": 10, "repeat": [ 1, 4 ], "item": "clothing_male", "x": 2, "y": 9 },
        { "chance": 10, "repeat": [ 1, 4 ], "item": "clothing_male", "x": 2, "y": 10 },
        { "chance": 10, "repeat": [ 1, 4 ], "item": "clothing_male", "x": 2, "y": 11 },
        { "chance": 20, "repeat": [ 1, 2 ], "item": "SUS_trash_trashcan_public", "x": 21, "y": 3 },
        { "chance": 20, "repeat": [ 1, 2 ], "item": "SUS_trash_trashcan_public", "x": 2, "y": 3 },
        { "chance": 10, "item": "magazines", "x": 21, "y": 17 },
        { "chance": 10, "repeat": [ 1, 2 ], "item": "magazines", "x": 2, "y": 17 }
      ],
      "place_toilets": [ { "x": 6, "y": 3 }, { "x": 8, "y": 3 }, { "x": 15, "y": 3 }, { "x": 17, "y": 3 } ],
      "place_monster": [ { "group": "GROUP_MAPGEN_POOL", "x": [ 5, 18 ], "y": [ 5, 18 ], "repeat": [ 2, 6 ] } ],
      "fill_ter": { "param": "linoleum_color", "fallback": "t_linoleum_white" },
      "rows": [
        "ssssssssssssssssssssssss",
        "ssssssssssssssssssssssss",
        " ##########rr########## ",
        " #T&&|t|t|ffff|t|t|&&T# ",
        " #fff|+|+PffffP+|+|fff# ",
        " #bffffff+ffff+ffffffb# ",
        " #{f||||||f||f||||||f{# ",
        " #{f|..............|f{# ",
        " #{f|..............|f{# ",
        " #{f|..wwwwwwwwww..|f{# ",
        " #{f|..wwwwwwwwww..|f{# ",
        " #{f|..wwwwwwwwww..|f{# ",
        " #|+|..wwwwwwwwww..|+|# ",
        " #S....wwwwwwwwww....S# ",
        " #B....wwwwwwwwww....B# ",
        " #B..wwwwwwwwwwwwww..B# ",
        " #B..OwwwwwwwwwwwwO..B# ",
        " #a..wwwwwwwwwwwwww..a# ",
        " #B..OwwwwwwwwwwwwO..B# ",
        " #B..wwwwwwwwwwwwww..B# ",
        " #B..................B# ",
        " #....................# ",
        " ###################### ",
        "                     4  "
      ],
      "palettes": [ "parametrized_linoleum_palette", "parametrized_walls_palette" ],
      "terrain": {
        "B": "t_thconc_floor",
        "+": [ "t_door_o", "t_door_c" ],
        ".": "t_thconc_floor",
        "O": "t_water_pool",
        "P": "t_wall_b",
        "S": "t_thconc_floor",
        " ": "t_region_groundcover_urban",
        "a": "t_thconc_floor",
        "f": { "param": "linoleum_color", "fallback": "t_linoleum_white" },
        "r": "t_reinforced_door_glass_c",
        "s": "t_sidewalk",
        "4": "t_gutter_downspout",
        "w": "t_water_pool"
      },
      "place_signs": [
        { "signage": "MEN", "x": 9, "y": 4 },
        { "signage": "WOMEN", "x": 14, "y": 4 },
        { "signage": "NO running!", "x": 2, "y": 13 },
        { "signage": "NO diving in the shallow end!", "x": 21, "y": 13 }
      ]
    },
    "om_terrain": "pool_2",
    "//": "Indoor pool",
    "type": "mapgen"
  },
  {
    "type": "mapgen",
    "method": "json",
    "om_terrain": "pool_roof_2",
    "object": {
      "fill_ter": "t_flat_roof",
      "rows": [
        "                        ",
        "                        ",
        " ---------------------- ",
        " -....................- ",
        " -....................- ",
        " -....................- ",
        " -....&...............- ",
        " -..................:.- ",
        " -....................- ",
        " -....................- ",
        " -......oo.oo.oo......- ",
        " -......oo.oo.oo......- ",
        " -......oo.oo.oo......- ",
        " -......oo.oo.oo......- ",
        " -....................- ",
        " -......oo.oo.oo......- ",
        " -......oo.oo.oo......- ",
        " -......oo.oo.oo......- ",
        " -......oo.oo.oo......- ",
        " -....................- ",
        " -....................- ",
        " -...............&....- ",
        " --------------------5- ",
        "                        "
      ],
      "palettes": [ "roof_palette" ]
    }
  },
  {
    "method": "json",
    "object": {
      "furniture": { "B": "f_bench", "&": "f_toilet", "P": "f_sign", "S": "f_sink", "b": "f_bench", "t": "f_trashcan", "{": "f_locker" },
      "place_items": [
        { "chance": 10, "repeat": [ 1, 4 ], "item": "SUS_trash_trashcan_public", "x": 13, "y": 21 },
        { "chance": 10, "repeat": [ 1, 4 ], "item": "SUS_trash_trashcan_public", "x": 10, "y": 21 },
        { "chance": 15, "repeat": [ 1, 4 ], "item": "clothing_female", "x": 5, "y": 21 },
        { "chance": 15, "repeat": [ 1, 4 ], "item": "clothing_female", "x": 6, "y": 21 },
        { "chance": 15, "repeat": [ 1, 4 ], "item": "clothing_female", "x": 7, "y": 21 },
        { "chance": 15, "repeat": [ 1, 4 ], "item": "clothing_female", "x": 8, "y": 21 },
        { "chance": 15, "repeat": [ 1, 4 ], "item": "clothing_male", "x": 15, "y": 21 },
        { "chance": 15, "repeat": [ 1, 4 ], "item": "clothing_male", "x": 16, "y": 21 },
        { "chance": 15, "repeat": [ 1, 4 ], "item": "clothing_male", "x": 17, "y": 21 },
        { "chance": 15, "repeat": [ 1, 4 ], "item": "clothing_male", "x": 18, "y": 21 }
      ],
      "place_toilets": [ { "x": 2, "y": 19 }, { "x": 2, "y": 21 }, { "x": 21, "y": 19 }, { "x": 21, "y": 21 } ],
      "fill_ter": { "param": "linoleum_color", "fallback": "t_linoleum_white" },
      "rows": [
        "ssssssssssssssssssssssss",
        "ssssssssssssssssssssssss",
        " #--#--#--#++#--#--#--# ",
        " -....................- ",
        " -....................- ",
        " #..wwwwwwwwwwwwwwww..# ",
        " -..wwwwwwwwwwwwwwww..- ",
        " -..wwwwwwwwwwwwwwww..- ",
        " #..wwwwwwwwwwwwwwww..# ",
        " -..wwwwwwwwwwwwwwww..- ",
        " -..wwwwwwwwwwwwwwww..- ",
        " #..wwwwwwwwwwwwwwww..# ",
        " -..wwwwwwwwwwwwwwww..- ",
        " -..wwwwwwwwwwwwwwww..- ",
        " #..wwwwwwwwwwwwwwww..# ",
        " -..wwwwwwwwwwwwwwww..- ",
        " -....................- ",
        " #....................# ",
        " #|||||||||..|||||||||# ",
        " #&DfSSBBP....PBBSSfD&# ",
        " #||fffffa....afffff||# ",
        " #&Df{{{{|tbbt|{{{{fD&# ",
        " ###################### ",
        "                     4  "
      ],
      "palettes": [ "parametrized_linoleum_palette", "parametrized_walls_palette" ],
      "terrain": {
        "+": "t_door_metal_c",
        "-": "t_wall_glass",
        ".": "t_thconc_floor",
        "D": [ "t_door_o", "t_door_c" ],
        "P": "t_brick_wall",
        " ": "t_region_groundcover_urban",
        "a": "t_door_c",
        "b": "t_thconc_floor",
        "f": { "param": "linoleum_color", "fallback": "t_linoleum_white" },
        "s": "t_sidewalk",
        "t": "t_thconc_floor",
        "4": "t_gutter_downspout",
        "w": "t_water_pool"
      },
      "place_monster": [ { "group": "GROUP_MAPGEN_POOL", "x": [ 5, 18 ], "y": [ 5, 18 ], "repeat": [ 2, 6 ] } ],
      "place_signs": [ { "signage": "Women", "x": 9, "y": 19 }, { "signage": "Men", "x": 14, "y": 19 } ]
    },
    "om_terrain": "pool_3",
    "//": "Indoor pool",
    "type": "mapgen"
  },
  {
    "type": "mapgen",
    "method": "json",
    "om_terrain": "pool_roof_3",
    "object": {
      "fill_ter": "t_flat_roof",
      "rows": [
        "                        ",
        "                        ",
        " ---------------------- ",
        " -....................- ",
        " -....................- ",
        " -......oo.oo.oo......- ",
        " -......oo.oo.oo......- ",
        " -....................- ",
        " -......oo.oo.oo......- ",
        " -......oo.oo.oo......- ",
        " -....................- ",
        " -......oo.oo.oo......- ",
        " -......oo.oo.oo......- ",
        " -....................- ",
        " -......oo.oo.oo......- ",
        " -......oo.oo.oo......- ",
        " -....................- ",
        " -....................- ",
        " -....................- ",
        " -...&............&...- ",
        " -....................- ",
        " -....................- ",
        " --------------------5- ",
        "                        "
      ],
      "palettes": [ "roof_palette" ]
    }
  },
  {
    "method": "json",
    "object": {
      "furniture": {
        "B": "f_bench",
        "&": "f_sink",
        "P": "f_sign",
        "T": "f_toilet",
        "a": "f_trashcan",
        "c": "f_counter",
        "t": "f_table",
        "{": "f_locker"
      },
      "place_item": [ { "item": "goggles_swim", "chance": 10, "x": 13, "y": 11 } ],
      "place_items": [
        { "chance": 40, "item": "male_underwear_bottom", "x": 18, "y": 6 },
        { "chance": 25, "repeat": 2, "item": "clothing_female", "x": 5, "y": 6 },
        { "chance": 40, "item": "female_underwear_bottom", "x": 6, "y": 6 },
        { "chance": 40, "item": "female_underwear_top", "x": 6, "y": 6 },
        { "chance": 20, "repeat": 2, "item": "SUS_trash_trashcan_public", "x": 3, "y": 6 },
        { "chance": 20, "repeat": 2, "item": "SUS_trash_trashcan_public", "x": 20, "y": 6 },
        { "chance": 5, "item": "swimmer_head", "x": 7, "y": 6 },
        { "chance": 25, "item": "swimmer_glasses", "x": 7, "y": 6 },
        { "chance": 40, "item": "swimmer_torso", "x": 16, "y": 6 },
        { "chance": 40, "item": "swimmer_pants", "x": 16, "y": 6 },
        { "chance": 25, "repeat": 2, "item": "clothing_male", "x": 15, "y": 6 },
        { "chance": 10, "item": "light_reading", "x": 12, "y": 20 },
        { "chance": 10, "item": "light_reading", "x": 6, "y": 20 },
        { "chance": 10, "item": "light_reading", "x": 17, "y": 8 },
        { "chance": 10, "item": "light_reading", "x": 11, "y": 8 },
        { "chance": 10, "item": "light_reading", "x": 12, "y": 8 }
      ],
      "place_toilets": [ { "x": 6, "y": 3 }, { "x": 8, "y": 3 }, { "x": 15, "y": 3 }, { "x": 17, "y": 3 } ],
      "place_monster": [ { "group": "GROUP_MAPGEN_POOL", "x": [ 6, 17 ], "y": [ 11, 17 ], "repeat": [ 2, 6 ] } ],
      "fill_ter": { "param": "linoleum_color", "fallback": "t_linoleum_gray" },
      "rows": [
        "           ss           ",
        "           ss           ",
        "  ######## ss ########  ",
        "  #&&-T-T#WrrW#T-T-&&#  ",
        "  #ff-+-+#ffff#+-+-ff#  ",
        "  #ffffff+fccf+ffffff#  ",
        "  #af{{{{#ffff#{{{{fa#  ",
        "  #|+||||######||||+|#  ",
        "  #___tBBBBttBBBBt___#  ",
        "  #__________________#  ",
        "  #__wwwwwwwwwwwwww__#  ",
        "  #__wwwwwwwwwwwwww__#  ",
        "  #__wwwwwwwwwwwwww__#  ",
        "  #__wwwwwwwwwwwwww__#  ",
        "  #P_wwwwwwwwwwwwww_P#  ",
        "  #__wwwwwwwwwwwwww__#  ",
        "  #__wwwwwwwwwwwwww__#  ",
        "  #__wwwwwwwwwwwwww__#  ",
        "  #__wwwwwwwwwwwwww__#  ",
        "  #__________________#  ",
        "  #___tBBBBttBBBBt___#  ",
        "  ####################  ",
        "   4                    ",
        "                        "
      ],
      "palettes": [ "parametrized_linoleum_palette", "parametrized_walls_palette" ],
      "terrain": {
        "B": "t_thconc_floor",
        "+": [ "t_door_o", "t_door_c" ],
        "-": "t_wall_b",
        " ": "t_region_groundcover_urban",
        "P": "t_thconc_floor",
        "W": "t_wall_glass",
        "_": "t_thconc_floor",
        "f": { "param": "linoleum_color", "fallback": "t_linoleum_gray" },
        "r": "t_reinforced_door_glass_c",
        "s": "t_sidewalk",
        "t": "t_thconc_floor",
        "w": "t_water_pool",
        "4": "t_gutter_downspout"
      },
      "place_signs": [ { "signage": "NO Running!", "x": 3, "y": 14 }, { "signage": "NO Diving!", "x": 20, "y": 14 } ]
    },
    "om_terrain": "pool_4",
    "//": "Indoor pool",
    "type": "mapgen"
  },
  {
    "type": "mapgen",
    "method": "json",
    "om_terrain": "pool_roof_4",
    "object": {
      "fill_ter": "t_flat_roof",
      "rows": [
        "                        ",
        "                        ",
        "  --------    --------  ",
        "  -......------...:..-  ",
        "  -..................-  ",
        "  -..................-  ",
        "  -.....&.....&......-  ",
        "  -..................-  ",
        "  -..................-  ",
        "  -..................-  ",
        "  -..................-  ",
        "  -..................-  ",
        "  -...oooo....oooo...-  ",
        "  -...oooo....oooo...-  ",
        "  -...oooo....oooo...-  ",
        "  -...oooo....oooo...-  ",
        "  -...oooo....oooo...-  ",
        "  -...oooo....oooo...-  ",
        "  -..................-  ",
        "  -..................-  ",
        "  -..................-  ",
        "  -5------------------  ",
        "                        ",
        "                        "
      ],
      "palettes": [ "roof_palette" ]
    }
  },
  {
    "type": "mapgen",
    "method": "json",
    "om_terrain": "pool_5",
    "//": "Outdoor pool",
    "object": {
      "rows": [
        "ssssssssssssssssssssssss",
        " ______________________ ",
        " ___n__n__n__n__n__n___ ",
        " __wwwwwwwwwwwwwwwwww__ ",
        " __wwwwwwwwwwwwwwwwww__ ",
        " __wwwwwwwwwwwwwwwwww__ ",
        " __wwwwwwwwwwwwwwwwww__ ",
        " __wwwwwwwwwwwwwwwwww__ ",
        " __wwwwwwwwwwwwwwwwww__ ",
        " __wwwwwwwwwwwwwwwwww__ ",
        " __wwwwwwwwwwwwwwwwww__ ",
        " __wwwwwwwwwwwwwwwwww__ ",
        " __wwwwwwwwwwwwwwwwww__ ",
        " __wwwwwwwwwwwwwwwwww__ ",
        " __wwwwwwwwwwwwwwwwww__ ",
        " __wwwwwwwwwwwwwwwwww__ ",
        " __wwwwwwwwwwwwwwwwww__ ",
        " __wwwwwwwwwwwwwwwwww__ ",
        " __wwwwwwwwwwwwwwwwww__ ",
        " __wwwwwwwwwwwwwwwwww__ ",
        " __wwwwwwwwwwwwwwwwww__ ",
        " ___n__n__n__n__n__n___ ",
        " ______________________ ",
        "                        "
      ],
      "terrain": { "_": "t_concrete", " ": "t_region_groundcover_urban", "n": "t_concrete", "w": "t_water_pool", "s": "t_sidewalk" },
      "furniture": { "n": "f_dive_block" },
      "place_monster": [ { "group": "GROUP_MAPGEN_POOL", "x": [ 5, 18 ], "y": [ 5, 18 ], "repeat": [ 2, 6 ] } ]
    }
  },
  {
    "type": "mapgen",
    "method": "json",
    "om_terrain": "pool_6",
    "//": "Outdoor pool",
    "object": {
      "rows": [
        "    ss                  ",
        " ---oo----------------- ",
        " -xx__xxxxxxxxxxxxxx__- ",
        " -____cc__cc__cc__cc__- ",
        " -____________________- ",
        " -______________WWW___- ",
        " -___wwwwwwwwwwwwwww__- ",
        " -c__wwwwwwwwwwwwwww__- ",
        " -c__wwwwwwwwwwwwwww__- ",
        " -___wwwwwwwwwwwwwww__- ",
        " -___wwwwwwwwwwwwwww__- ",
        " -___wwwwwwwwwwwwwww__- ",
        " -c__wwwwwwwwwwwwwww__- ",
        " -c__wwwwwwwwwwwwwww__- ",
        " -___wwwwwwwwwwwwwww__- ",
        " -___wwwwwwwwwwwwwww__- ",
        " -___wwwwwwwwwwwwwww__- ",
        " -c__wwwwwwwwwwwwwww__- ",
        " -c__wwwwwwwwwwwwwww__- ",
        " -___wwwwwwwwwwwwwww__- ",
        " -____________________- ",
        " -______________c_____- ",
        " ---------------------- ",
        "                        "
      ],
      "terrain": {
        "_": "t_concrete",
        "-": "t_chainfence",
        "x": "t_region_groundcover_urban",
        " ": "t_region_groundcover_urban",
        "W": "t_water_pool",
        "c": "t_concrete",
        "s": "t_sidewalk",
        "o": [ "t_chaingate_c", "t_chaingate_o" ],
        "w": "t_water_pool"
      },
      "furniture": { "c": "f_camp_chair", "n": "f_dive_block", "x": "f_region_flower_decorative" },
      "place_monster": [ { "group": "GROUP_MAPGEN_POOL", "x": [ 5, 18 ], "y": [ 5, 18 ], "repeat": [ 2, 6 ] } ]
    }
  }
]
