[
  {
    "type": "mapgen",
    "method": "json",
    "om_terrain": [ "craft_shop_2" ],
    "weight": 200,
    "object": {
      "fill_ter": "t_floor",
      "rows": [
        "____,____,____,____,____",
        "____,____,____,____,____",
        "____,____,____,____,____",
        "____,____,____,____,____",
        "____,____,____,____,____",
        "sssssssssss55sssssssssss",
        "ssssussssssb3sssssusssss",
        "s51|---+-|s55s|-+---|15s",
        "s11|.c..P-ssss-P..c.|11s",
        "s4||TC..B||<<||n..CT||4s",
        "s;|R.c..B||||||n..c.R|;s",
        "s;|B....B|t|SS|n....B|;s",
        "s;|B.nn..=wwww=..nn.n|4s",
        "s;|B....B||||||n....n|;s",
        "s4|B.....=L|L=......n|;s",
        "s;|||-+-|||||||-+-||||4s",
        "s;|E*******|QQQ***|nn|;s",
        "s4|**nh*nh*|Q*****|=||;s",
        "s;|**nh*nh*|Q*******q|;s",
        "s;|E******q|Q*qY*Y**q|;s",
        "s4|||||||=||||||+|||||4s",
        "s;__UU_____4|g_|_UU___;s",
        "s;_________2__________4s",
        "s;_________4__________;s"
      ],
      "terrain": {
        ".": "t_floor",
        "s": "t_sidewalk",
        "u": "t_sidewalk",
        "_": "t_pavement",
        "U": "t_pavement",
        ",": "t_pavement_y",
        ";": "t_grass",
        "H": "t_grass",
        "b": "t_grass",
        "1": "t_shrub_hydrangea",
        "2": "t_tree_walnut",
        "3": "t_tree_apple",
        "4": "t_underbrush",
        "5": "t_grass",
        "-": "t_wall_glass",
        "|": "t_brick_wall",
        "+": "t_door_glass_c",
        "=": "t_door_c",
        "S": "t_linoleum_gray",
        "w": "t_linoleum_gray",
        "t": "t_linoleum_gray",
        "C": "t_console_broken",
        "*": "t_thconc_floor",
        "Q": "t_thconc_floor",
        "Y": "t_thconc_floor",
        "A": "t_thconc_floor",
        "q": "t_thconc_floor",
        "E": "t_thconc_floor",
        "h": "t_thconc_floor",
        "g": "t_ladder_up",
        "<": "t_stairs_up"
      },
      "furniture": {
        "H": "f_bench",
        "S": "f_sink",
        "T": "f_stool",
        "P": "f_indoor_plant",
        "B": "f_bookcase",
        "c": "f_counter",
        "n": "f_table",
        "h": "f_chair",
        "L": "f_locker",
        "R": "f_trashcan",
        "Y": "f_clay_kiln",
        "Q": "f_rack",
        "b": "f_birdbath",
        "q": "f_crate_c",
        "E": "f_mannequin",
        "U": "f_dumpster",
        "5": "f_flower_tulip",
        "u": "f_vending_reinforced"
      },
      "toilets": { "t": {  } },
      "place_items": [
        { "item": "sewing_group", "x": [ 8, 8 ], "y": [ 9, 11 ], "chance": 75, "repeat": [ 2, 10 ] },
        { "item": "sewing_group", "x": [ 3, 3 ], "y": [ 11, 14 ], "chance": 50, "repeat": [ 2, 10 ] },
        { "item": "sewing_group", "x": [ 5, 6 ], "y": [ 12, 12 ], "chance": 70, "repeat": [ 2, 10 ] },
        { "item": "sewing_group", "x": [ 5, 5 ], "y": [ 17, 18 ], "chance": 50, "repeat": [ 2, 10 ] },
        { "item": "sewing_group", "x": [ 8, 8 ], "y": [ 17, 18 ], "chance": 60, "repeat": [ 2, 10 ] },
        { "item": "sewing_group", "x": [ 10, 10 ], "y": [ 19, 19 ], "chance": 70, "repeat": [ 2, 10 ] },
        { "item": "pottery", "x": [ 15, 15 ], "y": [ 9, 11 ], "chance": 70, "repeat": [ 2, 10 ] },
        { "item": "pottery", "x": [ 17, 18 ], "y": [ 12, 12 ], "chance": 50, "repeat": [ 2, 10 ] },
        { "item": "pottery", "x": [ 20, 20 ], "y": [ 12, 14 ], "chance": 70, "repeat": [ 2, 10 ] },
        { "item": "pottery", "x": [ 15, 15 ], "y": [ 13, 13 ], "chance": 50, "repeat": [ 2, 10 ] },
        { "item": "pottery", "x": [ 19, 20 ], "y": [ 16, 16 ], "chance": 60, "repeat": [ 2, 10 ] },
        { "item": "pottery", "x": [ 12, 14 ], "y": [ 16, 16 ], "chance": 50, "repeat": [ 2, 10 ] },
        { "item": "ceramics_workroom", "x": [ 12, 12 ], "y": [ 17, 19 ], "chance": 70, "repeat": [ 2, 10 ] },
        { "item": "ceramics_workroom", "x": [ 14, 14 ], "y": [ 19, 19 ], "chance": 50, "repeat": [ 2, 10 ] },
        { "item": "ceramics_workroom", "x": [ 20, 20 ], "y": [ 18, 19 ], "chance": 70, "repeat": [ 2, 10 ] },
        { "item": "vending_food_items", "x": [ 4, 4 ], "y": [ 6, 6 ], "chance": 70, "repeat": [ 2, 10 ] },
        { "item": "vending_drink_items", "x": [ 18, 18 ], "y": [ 6, 6 ], "chance": 70, "repeat": [ 2, 10 ] },
        { "item": "cleaning", "x": [ 10, 10 ], "y": [ 14, 14 ], "chance": 60, "repeat": [ 2, 10 ] },
        { "item": "cleaning", "x": [ 12, 12 ], "y": [ 14, 14 ], "chance": 50, "repeat": [ 2, 10 ] },
        { "item": "trash", "x": [ 3, 3 ], "y": [ 10, 10 ], "chance": 60, "repeat": [ 2, 10 ] },
        { "item": "trash", "x": [ 12, 12 ], "y": [ 10, 10 ], "chance": 70, "repeat": [ 2, 10 ] },
        { "item": "trash", "x": [ 4, 5 ], "y": [ 21, 21 ], "chance": 50, "repeat": [ 2, 10 ] },
        { "item": "trash", "x": [ 4, 5 ], "y": [ 21, 21 ], "chance": 50, "repeat": [ 2, 10 ] },
        { "item": "trash", "x": [ 11, 11 ], "y": [ 21, 23 ], "chance": 70, "repeat": [ 2, 10 ] }
      ],
      "place_monsters": [ { "monster": "GROUP_ZOMBIE", "x": [ 2, 21 ], "y": [ 2, 21 ], "chance": 2 } ]
    }
  },
  {
    "type": "mapgen",
    "method": "json",
    "om_terrain": "craft_shop_2ndfloor_2",
    "object": {
      "fill_ter": "t_floor",
      "rows": [
        "                        ",
        "                        ",
        "                        ",
        "                        ",
        "                        ",
        "                        ",
        "                        ",
        "   |--|--|    |--|--|   ",
        "   |Cttty-    -U.C.t|   ",
        "  ||.....||>>||U...t||  ",
        "  |B.UUU.t|..|yU..CyB|  ",
        "  0B......|++|......B0  ",
        "  |.a..a..|..|...a.a.|  ",
        "  0ccccc..+..+..ccccc0  ",
        "  |.......||||.......|  ",
        "  |fcoSc.y|&.+..fcoSc|  ",
        "  ||||||+||S9||+||||||  ",
        "  |y.....A||||B...t@@|  ",
        "  |.@@..h.+.&|B.h..@@|  ",
        "  |t@@.yII|9S|yIIy..A|  ",
        "  ||0|||0||||||0|||0||  ",
        "        ##2##1##        ",
        "                        ",
        "                        "
      ],
      "terrain": {
        ".": "t_floor",
        "|": "t_brick_wall",
        "+": "t_door_locked",
        "-": "t_wall_glass",
        "0": "t_window_domestic",
        "#": "t_grate",
        "1": "t_ladder_down",
        "2": "t_ladder_up",
        " ": "t_open_air",
        ">": "t_stairs_down"
      },
      "toilets": { "&": {  } },
      "furniture": {
        "@": "f_bed",
        "o": "f_oven",
        "f": "f_fridge",
        "S": "f_sink",
        "U": "f_sofa",
        "t": "f_table",
        "c": "f_counter",
        "h": "f_chair",
        "I": "f_desk",
        "C": "f_armchair",
        "A": "f_wardrobe",
        "a": "f_stool",
        "9": "f_shower",
        "B": "f_bookcase",
        "y": [ "f_indoor_plant_y", "f_indoor_plant" ]
      },
      "items": {
        "@": { "item": "bed", "chance": 40, "repeat": [ 1, 2 ] },
        "y": { "item": "trash", "chance": 5 },
        "o": { "item": "oven", "chance": 50, "repeat": [ 1, 2 ] },
        "c": { "item": "kitchen", "chance": 40 },
        "f": { "item": "fridge", "chance": 50, "repeat": [ 2, 4 ] },
        "I": { "item": "office", "chance": 30 },
        "A": { "item": "allclothes", "chance": 60, "repeat": [ 2, 4 ] },
        "9": { "item": "softdrugs", "chance": 60, "repeat": [ 1, 2 ] },
        "S": { "item": "shower", "chance": 60, "repeat": [ 1, 2 ] },
        "B": { "item": "homebooks", "chance": 60, "repeat": [ 1, 2 ] }
      }
    }
  },
  {
    "type": "mapgen",
    "method": "json",
    "om_terrain": "craft_shop_roof_2",
    "object": {
      "fill_ter": "t_tile_flat_roof",
      "rows": [
        "                        ",
        "                        ",
        "                        ",
        "                        ",
        "                        ",
        "                        ",
        "                        ",
        "   %%%%%%%    %%%%%%%   ",
        "   %.....%    %.....%   ",
        "  %%.J...%%oo%%.J...%%  ",
        "  %.......%oo%.......%  ",
        "  %.......%%%%.......%  ",
        "  %..................%  ",
        "  %.U......bb.Z......%  ",
        "  %........bb........%  ",
        "  %........bb........%  ",
        "  %..................%  ",
        "  %........bb........%  ",
        "  %........bb........%  ",
        "  %..................%  ",
        "  %%%%%%########%%%%%%  ",
        "        ##1#####        ",
        "                        ",
        "                        "
      ],
      "palettes": [ "roof_palette" ],
      "terrain": {
        ".": "t_tile_flat_roof",
        "U": "t_tile_flat_roof",
        "Z": "t_tile_flat_roof",
        "J": "t_tile_flat_roof",
        "%": "t_glass_railing",
        "1": "t_ladder_down"
      },
      "nested": {
        "U": {
          "chunks": [
            [ "roof_6x6_greenhouse_1", 20 ],
            [ "roof_6x6_greenhouse_2", 20 ],
            [ "roof_6x6_garden_3", 20 ],
            [ "roof_6x6_garden_1", 20 ],
            [ "roof_6x6_garden_2", 20 ]
          ]
        },
        "Z": {
          "chunks": [
            [ "roof_5x5_coop", 20 ],
            [ "roof_6x6_survivor", 20 ],
            [ "roof_4x4_utility_1", 20 ],
            [ "roof_4x4_holdout", 20 ],
            [ "roof_6x6_garden_3", 20 ]
          ]
        },
        "J": {
          "chunks": [
            [ "null", 20 ],
            [ "roof_2x2_utilities_b", 15 ],
            [ "roof_2x2_utilities_c", 5 ],
            [ "roof_2x2_utilities_d", 40 ],
            [ "roof_2x2_utilities", 50 ],
            [ "roof_2x2_golf", 20 ],
            [ "roof_3x3_wine", 30 ]
          ]
        }
      }
    }
  }
]
