[
    {
        "type" : "mapgen",
        "om_terrain" : ["pwr_large_entrance"],
        "method": "json",
        "weight": 10,
        "object": {
        "fill_ter": "t_concrete",
            "rows": [
            "  |     x--------------|",
            "  |     |              |",
            " T|  T  |  ThB         |",
            "  |     |         {Bh} |",
            "  |     |     T  s8    |",
            "  |     |              |", 
            "  |     |         {Bh} |",
            "  |     |     T  s8    |",
            "  |     |              |",
            "  |     |         {Bh} |",
            "  |     |     T  s8    |",
            "  |     |              |",
            "  +     x----------+---|",
            "  |                    |",
            "  |                    |",
            "  |                    |",
            "wwwwWWWWwwww           |",
            "CCCCCccccccv           |",
            "***********d           |",
            "***********v       x-+-|",
            "***********v       |   |",
            "wwwwWWWWwwww       |   |",
            "  |                |   |",
            "-------------------x-+-x"
            ],
            "terrain": {
            " ": "t_concrete",
            "-": "t_chainfence_h",
            "|": "t_chainfence_v",
            "x": "t_chainfence_posts",
            "+": "t_chaingate_c",
            "T": "t_pwr_sb_support_l",
            "B": "t_oil_circ_brkr_l",
            "s": "t_pwr_sb_switchgear_s",
            "w": "t_wall_h",
            "v": "t_wall_v",
            "d": "t_door_locked",
            "C": "t_console_broken",
            "*": "t_floor",
            "c": "t_floor",
            "}": "t_lgtn_arrest",
            "h": "t_station_disc",
            "{": "t_current_trans",
            "8": "t_potential_trans",
            "W": "t_window"
            },
            "furniture": {
            "c": "f_counter"
            }
        }
    },{
        "type" : "mapgen",
        "om_terrain" : ["pwr_large_2"],
        "method": "json",
        "weight": 10,
        "object": {
        "fill_ter": "t_concrete",
            "rows": [
            "|         |             ",
            "|         |         888 ",
            "|       T | T   hST 888 ",
            "|         |         888 ",
            "|         |             ",
            "|         |             ",
            "|         |             ",
            "|         |             ",
            "|         |             ",
            "|         |             ",
            "|         |             ",
            "|         |             ",
            "|         |             ",
            "|         |             ",
            "|         |             ",
            "|         |             ",
            "|         |     wwwwWWWW",
            "|         |     vccccccC",
            "|         +     d*******",
            "|         |     v*******",
            "|         |     v*******",
            "|         |     wwwwWWWW",
            "|         |             ",
            "x-----------------------"
            ],
            "terrain": {
            " ": "t_concrete",
            "-": "t_chainfence_h",
            "|": "t_chainfence_v",
            "x": "t_chainfence_posts",
            "+": "t_chaingate_c",
            "T": "t_pwr_sb_support_l",
            "S": "t_pwr_sb_switchgear_l",
            "w": "t_wall_h",
            "v": "t_wall_v",
            "d": "t_door_locked",
            "C": "t_console_broken",
            "*": "t_floor",
            "c": "t_floor",
            "h": "t_station_disc",
            "8": "t_potential_trans",
            "W": "t_window"
            },
            "furniture": {
            "c": "f_counter"
            }
        }
    },{
        "type" : "mapgen",
        "om_terrain" : ["pwr_large_3"],
        "method": "json",
        "weight": 10,
        "object": {
        "fill_ter": "t_concrete",
            "rows": [
            "x-----------------------",
            "|         |             ",
            "|    }    |             ",
            "|    h    |             ",
            "|    B    |             ",
            "|    {    |             ",
            "|    h    |             ",
            "|    T    |             ",
            "|         |             ",
            "|         |             ",
            "|         |             ",
            "|    T    |             ",
            "|    {B   |             ",
            "|   S8    |             ",
            "|         |             ",
            "|    T    |             ",
            "|         |             ",
            "|         |         888 ",
            "|       T | T   hST 888 ",   
            "|         |         888 ",
            "|         |             ",
            "|         |             ",
            "|       T |             ",
            "|         |             "
            ],
            "terrain": {
            " ": "t_concrete",
            "-": "t_chainfence_h",
            "|": "t_chainfence_v",
            "x": "t_chainfence_posts",
            "T": "t_pwr_sb_support_l",
            "B": "t_oil_circ_brkr_l",
            "S": "t_pwr_sb_switchgear_l",
            "}": "t_lgtn_arrest",
            "h": "t_station_disc",
            "{": "t_current_trans",
            "8": "t_potential_trans"
            }
        }
    },{
        "type" : "mapgen",
        "om_terrain" : ["pwr_large_4"],
        "method": "json",
        "weight": 10,
        "object": {
        "fill_ter": "t_concrete",
            "rows": [
            "-----------------------x",
            "  |     |              |",
            "  |     |  }    }   }  |",
            "  |     |  h    h   h  |",
            "  |     |  B    B   B  |",
            "  |     |  {8  8{  8{  |",
            "  |     |   s  s   s   |",
            "  |     |              |",
            "  |     |   T      T   |",
            "  |     |      hB      |",
            "  |     |      T       |",
            "  |     |              |",
            "  |     x----------+---|",
            "  |                    |",
            "  |            T       |",
            "  |                    |",
            "  |                    |",
            "  |                    |",
            " T|  T    T    T       |",
            "  |                    |",
            "  |                    |",
            "  |                    |",
            "  |                    |",
            "  |                    |"
            ],
            "terrain": {
            " ": "t_concrete",
            "-": "t_chainfence_h",
            "|": "t_chainfence_v",
            "x": "t_chainfence_posts",
            "+": "t_chaingate_c",
            "T": "t_pwr_sb_support_l",
            "B": "t_oil_circ_brkr_l",
            "s": "t_pwr_sb_switchgear_s",
            "}": "t_lgtn_arrest",
            "h": "t_station_disc",
            "{": "t_current_trans",
            "8": "t_potential_trans"
            }
        }
    }
]
