[
  {
    "type": "mapgen",
    "method": "json",
    "om_terrain": [ [ "pwr_large_3", "pwr_large_4" ], [ "pwr_large_2", "pwr_large_entrance" ] ],
    "object": {
      "fill_ter": "t_linoleum_white",
      "rows": [
        "------------------------------------------------",
        "-         -               -     -              -",
        "-    }    -               -     -  }    }   }  -",
        "-    h    -               -     -  h    h   h  -",
        "-    B    -               -     -  B    B   B  -",
        "-    {    -               -     -  {8  8{  8{  -",
        "-    h    -               -     -   s  s   s   -",
        "-    T    -               -     -              -",
        "-         -               -     -   T      T   -",
        "-         -               -     -      hB      -",
        "-         -               -     -      T       -",
        "-    T    -               -     -              -",
        "-    {B   -               -     -----------+----",
        "-   S8    -               -                    -",
        "-         -               -            T       -",
        "-    T    -               -                    -",
        "-         -               -                    -",
        "-         -         888   -                    -",
        "-       T - T   hST 888  T-  T    T    T       -",
        "-         -         888   -                    -",
        "-         -               -                    -",
        "-         -               -                    -",
        "-       T -               -                    -",
        "-         -               -                    -",
        "-         -               -     ----------------",
        "-         -         888   -     -              -",
        "-       T - T   hST 888  T-  T  -  ThB         -",
        "-         -         888   -     -         {Bh} -",
        "-         -               -     -     T  s8    -",
        "-         -               -     -              -",
        "-       i -      i        -     -         {Bh} -",
        "-         -               -     -     T  s8    -",
        "-         -               -     -              -",
        "-         -               -     -         {Bh} -",
        "-         -               -     -     T  s8    -",
        "-         -      i        -     -              -",
        "-         -               +     -----------+----",
        "-         -               -                    -",
        "-         -             i -           i        -",
        "-         -               -                    -",
        "-         -     ||||oooo||||oooo||||           -",
        "-         -     |ccccccCCCCCCcccccc|           -",
        "-         +     d.........a........d           -",
        "-         -     ||d|..a........a...|       --+--",
        "-         -     |&$|.....kkk..III..|4      -   -",
        "-         -     ||||oooo||||oooo||||  i    -   -",
        "-         -               -                -   -",
        "---------------------------------------------+--"
      ],
      "terrain": {
        " ": "t_concrete",
        "i": "t_concrete",
        "h": "t_station_disc",
        "s": "t_switchgear_s",
        "{": "t_current_trans",
        "}": "t_lgtn_arrest",
        "8": "t_potential_trans",
        "B": "t_oil_circ_brkr_l",
        "T": "t_support_l",
        "S": "t_switchgear_l",
        "-": "t_chainfence",
        "+": "t_chaingate_c",
        "o": "t_window",
        "d": "t_door_locked",
        "|": "t_wall_b",
        ".": "t_linoleum_white",
        "4": "t_gutter_downspout"
      },
      "furniture": {
        "c": "f_counter",
        "C": "f_console_broken",
        "a": "f_stool",
        "I": "f_desk",
        "$": "f_sink",
        "k": "f_filing_cabinet",
        "i": "f_utility_pole"
      },
      "items": {
        "I": { "item": "SUS_office_desk", "chance": 33 },
        "k": { "item": "SUS_office_filing_cabinet", "chance": 33 },
        "$": { "item": "softdrugs", "chance": 30 }
      },
      "place_loot": [
        { "group": "supplies_electronics", "x": [ 17, 22 ], "y": 41, "chance": 60, "repeat": [ 1, 3 ] },
        { "group": "tools_lighting_industrial", "x": [ 17, 22 ], "y": 41, "chance": 30, "repeat": [ 1, 2 ] },
        { "group": "tools_common", "x": [ 17, 22 ], "y": 41, "chance": 50, "repeat": [ 1, 3 ] },
        { "group": "clothing_work_set", "x": [ 17, 22 ], "y": 41, "chance": 35 },
        { "group": "supplies_electronics", "x": [ 29, 34 ], "y": 41, "chance": 60, "repeat": [ 1, 3 ] },
        { "group": "tools_lighting_industrial", "x": [ 29, 34 ], "y": 41, "chance": 30, "repeat": [ 1, 2 ] },
        { "group": "tools_common", "x": [ 29, 34 ], "y": 41, "chance": 50, "repeat": [ 1, 3 ] },
        { "group": "clothing_work_set", "x": [ 29, 34 ], "y": 41, "chance": 35 }
      ],
      "toilets": { "&": {  } }
    }
  },
  {
    "type": "mapgen",
    "method": "json",
    "om_terrain": [ [ "pwr_large_2_roof", "pwr_large_entrance_roof" ] ],
    "object": {
      "fill_ter": "t_tar_flat_roof",
      "rows": [
        "                                                ",
        "                                                ",
        "                                                ",
        "                                                ",
        "                                                ",
        "                                                ",
        "                                                ",
        "                                                ",
        "                                                ",
        "                                                ",
        "                                                ",
        "                                                ",
        "                                                ",
        "                                                ",
        "                                                ",
        "                                                ",
        "                --------------------            ",
        "                -..................-            ",
        "                -..................-            ",
        "                -.........&....A...-            ",
        "                -.=................5            ",
        "                --------------------            ",
        "                                                ",
        "                                                "
      ],
      "palettes": [ "roof_palette" ],
      "terrain": { ".": "t_tar_flat_roof" }
    }
  }
]
