[
  {
    "type": "mapgen",
    "method": "json",
    "om_terrain": "recyclecenter",
    "object": {
      "fill_ter": "t_thconc_floor",
      "furniture": { "&": "f_trashcan", "P": "f_sign", "c": "f_chair", "d": "f_desk", "t": "f_table", "{": "f_recycle_bin", "S": "f_sink" },
      "items": { "T": { "item": "SUS_toilet", "chance": 50 } },
      "toilets": { "T": {  } },
      "place_items": [
        { "chance": 50, "repeat": [ 120, 220 ], "item": "recycle_iron", "x": [ 10, 14 ], "y": [ 15, 16 ] },
        { "chance": 50, "repeat": [ 50, 120 ], "item": "recycle_electronic", "x": [ 18, 19 ], "y": [ 12, 14 ] },
        { "chance": 50, "repeat": [ 160, 400 ], "item": "recycle_paper", "x": [ 4, 5 ], "y": [ 11, 19 ] },
        { "chance": 50, "repeat": [ 80, 180 ], "item": "recycle_copper", "x": [ 10, 14 ], "y": [ 12, 13 ] },
        { "chance": 50, "repeat": [ 30, 100 ], "item": "recycle_battery", "x": [ 18, 19 ], "y": [ 17, 19 ] },
        { "chance": 50, "repeat": [ 80, 180 ], "item": "recycle_glass", "x": [ 18, 19 ], "y": [ 7, 9 ] },
        { "chance": 50, "repeat": [ 150, 250 ], "item": "recycle_steel", "x": [ 10, 14 ], "y": [ 18, 19 ] },
        { "chance": 75, "item": "SUS_office_mess", "x": 6, "y": 7 },
        { "chance": 75, "item": "SUS_office_mess", "x": 3, "y": 7 },
        { "chance": 35, "repeat": 2, "item": "SUS_trash_trashcan", "x": 3, "y": 5 },
        { "chance": 50, "repeat": [ 80, 180 ], "item": "recycle_aluminum", "x": [ 10, 14 ], "y": [ 9, 10 ] },
        { "chance": 50, "repeat": [ 180, 350 ], "item": "recycle_plastic", "x": [ 7, 8 ], "y": [ 11, 19 ] }
      ],
      "rows": [
        "         s              ",
        "         s              ",
        "         s              ",
        "         s              ",
        "  #w#+###+###w##w#####  ",
        "  #&fff|______RR_____#  ",
        "  #fcffD__________P__#  ",
        "###ddft|__________{{_#  ",
        "#T||||||__________{{_#  ",
        "#_D_______{{{{{P__{{_#  ",
        "#S|__P__P_{{{{{______#  ",
        "###_{{_{{_________P__#  ",
        " 4#_{{_{{_{{{{{P__{{_#  ",
        "  #_{{_{{_{{{{{___{{_#  ",
        "  #_{{_{{_________{{_#  ",
        "  #_{{_{{_{{{{{P_____#  ",
        "  #_{{_{{_{{{{{___P__#  ",
        "  #_{{_{{_________{{_#  ",
        "  #_{{_{{_{{{{{P__{{_#  ",
        "  #_{{_{{_{{{{{___{{_#  ",
        "  #__________________#  ",
        "  ###############+####  ",
        "                        ",
        "                        "
      ],
      "palettes": [ "parametrized_walls_palette" ],
      "terrain": {
        "&": "t_floor",
        "+": "t_door_metal_c",
        " ": "t_region_groundcover_urban",
        "D": "t_door_c",
        "_": "t_thconc_floor",
        "c": "t_floor",
        "R": "t_recycler",
        "d": "t_floor",
        "f": "t_floor",
        "s": "t_sidewalk",
        "t": "t_floor",
        "w": "t_window",
        "4": "t_gutter_downspout"
      },
      "place_signs": [
        { "signage": "GLASS", "x": 18, "y": 6 },
        { "signage": "ALUMINUM", "x": 15, "y": 9 },
        { "signage": "PAPER", "x": 5, "y": 10 },
        { "signage": "PLASTIC", "x": 8, "y": 10 },
        { "signage": "ELECTRONICS", "x": 18, "y": 11 },
        { "signage": "COPPER", "x": 15, "y": 12 },
        { "signage": "IRON", "x": 15, "y": 15 },
        { "signage": "BATTERIES", "x": 18, "y": 16 },
        { "signage": "STEEL", "x": 15, "y": 18 }
      ]
    }
  },
  {
    "type": "mapgen",
    "method": "json",
    "om_terrain": "recyclecenter_roof",
    "object": {
      "fill_ter": "t_flat_roof",
      "rows": [
        "                        ",
        "                        ",
        "                        ",
        "                        ",
        "  --------------------  ",
        "  -..................-  ",
        "  -..................-  ",
        "---..................-  ",
        "-....................-  ",
        "-.U..................-  ",
        "-....................-  ",
        "--5..................-  ",
        "  -..................-  ",
        "  -..................-  ",
        "  -..................-  ",
        "  -..................-  ",
        "  -..................-  ",
        "  -..................-  ",
        "  -..................-  ",
        "  -...............R..-  ",
        "  -..................-  ",
        "  --------------------  ",
        "                        ",
        "                        "
      ],
      "palettes": [ "roof_palette" ],
      "nested": { "U": { "chunks": [ "roof_2x2_infrastructure" ] }, "R": { "chunks": [ "roof_2x2_infrastructure_1" ] } },
      "place_nested": [
        {
          "chunks": [
            [ "null", 20 ],
            [ "roof_2x2_utilities_b", 15 ],
            [ "roof_2x2_utilities_c", 5 ],
            [ "roof_2x2_utilities_d", 40 ],
            [ "roof_2x2_utilities", 50 ]
          ],
          "x": [ 5, 15 ],
          "y": [ 7, 15 ]
        }
      ]
    }
  },
  {
    "method": "json",
    "object": {
      "fill_ter": "t_thconc_floor",
      "furniture": {
        "A": "f_table",
        "&": "f_trashcan",
        "C": "f_chair",
        "P": "f_sign",
        "S": "f_sign",
        "a": "f_desk",
        "b": "f_bench",
        "d": "f_recycle_bin",
        "s": "f_sign",
        "{": "f_recycle_bin",
        "Á": "f_sink"
      },
      "place_items": [
        { "chance": 50, "repeat": [ 20, 60 ], "item": "recycle_copper", "x": [ 8, 9 ], "y": 19 },
        { "chance": 50, "repeat": [ 80, 220 ], "item": "recycle_plastic", "x": [ 4, 5 ], "y": [ 6, 11 ] },
        { "chance": 50, "repeat": [ 80, 220 ], "item": "recycle_iron", "x": [ 8, 9 ], "y": [ 6, 11 ] },
        { "chance": 30, "repeat": 2, "item": "SUS_trash_trashcan", "x": 12, "y": 7 },
        { "chance": 30, "repeat": 2, "item": "SUS_trash_trashcan", "x": 13, "y": 5 },
        { "chance": 50, "repeat": [ 100, 350 ], "item": "recycle_paper", "x": [ 18, 19 ], "y": [ 9, 19 ] },
        { "chance": 50, "repeat": [ 20, 120 ], "item": "recycle_battery", "x": [ 13, 15 ], "y": [ 18, 19 ] },
        { "chance": 25, "item": "office", "x": 14, "y": 5 },
        { "chance": 25, "item": "office", "x": 12, "y": 5 },
        { "chance": 50, "repeat": [ 80, 250 ], "item": "recycle_steel", "x": [ 4, 5 ], "y": [ 14, 19 ] },
        { "chance": 50, "repeat": [ 20, 100 ], "item": "recycle_aluminum", "x": [ 8, 9 ], "y": [ 14, 15 ] },
        { "chance": 50, "repeat": [ 20, 120 ], "item": "recycle_electronic", "x": [ 13, 15 ], "y": [ 14, 15 ] },
        { "chance": 50, "repeat": [ 20, 150 ], "item": "recycle_glass", "x": [ 13, 15 ], "y": [ 10, 11 ] }
      ],
      "place_vehicles": [ { "chance": 75, "fuel": 0, "rotation": 270, "status": -1, "vehicle": "forklift_vehicles", "x": 16, "y": [ 7, 16 ] } ],
      "rows": [
        "     cccc               ",
        "     cccc               ",
        "     cccc               ",
        "  ---S++S--###ww##D#w#  ",
        "  -ccccccccwC_______b#  ",
        "  -ccPccPcc#a&AA____b###",
        "  -c{{cc{{c#||||____b|T#",
        "  -c{{cc{{c#&RAR_____=_#",
        "  -c{{cc{{c#A_____s__|Á#",
        "  -c{{cc{{c#___s__dd_###",
        "  -c{{cc{{c#_ddd__dd_#4 ",
        "  -c{{cc{{c#_ddd__dd_#  ",
        "  -cccccccc#______dd_#  ",
        "  -ccPccPcc#___s__dd_#  ",
        "  -c{{cc{{c#_ddd__dd_#  ",
        "  -c{{cc{{c#_ddd__dd_#  ",
        "  -c{{ccccc_______dd_#  ",
        "  -c{{ccccc_______dd_#  ",
        "  -c{{ccPcc__ddds_dd_#  ",
        "  -c{{cc{{c__ddd__dd_#  ",
        "  -cccccccc#_________#  ",
        "  ---------###########  ",
        "                        ",
        "                        "
      ],
      "palettes": [ "parametrized_walls_palette" ],
      "terrain": {
        "+": "t_chaingate_c",
        "-": "t_chainfence",
        " ": "t_region_groundcover_urban",
        "D": "t_door_metal_c",
        "P": "t_concrete",
        "S": "t_chainfence",
        "_": "t_thconc_floor",
        "R": "t_recycler",
        "c": "t_concrete",
        "w": "t_window",
        "{": "t_concrete",
        "4": "t_gutter_downspout",
        "=": "t_door_c"
      },
      "items": { "T": { "item": "SUS_toilet", "chance": 50 } },
      "toilets": { "T": {  } },
      "place_signs": [
        { "signage": "GLASS", "x": 15, "y": 9 },
        { "signage": "ALUMINUM", "x": 8, "y": 13 },
        { "signage": "PAPER", "x": 18, "y": 8 },
        { "signage": "PLASTIC", "x": 5, "y": 5 },
        { "signage": "ELECTRONICS", "x": 15, "y": 13 },
        { "signage": "COPPER", "x": 8, "y": 18 },
        { "signage": "IRON", "x": 8, "y": 5 },
        { "signage": "BATTERIES", "x": 16, "y": 18 },
        { "signage": "STEEL", "x": 5, "y": 13 },
        { "signage": "<given_name>'s Recycling", "x": 8, "y": 3 },
        { "signage": "Drop off 7am to 6pm Monday thru Friday", "x": 11, "y": 3 }
      ]
    },
    "om_terrain": "recyclecenter_1",
    "type": "mapgen"
  },
  {
    "type": "mapgen",
    "method": "json",
    "om_terrain": "recyclecenter_roof_1",
    "object": {
      "fill_ter": "t_flat_roof",
      "rows": [
        "                        ",
        "                        ",
        "                        ",
        "           -----------  ",
        "           -.........-  ",
        "           -.R.......---",
        "           -...........-",
        "           -.........U.-",
        "           -...........-",
        "           -.........---",
        "           -.........5  ",
        "           -.........-  ",
        "           -.........-  ",
        "           -.........-  ",
        "           -.........-  ",
        "           -.........-  ",
        "           -.........-  ",
        "           -.........-  ",
        "           -.........-  ",
        "           -.........-  ",
        "           -.........-  ",
        "           -----------  ",
        "                        ",
        "                        "
      ],
      "palettes": [ "roof_palette" ],
      "nested": { "U": { "chunks": [ "roof_2x2_infrastructure" ] }, "R": { "chunks": [ "roof_2x2_infrastructure_1" ] } },
      "place_nested": [
        {
          "chunks": [
            [ "null", 20 ],
            [ "roof_2x2_utilities_b", 15 ],
            [ "roof_2x2_utilities_c", 5 ],
            [ "roof_2x2_utilities_d", 40 ],
            [ "roof_2x2_utilities", 50 ]
          ],
          "x": [ 13, 15 ],
          "y": [ 7, 17 ]
        }
      ]
    }
  },
  {
    "method": "json",
    "object": {
      "fill_ter": "t_thconc_floor",
      "furniture": {
        "#": "f_counter",
        "&": "f_trashcan",
        "P": "f_sign",
        "c": "f_chair",
        "d": "f_desk",
        "s": "f_sign",
        "{": "f_recycle_bin",
        "S": "f_sink"
      },
      "items": { "T": { "item": "SUS_toilet", "chance": 50 } },
      "toilets": { "T": {  } },
      "place_items": [
        { "chance": 15, "item": "office", "x": [ 4, 5 ], "y": 14 },
        { "chance": 30, "item": "SUS_trash_trashcan", "x": 3, "y": 14 },
        { "chance": 20, "item": "tools_home", "x": 3, "y": [ 19, 20 ] },
        { "chance": 50, "repeat": [ 80, 280 ], "item": "recycle_plastic", "x": [ 15, 16 ], "y": [ 7, 12 ] },
        { "chance": 50, "repeat": [ 80, 280 ], "item": "recycle_glass", "x": [ 19, 20 ], "y": [ 7, 12 ] },
        { "chance": 50, "repeat": [ 80, 350 ], "item": "recycle_paper", "x": [ 3, 9 ], "y": [ 7, 8 ] },
        { "chance": 50, "repeat": [ 30, 150 ], "item": "recycle_electronic", "x": [ 3, 5 ], "y": [ 10, 11 ] },
        { "chance": 50, "repeat": [ 20, 120 ], "item": "recycle_battery", "x": [ 8, 9 ], "y": [ 10, 11 ] },
        { "chance": 50, "repeat": [ 80, 350 ], "item": "recycle_iron", "x": [ 9, 15 ], "y": [ 15, 16 ] },
        { "chance": 50, "repeat": [ 80, 350 ], "item": "recycle_steel", "x": [ 9, 15 ], "y": [ 19, 20 ] },
        { "chance": 50, "repeat": [ 50, 180 ], "item": "recycle_aluminum", "x": [ 18, 20 ], "y": [ 15, 16 ] },
        { "chance": 50, "repeat": [ 50, 180 ], "item": "recycle_copper", "x": [ 18, 20 ], "y": [ 19, 20 ] }
      ],
      "place_loot": [ { "item": "television", "x": 4, "y": 14, "chance": 100 }, { "item": "stepladder", "x": 8, "y": 13, "chance": 100 } ],
      "rows": [
        "          ppppp         ",
        "          ppppp         ",
        "      4   ppppp     7   ",
        " 4        ppppp         ",
        "         sppppps        ",
        " |||||||||+++++|||||||| ",
        " |....................| ",
        " |.{{{{{{{P....{{..{{.| ",
        " |.{{{{{{{.....{{..{{.| ",
        " |.............{{..{{.| ",
        " |.{{{P.{{P....{{..{{.| ",
        " |.{{{..{{.....{{..{{.| ",
        " |............P{{.P{{.| ",
        " |--ww--..............| ",
        " |-&ddtD..........P...| ",
        " |wtctt-.{{{{{{{P.{{{.| ",
        " |wttttw.{{{{{{{..{{{.| ",
        " |---tt-..............| ",
        " |-&-tt-..........P...| ",
        " |-tDtt-.{{{{{{{P.{{{.| ",
        " |-T-RR-.{{{{{{{..{{{.| ",
        " |------..............| ",
        " |||||||||||||||||||||| ",
        "                        "
      ],
      "terrain": {
        "+": "t_chaingate_c",
        "-": "t_concrete_wall",
        ".": "t_concrete",
        "4": "t_region_tree_evergreen",
        "7": "t_region_tree",
        "D": "t_door_c",
        "P": "t_concrete",
        "R": "t_recycler",
        " ": "t_region_groundcover_urban",
        "p": "t_pavement",
        "s": "t_region_groundcover_urban",
        "t": "t_thconc_floor",
        "w": "t_window",
        "{": "t_concrete",
        "|": "t_chainfence",
        "5": "t_gutter_downspout"
      },
      "place_signs": [
        { "signage": "GLASS", "x": 18, "y": 12 },
        { "signage": "ALUMINUM", "x": 18, "y": 14 },
        { "signage": "PAPER", "x": 10, "y": 7 },
        { "signage": "PLASTIC", "x": 14, "y": 12 },
        { "signage": "ELECTRONICS", "x": 6, "y": 10 },
        { "signage": "COPPER", "x": 18, "y": 18 },
        { "signage": "IRON", "x": 16, "y": 15 },
        { "signage": "BATTERIES", "x": 10, "y": 10 },
        { "signage": "STEEL", "x": 16, "y": 19 },
        { "signage": "<city> Recycling", "x": 9, "y": 4 },
        { "signage": "Drop off 8am to 8pm, weekdays.", "x": 15, "y": 4 }
      ]
    },
    "om_terrain": "recyclecenter_2",
    "type": "mapgen"
  },
  {
    "type": "mapgen",
    "method": "json",
    "om_terrain": "recyclecenter_roof_2",
    "object": {
      "fill_ter": "t_tar_flat_roof",
      "rows": [
        "                        ",
        "                        ",
        "                        ",
        "                        ",
        "                        ",
        "                        ",
        "                        ",
        "                        ",
        "                        ",
        "                        ",
        "                        ",
        "                        ",
        "                        ",
        "  ......                ",
        "  ......                ",
        "  ......                ",
        "  ......                ",
        "  ......                ",
        "  ......                ",
        "  ......                ",
        "  ......                ",
        "  ......                ",
        "                        ",
        "                        "
      ],
      "palettes": [ "roof_palette" ],
      "terrain": { ".": "t_tar_flat_roof" }
    }
  }
]
