[
  {
    "type": "mapgen",
    "method": "json",
    "om_terrain": [ [ "shipwreck_river_1", "shipwreck_river_2" ] ],
    "object": {
      "fallback_predecessor_mapgen": "forest_water",
      "rows": [
        "                                CCCCCCCCC       ",
        "                       CCCCCCCCCCCCCC--CCC      ",
        "                  CCCCCCC####C#------#---CC     ",
        "           CCCCCCCCCCCCCC------#>-..@###--C     ",
        "       CCCC#C##CCCCc------@@..#@@+@@##CCCC      ",
        "    CCCC#####cccccc@3r..A-###..---####C --C     ",
        " # CCCCcccccc.....@.3r...-#@----#######-#CC     ",
        "  #CC##@@@..........3r...-+--..#@.---##CCC      ",
        " ##C#C#@.....6ee....--@-+-#####C---#####        ",
        " #CCCC#@.@@..@@@....@....#####C###  #- C-       ",
        "   CC#@c....@@##@@.c----###-#      ##C          ",
        " CC-CCc@@..@@CCCCcc##CC##  CCCC    CC           ",
        "   C#CC#cccc#CC   #      #---                   ",
        "    CCCCCCCCC-          #CCC                    ",
        "  C-       CC                                   ",
        "       C     ##                                 ",
        "      C  C- -                                   ",
        "         C CC                                   ",
        "                                                ",
        "                                                ",
        "                                                ",
        "                                                ",
        "                                                ",
        "                                                "
      ],
      "flags": [ "ERASE_ALL_BEFORE_PLACING_TERRAIN" ],
      "fill_ter": "t_metal_floor_no_roof",
      "terrain": {
        " ": [ [ "t_region_soil", 2 ], [ "t_region_groundcover", 1 ] ],
        "#": "t_region_soil",
        "@": "t_metal_floor_no_roof",
        ".": "t_metal_floor_no_roof",
        "6": "t_metal_floor_no_roof",
        "e": "t_metal_floor_no_roof",
        "r": "t_metal_floor_no_roof",
        "A": "t_metal_floor_no_roof",
        "+": "t_door_metal_c",
        "-": "t_wall_metal",
        "3": "t_window_frame",
        ">": "t_stairs_down",
        "C": "t_dirtmound",
        "c": "t_metal_railing"
      },
      "furniture": {
        "@": "f_wreckage",
        "#": "f_wreckage",
        "6": "f_machinery_light",
        "e": "f_machinery_heavy",
        "r": "f_console_broken",
        "A": "f_safe_l"
      },
      "place_loot": [ { "group": "guns_pistol_common", "x": 24, "y": 5, "chance": 70, "ammo": 95, "magazine": 100 } ],
      "place_monsters": [
        { "monster": "GROUP_RAZORCLAW", "x": [ 2, 21 ], "y": [ 2, 21 ], "density": 0.4 },
        { "monster": "GROUP_RAZORCLAW", "x": [ 26, 45 ], "y": [ 2, 21 ], "density": 0.4 }
      ]
    }
  },
  {
    "type": "mapgen",
    "method": "json",
    "om_terrain": [ [ "shipwreck_river_3", "shipwreck_river_4" ] ],
    "object": {
      "fill_ter": "t_metal_floor",
      "rows": [
        "................................................",
        ".....................................------.....",
        "...............................-------ee66---...",
        ".........................-------<~-A~~# 6###-...",
        "...................-------CC###-~~--##6e6~~#-...",
        ".............-------66e-CC###--~~~#+   ~ ~~--...",
        ".......-------~C~#~####-#~~~~~~#  C-9 eee##-....",
        ".....--## ~~C~ ~~~#~~#~#~##~-~~ #C#--------.....",
        ".....-#C###C~~~ #e#~~~~--~~~-C-------...........",
        "...--.-C###R~~~  ~~66ee--------.................",
        "......-###CC C~~~~-------.......................",
        "......#-####-------.............................",
        ".....--------...................................",
        "................................................",
        "................................................",
        "................................................",
        "................................................",
        "................................................",
        "................................................",
        "................................................",
        "................................................",
        "................................................",
        "................................................",
        "................................................"
      ],
      "terrain": {
        " ": "t_metal_floor",
        "+": "t_door_metal_c",
        "-": "t_wall_metal",
        ".": "t_soil",
        "C": "t_dirtmound",
        "<": "t_stairs_up",
        "~": "t_water_sh"
      },
      "furniture": {
        "6": "f_machinery_light",
        "e": "f_machinery_heavy",
        "r": "f_console_broken",
        "R": "f_active_backup_generator",
        "#": "f_wreckage",
        "9": "f_locker",
        "A": "f_standing_tank"
      },
      "items": {
        "C": { "item": "razorclaw_nest", "chance": 80 },
        "9": { "item": "hardware_plumbing", "chance": 90, "repeat": [ 1, 4 ] }
      },
      "place_monsters": [
        { "monster": "GROUP_RAZORCLAW", "x": [ 12, 21 ], "y": [ 5, 11 ], "density": 0.2 },
        { "monster": "GROUP_RAZORCLAW", "x": [ 24, 33 ], "y": [ 2, 8 ], "density": 0.05 }
      ],
      "place_monster": [ { "monster": "mon_alpha_razorclaw", "x": 13, "y": 11 } ]
    }
  }
]
