[
  {
    "type": "mapgen",
    "method": "json",
    "om_terrain": [ "4way_road" ],
    "weight": 100,
    "object": {
      "fill_ter": "t_dirt",
      "rows": [
        "    .......::.......    ",
        "    ................    ",
        "    .......::.......    ",
        "    .......::.......    ",
        "...........::...........",
        "........................",
        "........................",
        "........................",
        "........................",
        "........................",
        "...........]]...........",
        ".:::......]]]]......:::.",
        ".:::......]]]]......:::.",
        "...........]]...........",
        "........................",
        "........................",
        "........................",
        "........................",
        "........................",
        "........................",
        "    .......::.......    ",
        "    .......::.......    ",
        "    .......::.......    ",
        "    ................    "
      ],
      "terrain": {
        " ": [ "t_dirt", "t_dirt", "t_grass", "t_grass", "t_grass", "t_grass", "t_grass", "t_shrub" ],
        ".": "t_pavement",
        ":": "t_pavement_y",
        "]": "t_sidewalk"
      }
    }
  }
]
