[
  {
    "type": "mapgen",
    "method": "json",
    "nested_mapgen_id": "nest_RandEnc_roadstop",
    "//": "Select a possible random encounter that would make sense at a roadside outhouse.  This is a prototype version that only includes a merchant.  Doing this using cascading nested mapgen so that these same random encounter templates can be placed in other maps rather than being designed to only fit in this one.",
    "object": {
      "mapgensize": [ 24, 24 ],
      "place_nested": [
        {
          "chunks": [
            [ "RandEnc_FM_Caravan_Rand_8x8", 100 ]
          ],
          "x": 0,
          "y": 15
        }
      ]
    }
  },
  {
    "type": "mapgen",
    "method": "json",
    "nested_mapgen_id": "RandEnc_FM_Caravan_Rand_8x8",
    "//": "Adds a free merchant caravan that has stopped for a rest.  This one just has a generic random free merchant trader.",
    "object": {
      "mapgensize": [ 8, 8 ]
    }
  },
  {
    "type": "mapgen",
    "method": "json",
    "nested_mapgen_id": "nest_roadstop_zombies1",
    "//": "Scatters just a couple zombies and the car they came in on.",
    "object": {
      "mapgensize": [ 24, 24 ],
      "place_vehicles": [ { "chance": 100, "fuel": 0, "rotation": 90, "status": 1, "vehicle": "forgotten_vehicles", "x": [ 8, 20 ] "y": [ 17, 20 ] } ],
      "place_monsters": [ { "monster": "GROUP_ZOMBIE", "x": [ 6, 19 ], "y": [ 6, 19 ], "chance": 100 } ]
    }
  },
  {
    "type": "mapgen",
    "method": "json",
    "nested_mapgen_id": "nest_roadstop_zombies2",
    "//": "Scatters a few zombies and cars.",
    "object": {
      "mapgensize": [ 24, 24 ],
      "place_vehicles": [ { "chance": 100, "fuel": 0, "rotation": 90, "status": 1, "vehicle": "forgotten_vehicles", "x": [ 8, 12 ] "y": [ 17, 20 ] } ],
      "place_vehicles": [ { "chance": 80, "fuel": 0, "rotation": 90, "status": 1, "vehicle": "forgotten_vehicles", "x": [ 16, 20 ] "y": [ 17, 20 ] } ],
      "place_monsters": [ { "monster": "GROUP_ZOMBIE", "x": [ 6, 19 ], "y": [ 6, 19 ], "chance": 100 }, "repeat": [ 2, 3 ] ]
    }
  },
  {
    "type": "mapgen",
    "method": "json",
    "om_terrain": [ "roadstop" ],
    "weight": 333,
    "object": {
      "rotation": 2,
      "rows": [
        "........................",
        ".........222222.........",
        "........22222222........",
        ".......2222222222.......",
        ".......2222222222.......",
        ".......2222..2222.......",
        "......S2222..2222S......",
        "......S2222..2222S......",
        "######S2222##2222S######",
        "#73  3S2222662222S3  37#",
        "### A#S2222##2222S#A ###",
        "#73 A#S2222882222S#A 37#",
        "### A#S2222##2222S#A ###",
        "#73 A#S2222662222S#A 37#",
        "######S2222##2222S######",
        "......S2222..2222S......",
        "......S2222..2222S......",
        ".......2222..2222.......",
        ".......2222..2222.......",
        ".......2222..2222.......",
        ".......2222..2222.......",
        ".......2222..2222.......",
        ".......2222..2222.......",
        ".......2222..2222......."
      ],
      "terrain": {
        " ": "t_floor",
        "#": "t_wall_log",
        ".": "t_region_groundcover",
        "2": "t_region_groundcover_barren",
        "3": "t_door_c",
        "6": "t_floor",
        "7": "t_floor",
        "8": "t_region_groundcover_barren",
        "A": "t_floor",
        "S": "t_sidewalk"
      },
      "furniture": { "6": "f_table", "7": "f_toilet", "8": "f_trashcan", "A": "f_sink" },
      "toilets": { "7": {  } },
      "place_items": [
        { "item": "magazines", "x": [ 11, 12 ], "y": 9, "chance": 80 },
        { "item": "trash", "x": [ 11, 12 ], "y": 11, "chance": 80 },
        { "item": "magazines", "x": [ 11, 12 ], "y": 13, "chance": 90 }
      ],
      "place_nested": [
        {
          "//": "Overlay a single nested map over the whole region.  It may contain nothing, a few zombies, a lot of zombies, or no zombies at all and a script for random encounters to occur here.",
          "chunks": [
            [ "null", 50 ],
            [ "nest_roadstop_zombies1", 20 ],
            [ "nest_roadstop_zombies2", 10 ],
            [ "nest_RandEnc_roadstop", 20 ]
          ],
          "x": 0,
          "y": 0
        }
      ]
    }
  },
  {
    "type": "mapgen",
    "method": "json",
    "nested_mapgen_id": "nest_RandEnc_NPC_roadstop",
    "//": "Random encounter with NPCs at a roadside bathroom.",
    "object": {
      "mapgensize": [ 24, 24 ],
      "place_vehicles": [ { "chance": 100, "fuel": 0, "rotation": 90, "status": 1, "vehicle": "forgotten_vehicles", "x": [ 8, 12 ] "y": [ 17, 20 ] } ],
      "place_vehicles": [ { "chance": 80, "fuel": 0, "rotation": 90, "status": 1, "vehicle": "forgotten_vehicles", "x": [ 16, 20 ] "y": [ 17, 20 ] } ],
      "place_monsters": [ { "monster": "GROUP_ZOMBIE", "x": [ 6, 19 ], "y": [ 6, 19 ], "chance": 100 }, "repeat": [ 2, 3 ] ]
    }
  },
  {
    "type": "mapgen",
    "method": "json",
    "om_terrain": "roadstop_roof",
    "object": {
      "fill_ter": "t_tar_flat_roof",
      "rows": [
        "                        ",
        "                        ",
        "                        ",
        "                        ",
        "                        ",
        "                        ",
        "                        ",
        "                        ",
        "                        ",
        "......     ..     ......",
        "......     ..     ......",
        ".A....            ...A..",
        ".=.&..     ..     ...=..",
        "......     ..     ......",
        "......     ..     ...&..",
        "......     ..     ......",
        "                        ",
        "                        ",
        "                        ",
        "                        ",
        "                        ",
        "                        ",
        "                        ",
        "                        "
      ],
      "palettes": [ "roof_palette" ],
      "terrain": { ".": "t_tar_flat_roof" }
    }
  },
  {
    "type": "mapgen",
    "method": "json",
    "om_terrain": [ "roadstop_a" ],
    "weight": 333,
    "object": {
      "rotation": 2,
      "rows": [
        "........................",
        "........................",
        "........................",
        "........................",
        "........................",
        "......o........oo.......",
        ".....##############.....",
        ".t.t.#A  37##73  A#.t.t.",
        ".....#A  ######  A#.....",
        ".t.t.#A  39##73  A#.t.t.",
        ".....#A  ######  A#.....",
        ".t.t.#   37##93   #.t.t.",
        ".....# ########## #.....",
        ".t.t.#    ####    #.t.t.",
        ".....####3#88#3####.....",
        "......SSSSSSSSSSSS......",
        "........22222222........",
        ".......2222222222.......",
        "......222222222222......",
        "......222222222222......",
        "......2222....2222......",
        "......2222#ii#2222......",
        "......2222....2222......",
        "......2222....2222......"
      ],
      "terrain": {
        " ": "t_floor",
        "#": "t_wall_log",
        ".": "t_region_groundcover",
        "2": "t_region_groundcover_barren",
        "3": "t_door_c",
        "6": "t_floor",
        "7": "t_floor",
        "8": "t_region_groundcover_barren",
        "9": "t_floor",
        "A": "t_floor",
        "S": "t_sidewalk",
        "i": "t_region_groundcover_barren",
        "o": "t_region_groundcover_barren",
        "t": "t_region_tree"
      },
      "furniture": { "6": "f_table", "7": "f_toilet", "8": "f_trashcan", "9": "f_toilet", "A": "f_sink", "i": "f_sign", "o": "f_crate_c" },
      "signs": {
        "i": {
          "signage": "This was once an information map for the <city> area, but it has long since eroded beyond usefulness.  There are small holders for tourist maps attached."
        }
      },
      "toilets": { "7": {  }, "9": { "amount": 500 } },
      "place_items": [
        { "item": "trash", "x": [ 11, 12 ], "y": 14, "chance": 80 },
        { "item": "trash", "x": [ 6, 18 ], "y": [ 8, 15 ], "chance": 60 },
        { "item": "methlab", "x": [ 6, 18 ], "y": [ 8, 15 ], "chance": 50 }
      ],
      "place_item": [ { "item": "touristmap", "x": [ 11, 12 ], "y": 22, "chance": 50, "amount": 1 } ],
      "place_nested": [
        {
          "//": "Overlay a single nested map over the whole region.  It may contain nothing, a few zombies, a lot of zombies, or no zombies at all and a script for random encounters to occur here.",
          "chunks": [
            [ "null", 50 ],
            [ "nest_roadstop_zombies1", 20 ],
            [ "nest_roadstop_zombies2", 10 ],
            [ "nest_RandEnc_roadstop", 20 ]
          ],
          "x": 0,
          "y": 0
        }
      ]
    }
  },
  {
    "type": "mapgen",
    "method": "json",
    "om_terrain": "roadstop_a_roof",
    "object": {
      "fill_ter": "t_tar_flat_roof",
      "rows": [
        "                        ",
        "                        ",
        "                        ",
        "                        ",
        "                        ",
        "                        ",
        "                        ",
        "                        ",
        "                        ",
        "     ..............     ",
        "     ..............     ",
        "     ..............     ",
        "     ..............     ",
        "     ..............     ",
        "     ..............     ",
        "     ..............     ",
        "     ..............     ",
        "     ..............     ",
        "                        ",
        "                        ",
        "                        ",
        "          ....          ",
        "                        ",
        "                        "
      ],
      "palettes": [ "roof_palette" ],
      "terrain": { ".": "t_tar_flat_roof" }
    }
  },
  {
    "type": "mapgen",
    "method": "json",
    "om_terrain": [ "roadstop_b" ],
    "weight": 333,
    "object": {
      "rotation": 2,
      "rows": [
        "........................",
        "........................",
        "........................",
        "........................",
        "........................",
        "......o........oo.......",
        ".....##############.....",
        ".t.t.# 77A7i779995#.t.t.",
        ".....3           5#.....",
        ".t.t.# 9977777  75#.t.t.",
        ".....########777###.....",
        ".....||4||||4||||4|.....",
        ".....|464||464||46|.....",
        ".....||4||4|4|4||4|.....",
        ".....|8||464|464|8|.....",
        ".....|SSSSSSSSSSSS|.....",
        ".2222222222222222222222.",
        ".2222222222222222222222.",
        ".2222222222222222222222.",
        ".,,,,,222222222222,,,,,.",
        ".2222222222222222222222.",
        ".2222222222222222222222.",
        ".2222222222222222222222.",
        ".,,,,,2222....2222,,,,,."
      ],
      "terrain": {
        " ": "t_floor",
        "#": "t_wall_w",
        ",": "t_pavement_y",
        ".": [ [ "t_grass", 5 ], [ "t_grass_long", 2 ], "t_dirt", "t_shrub" ],
        "2": "t_pavement",
        "3": "t_door_c",
        "4": "t_sidewalk",
        "5": "t_floor",
        "6": "t_sidewalk",
        "7": "t_floor",
        "8": "t_sidewalk",
        "9": "t_floor",
        "A": "t_floor",
        "S": "t_sidewalk",
        "i": "t_dirt",
        "o": "t_dirt",
        "t": "t_tree",
        "|": "t_sidewalk"
      },
      "furniture": {
        "4": "f_chair",
        "5": "f_rack",
        "6": "f_table",
        "7": "f_counter",
        "8": "f_trashcan",
        "9": "f_fridge",
        "A": "f_sink",
        "i": "f_oven",
        "o": "f_crate_c"
      },
      "place_items": [
        { "item": "kitchen", "x": 9, "y": [ 9, 14 ], "chance": 80 },
        { "item": "trash", "x": 6, "y": 7, "chance": 80 },
        { "item": "trash", "x": 6, "y": 9, "chance": 80 },
        { "item": "trash", "x": 6, "y": 14, "chance": 80 },
        { "item": "fridge", "x": [ 7, 8 ], "y": 9, "chance": 80 },
        { "item": "coffee_fridge", "x": [ 14, 16 ], "y": 7, "chance": 80 },
        { "item": "trash", "x": 17, "y": 14, "chance": 80 }
      ]
    }
  },
  {
    "type": "mapgen",
    "method": "json",
    "om_terrain": "roadstop_b_roof",
    "object": {
      "fill_ter": "t_tar_flat_roof",
      "rows": [
        "                        ",
        "                        ",
        "                        ",
        "                        ",
        "                        ",
        "                        ",
        "                        ",
        "                        ",
        "                        ",
        "                        ",
        "                        ",
        "                        ",
        "                        ",
        "     ..............     ",
        "     ........&.....     ",
        "     ....A.........     ",
        "     ...........:..     ",
        "     ..............     ",
        "                        ",
        "                        ",
        "                        ",
        "                        ",
        "                        ",
        "                        "
      ],
      "palettes": [ "roof_palette" ],
      "terrain": { ".": "t_tar_flat_roof" }
    }
  }
]
