[
  {
    "type": "mapgen",
    "method": "json",
    "om_terrain": [ "roadstop" ],
    "weight": 333,
    "object": {
      "rotation": 2,
      "fill_ter": "t_dirt",
      "rows": [
        "                        ",
        "         ______         ",
        "        ________        ",
        "       __________       ",
        "       __________       ",
        "       ____  ____       ",
        "      ]____  ____]      ",
        "      ]____  ____]      ",
        "######]____##____]######",
        "#T+..+]____tt____]+..+T#",
        "###.&#]____##____]#&.###",
        "#T+.S#]__________]#S.+T#",
        "###.S#]____##____]#S.###",
        "#T+.S#]____tt____]#S.+T#",
        "######]____##____]######",
        "      ]____  ____]      ",
        "      ]____  ____]      ",
        "       ____  ____       ",
        "       ____  ____       ",
        "       ____  ____       ",
        "       ____  ____       ",
        "       ____  ____       ",
        "       ____  ____       ",
        "       ____  ____       "
      ],
      "palettes": [
        "road"
      ],
      "terrain": {
        "#": "t_wall_log",
        "_": "t_dirt"
      },
      "place_items": [
        { "item": "magazines", "x": [ 11, 12 ], "y": 9, "chance": 80 },
        { "item": "trash", "x": 4, "y": 10, "chance": 80 },
        { "item": "trash", "x": 19, "y": 10, "chance": 80 },
        { "item": "magazines", "x": [ 11, 12 ], "y": 13, "chance": 90 }
      ]
    }
  }
]
