[
  {
    "type": "mapgen",
    "method": "json",
    "om_terrain": [ "s_apt" ],
    "object": {
      "fill_ter": "t_floor",
      "rows": [
        "##o####o##&*&##o####o##.",
        "#d@@I|fhF|===|7  |d  y#.",
        "o @@ |h O|===|5  +  @@o.",
        "#y   +  5|===|O A|D  I#.",
        "##||||  7|===|F f||||##.",
        ".o8__+   *===*   +__8o..",
        ".#9tS|HHL|===|LHH|St9#..",
        "##||||||||===||||||||##.",
        "#b  d|F 7|===|Fhf| d@I#.",
        "o @  +  5|===|5  +  @ o.",
        "#I@ D|H O|===|O 6|D   #.",
        "##||||H 6|===|7 6||||##.",
        ".o8__+   *===*   +__8o..",
        ".#9tS|hfh|===|sHH|St9#..",
        "##||||||||===||||||||##.",
        "#__|__|Æ_|===|7  |y  I#.",
        "#$/|$/|$/|===|5  +  @@o.",
        "#________|===|O f|E  d#.",
        "#________|===|F h||||##.",
        "#$/|$/|__+===*   +__8o..",
        "#__|__|WZ|===|HHs|St9#..",
        "##########===##o######..",
        "%%%%%%%%#<===<#%%%%%%%..",
        "!!!!!!!%##&*&##%!!!!!!!."
      ],
      "palettes": [ "standard_domestic_palette" ],
      "terrain": {
        "%": [ "t_region_shrub", "t_region_shrub_fruit", "t_region_shrub_decorative" ],
        "!": "t_region_groundcover_urban",
        "=": "t_carpet_green",
        "#": "t_adobe_brick_wall",
        "<": "t_stairs_up",
        "&": "t_window",
        "~": "t_thconc_floor",
        "_": "t_linoleum_white",
        "8": "t_linoleum_white",
        "S": "t_linoleum_white",
        "t": "t_linoleum_white",
        "Z": "t_linoleum_white",
        "W": "t_linoleum_white",
        "9": "t_linoleum_white",
        "$": "t_chainfence",
        "/": "t_chaingate_c"
      },
      "furniture": { "!": "f_region_flower" },
      "place_loot": [
        { "group": "allclothes", "chance": 50, "repeat": [ 5 ], "x": [ 7, 8 ], "y": [ 20, 20 ] },
        { "group": "tools_home", "chance": 50, "repeat": [ 1 ], "x": [ 5, 4 ], "y": [ 15, 15 ] },
        { "group": "tools_home", "chance": 50, "repeat": [ 1 ], "x": [ 2, 1 ], "y": [ 15, 15 ] },
        { "group": "tools_home", "chance": 50, "repeat": [ 1 ], "x": [ 2, 1 ], "y": [ 20, 20 ] },
        { "group": "tools_home", "chance": 50, "repeat": [ 1 ], "x": [ 4, 5 ], "y": [ 20, 20 ] }
      ]
    }
  },
  {
    "type": "mapgen",
    "method": "json",
    "om_terrain": [ "s_apt_2ndfloor" ],
    "object": {
      "fill_ter": "t_floor",
      "rows": [
        "##o####o##&*&##o####o##.",
        "#d@@I|fhF|===|7 F|d  y#.",
        "o @@ |h O|===|5  +  @@o.",
        "#y   +  5|===|O A|D  I#.",
        "##||||  7|===|2 f||||##.",
        ".o8__+   *===*   +__8o..",
        ".#9tS|HHL|===|LHH|St9#..",
        "##||||||||===||||||||##.",
        "#   d|F 7|===|Fhf|Md@I#.",
        "o @  +  5|===|5  +  @ o.",
        "#I@ D|H O|===|O 6|D  Æ#.",
        "##||||H 3|===|7 6||||##.",
        ".o8__+   *===*   +__8o..",
        ".#9tS|hfh|===|sHH|St9#..",
        "##||||||||===||||||||##.",
        "#@@ D|fAF|===|7  |y  I#.",
        "o  h |A 5|===|5  +  @@o.",
        "#dII +  O|===|O f|E  d#.",
        "#|||||E 7|===|F h||||##.",
        "#9__|R   +===*   +__8o..",
        "#8St+ sHH|===|HHs|St9#..",
        "##########===##o######..",
        "........#>=<=>#.........",
        "........##&#&##........."
      ],
      "palettes": [ "standard_domestic_palette" ],
      "terrain": {
        "=": "t_carpet_green",
        "#": "t_adobe_brick_wall",
        ".": "t_open_air",
        "<": "t_stairs_up",
        ">": "t_stairs_down",
        "&": "t_window",
        "_": "t_linoleum_white",
        "8": "t_linoleum_white",
        "S": "t_linoleum_white",
        "t": "t_linoleum_white",
        "9": "t_linoleum_white"
      }
    }
  },
  {
    "type": "mapgen",
    "method": "json",
    "om_terrain": [ "s_apt_roof" ],
    "object": {
      "fill_ter": "t_flat_roof",
      "rows": [
        "|2222222222222222222222 ",
        "|.....................3 ",
        "|.A..A...........A..A.3 ",
        "|.....................3 ",
        "||...................33 ",
        " |&.................&3  ",
        " |..X.......N........3  ",
        "||................:..33 ",
        "|.....................3 ",
        "|.A..A...........A..A.3 ",
        "|.....................3 ",
        "||...................33 ",
        " |&.................&3  ",
        " |.......N...........3  ",
        "||...................33 ",
        "|.....................3 ",
        "|.A..A...........A..A.3 ",
        "|.....................3 ",
        "|....................33 ",
        "|.&...............X.&3  ",
        "|....................3  ",
        "|-------$$$$+$$------3  ",
        "        $__>__$         ",
        "        $$$$$$$         "
      ],
      "palettes": [ "roof_palette" ],
      "terrain": { "$": "t_adobe_brick_wall", "+": "t_door_c", ">": "t_stairs_down" }
    }
  },
  {
    "type": "mapgen",
    "method": "json",
    "om_terrain": [ "s_apt_upper_roof" ],
    "object": {
      "fill_ter": "t_flat_roof",
      "rows": [
        "                        ",
        "                        ",
        "                        ",
        "                        ",
        "                        ",
        "                        ",
        "                        ",
        "                        ",
        "                        ",
        "                        ",
        "                        ",
        "                        ",
        "                        ",
        "                        ",
        "                        ",
        "                        ",
        "                        ",
        "                        ",
        "                        ",
        "                        ",
        "                        ",
        "        .......         ",
        "        ..X....         ",
        "        .......         "
      ],
      "palettes": [ "roof_palette" ]
    }
  }
]
