[
  {
    "type": "mapgen",
    "method": "json",
    "om_terrain": [ "candy_shop" ],
    "weight": 100,
    "object": {
      "fill_ter": "t_floor",
      "rows": [
        ".............dssd.......",
        "....fD..f.D..dssd....fD.",
        "........D.f..dssd..d....",
        "...uudud.....dssd.d7d...",
        "..|-----|rrrrrssd..d....",
        "..|____^|sbbsRssdudud...",
        "..|B____asssssss|----|..",
        "..|B____asssssss|H__H|..",
        "..|^____|sbbssss|t__t|..",
        "..|B____||||---||H__H|..",
        "..|B____{#&__________|..",
        "..|__________________|..",
        "..|^{_____________SSS|..",
        "..|||cccc|||www|__||||..",
        "..|_^__C__&|F##|__|e#|..",
        "..|C___________|__+__|..",
        "..|tt__________+__|T_|..",
        "..|ttC_{{{_|o##|__||||..",
        "..|||w||w|||||||__|T_|..",
        "........4pggppph__+__|..",
        "........ppppppp|ll|#e|..",
        "........ppppppp|||||||..",
        "........................",
        "........................"
      ],
      "terrain": {
        "+": "t_door_c",
        "-": "t_wall_glass",
        ".": [ [ "t_grass", 5 ], [ "t_grass_long", 5 ], "t_dirt" ],
        "7": "t_tree_apple_harvested",
        "D": "t_dirt",
        "R": "t_railing_v",
        "_": "t_floor",
        "a": "t_door_glass_c",
        "b": "t_sidewalk",
        "d": "t_dirt",
        "f": "t_dirt",
        "g": "t_grass",
        "h": "t_door_locked",
        "p": "t_pavement",
        "r": "t_railing_h",
        "s": "t_sidewalk",
        "u": "t_underbrush",
        "w": "t_window",
        "4": "t_gutter_downspout",
        "|": "t_wall_y"
      },
      "furniture": {
        "#": "f_counter",
        "&": "f_trashcan",
        "B": "f_bench",
        "C": "f_chair",
        "D": "f_dahlia",
        "F": "f_fridge",
        "H": "f_armchair",
        "S": "f_sofa",
        "T": "f_toilet",
        "^": "f_indoor_plant",
        "b": "f_bench",
        "c": "f_counter",
        "e": "f_sink",
        "f": "f_bluebell",
        "g": "f_dumpster",
        "l": "f_locker",
        "o": "f_oven",
        "t": "f_table",
        "{": "f_rack"
      },
      "toilets": { "T": {  } },
      "place_items": [
        { "item": "sugar_house_kitchen_items", "x": 14, "y": 17, "chance": 35 },
        { "item": "sugar_house_kitchen_items", "x": 4, "y": 16, "chance": 35 },
        { "item": "jackets", "x": 17, "y": 20, "chance": 15 },
        { "item": "fridge", "x": 12, "y": 14, "chance": 45, "repeat": [ 1, 12 ] },
        { "item": "oven", "x": 12, "y": 17, "chance": 45 },
        { "item": "groce_cereal", "x": 13, "y": 17, "chance": 35 },
        { "item": "groce_cereal", "x": 3, "y": 16, "chance": 35 },
        { "item": "trash", "x": 10, "y": 14, "chance": 65 },
        { "item": "trash", "x": 10, "y": 10, "chance": 65 },
        { "item": "bags", "x": 16, "y": 20, "chance": 25 },
        { "item": "floor_trash", "x": [ 10, 11 ], "y": 19, "chance": 35 },
        { "item": "candy_shop", "x": 4, "y": 17, "chance": 45, "repeat": [ 1, 8 ] },
        { "item": "candy_shop", "x": [ 13, 14 ], "y": 14, "chance": 45, "repeat": [ 1, 8 ] },
        { "item": "candy_shop", "x": 5, "y": 13, "chance": 45, "repeat": [ 1, 8 ] },
        { "item": "candy_shop", "x": 17, "y": 8, "chance": 45, "repeat": [ 1, 8 ] },
        { "item": "candy_shop", "x": [ 7, 9 ], "y": 17, "chance": 75, "repeat": [ 1, 8 ] },
        { "item": "candy_shop", "x": 4, "y": 12, "chance": 75, "repeat": [ 1, 8 ] },
        { "item": "candy_shop", "x": 8, "y": 10, "chance": 75, "repeat": [ 1, 8 ] },
        { "item": "light_reading", "x": 8, "y": 13, "chance": 25 },
        { "item": "light_reading", "x": 3, "y": 7, "chance": 25 }
      ]
    }
  },
  {
    "type": "mapgen",
    "method": "json",
    "om_terrain": "candy_shop_roof",
    "weight": 200,
    "object": {
      "fill_ter": "t_flat_roof",
      "rows": [
        "........................",
        "........................",
        "........................",
        "........................",
        "..2222222...............",
        "..|     3...............",
        "..|     3.......222222..",
        "..|:    3.......|    3..",
        "..|     3.......|    3..",
        "..|     32222222|    3..",
        "..|                  3..",
        "..|     oo   oo      3..",
        "..|                  3..",
        "..|     oo   oo      3..",
        "..|                  3..",
        "..|                  3..",
        "..|                  3..",
        "..| A       &        3..",
        "..-------5-----|     3..",
        "...............|   = 3..",
        "...............|     3..",
        "...............-------..",
        "........................",
        "........................"
      ],
      "terrain": {
        " ": "t_flat_roof",
        ".": "t_open_air",
        "o": "t_glass_roof",
        "2": "t_gutter_north",
        "-": "t_gutter_south",
        "3": "t_gutter_east",
        "|": "t_gutter_west",
        "5": "t_gutter_drop"
      },
      "furniture": { "&": "f_roof_turbine_vent", ":": "f_cellphone_booster", "=": "f_vent_pipe", "A": "f_air_conditioner" },
      "place_items": [ { "item": "roof_trash", "x": [ 3, 19 ], "y": [ 11, 16 ], "chance": 50, "repeat": [ 1, 3 ] } ],
      "place_nested": [
        {
          "chunks": [
            [ "null", 20 ],
            [ "roof_2x2_utilities_b", 15 ],
            [ "roof_2x2_utilities_c", 5 ],
            [ "roof_2x2_utilities_d", 40 ],
            [ "roof_2x2_utilities", 50 ]
          ],
          "x": [ 3, 15 ],
          "y": 15
        }
      ]
    }
  },
  {
    "type": "mapgen",
    "method": "json",
    "om_terrain": [ "candy_shop_1" ],
    "weight": 100,
    "object": {
      "fill_ter": "t_floor",
      "rows": [
        "............ss..........",
        "............ss..........",
        "...d....d...ss.u.u.u.u..",
        "..d7d..d4d..ss|||||||||.",
        "...d....d..bss-____#__|.",
        "...........bss-____#__|.",
        "............ss|||__#C_|.",
        "...d........ssss+__#__|.",
        "..dtd....uu.ssss+__#__|.",
        "...d....||-----||__#&_|.",
        ".......d|^_________##_|.",
        ".......f-_____________|.",
        "...d...u-__{__{_______|.",
        "..d4d..e-__{__{___{w_w|.",
        "...d...D-__{__{___{w__|.",
        ".......u-__{__{___{wwa|.",
        ".......g|__{__{___#wT_|.",
        "...d...f|__{__{___#w#S|.",
        "..dhd..u|__{__{__||||||.",
        "...d...D|________aspcc5.",
        ".......d|^______&|spppp.",
        "........||||||||||spppp.",
        "..................spppp.",
        "........................"
      ],
      "terrain": {
        "+": "t_door_glass_c",
        "-": "t_wall_glass",
        ".": [ [ "t_grass", 5 ], [ "t_grass_long", 5 ], "t_dirt" ],
        "4": "t_tree_pine",
        "7": "t_tree_birch_harvested",
        "D": "t_dirt",
        "_": "t_floor",
        "a": "t_door_c",
        "b": "t_sidewalk",
        "c": "t_pavement",
        "d": "t_dirt",
        "e": "t_dirt",
        "f": "t_dirt",
        "g": "t_dirt",
        "h": "t_tree",
        "p": "t_pavement",
        "s": "t_sidewalk",
        "t": "t_tree_maple_tapped",
        "u": "t_underbrush",
        "w": "t_wall_y",
        "5": "t_gutter_downspout",
        "|": "t_brick_wall"
      },
      "furniture": {
        "#": "f_counter",
        "&": "f_trashcan",
        "C": "f_chair",
        "D": "f_dandelion",
        "S": "f_sink",
        "T": "f_toilet",
        "^": "f_indoor_plant",
        "b": "f_bench",
        "c": "f_dumpster",
        "e": "f_dahlia",
        "f": "f_bluebell",
        "g": "f_chamomile",
        "{": "f_rack"
      },
      "toilets": { "T": {  } },
      "place_items": [
        { "item": "magazines", "x": 19, "y": 5, "chance": 35, "repeat": [ 1, 8 ] },
        { "item": "vending_drink", "x": 19, "y": 9, "chance": 75, "repeat": [ 1, 12 ] },
        { "item": "candy_shop", "x": 14, "y": [ 17, 18 ], "chance": 75, "repeat": [ 1, 6 ] },
        { "item": "candy_shop", "x": 18, "y": [ 13, 15 ], "chance": 75, "repeat": [ 1, 6 ] },
        { "item": "candy_shop", "x": 14, "y": [ 13, 14 ], "chance": 75, "repeat": [ 1, 6 ] },
        { "item": "candy_shop", "x": 11, "y": [ 12, 18 ], "chance": 75, "repeat": [ 1, 6 ] },
        { "item": "floor_trash", "x": 9, "y": 17, "chance": 35 },
        { "item": "floor_trash", "x": 16, "y": 13, "chance": 35 },
        { "item": "floor_trash", "x": 20, "y": 11, "chance": 35 },
        { "item": "floor_trash", "x": 16, "y": 4, "chance": 35 },
        { "item": "trash", "x": 16, "y": 20, "chance": 65 },
        { "item": "trash", "x": [ 20, 21 ], "y": 19, "chance": 65 },
        { "item": "trash", "x": 20, "y": 9, "chance": 65 },
        { "item": "toy_store", "x": 18, "y": 16, "chance": 55 },
        { "item": "toy_store", "x": 14, "y": [ 15, 16 ], "chance": 55 },
        { "item": "toy_store", "x": 14, "y": 12, "chance": 55 },
        { "item": "toy_store", "x": 19, "y": 4, "chance": 55 }
      ]
    }
  },
  {
    "type": "mapgen",
    "method": "json",
    "om_terrain": "candy_shop_roof_1",
    "weight": 200,
    "object": {
      "fill_ter": "t_flat_roof",
      "rows": [
        "........................",
        "........................",
        "........................",
        "..............222222222.",
        "..............|       3.",
        "..............|       3.",
        "..............---     3.",
        "................|     3.",
        "................|     3.",
        "........|22222222     3.",
        "........|             3.",
        "........|             3.",
        "........|  oo         3.",
        "........|  oo         3.",
        "........|  oo         3.",
        "........|  oo         3.",
        "........|  oo         3.",
        "........|           = 3.",
        "........|        -----5.",
        "........|        3......",
        "........|  &     3......",
        "........----------......",
        "........................",
        "........................"
      ],
      "terrain": {
        " ": "t_flat_roof",
        ".": "t_open_air",
        "o": "t_glass_roof",
        "2": "t_gutter_north",
        "-": "t_gutter_south",
        "3": "t_gutter_east",
        "|": "t_gutter_west",
        "5": "t_gutter_drop"
      },
      "furniture": { "&": "f_roof_turbine_vent", "=": "f_vent_pipe" },
      "place_items": [ { "item": "roof_trash", "x": [ 10, 21 ], "y": [ 10, 16 ], "chance": 50, "repeat": [ 1, 3 ] } ],
      "place_nested": [
        {
          "chunks": [
            [ "null", 20 ],
            [ "roof_2x2_utilities_b", 15 ],
            [ "roof_2x2_utilities_c", 5 ],
            [ "roof_2x2_utilities_d", 40 ],
            [ "roof_2x2_utilities", 50 ]
          ],
          "x": [ 14, 16 ],
          "y": [ 12, 14 ]
        }
      ]
    }
  }
]
