[
  {
    "type": "mapgen",
    "method": "json",
    "om_terrain": [ "s_restaurant_coffee" ],
    "object": {
      "fill_ter": "t_floor",
      "rows": [
        "S___________SSTzzzzzzzTS",
        "S_____,_____SSzMMMMMMMzS",
        "S_____,_____SSSSSSSSSMzS",
        "S_____,_____SSSSSSSSSMzS",
        "S_____,_____SSSSSSSSSMzS",
        "S_____,_____SS##V{{{V##S",
        "S_____,_____SS#D     <#S",
        "SSSSSSSSSSSSSS#r      OS",
        "SSSSSSSSSSSSSS#r      #S",
        "SVVVVVVVzMSSzz#   -W--#S",
        "SVD>>>>VzMSSMzV   -ww%#S",
        "SV BBB>VzMSSSS{   xww(#S",
        "SV   B>VzMSSSS{   flwl#S",
        "SV   B>VzMMMMzV   flwU#S",
        "SV   B>Vzzzzzz#X  -wwG#S",
        "S#B ^##########^  ||I|#S",
        "SO6  B|=;|;=|99  r|FwC#S",
        "S#B  6|=A|A=|9   r|Fwc#S",
        "S#   B|+|||+|9   D|!ww#S",
        "S#B               |Lwl#S",
        "SO6   6 6 6   B66B|Lwl#S",
        "S#B ^???????^ B66B|Lwl#S",
        "S###################3##S",
        "S4SSSSSSSSSSSSSSSSSSSSSS"
      ],
      "palettes": [ "parametrized_linoleum_palette", "commercial", "parametrized_walls_palette" ],
      "terrain": {
        ".": "t_region_groundcover_urban",
        "M": "t_region_groundcover_urban",
        "z": "t_region_shrub_decorative",
        "_": "t_pavement",
        ",": "t_pavement_y",
        "S": "t_sidewalk",
        " ": "t_floor",
        "!": { "param": "linoleum_color", "fallback": "t_linoleum_white" },
        "-": { "param": "linoleum_color", "fallback": "t_linoleum_white" },
        "%": { "param": "linoleum_color", "fallback": "t_linoleum_white" },
        ";": { "param": "linoleum_color", "fallback": "t_linoleum_white" },
        "=": { "param": "linoleum_color", "fallback": "t_linoleum_white" },
        "A": { "param": "linoleum_color", "fallback": "t_linoleum_white" },
        "C": { "param": "linoleum_color", "fallback": "t_linoleum_white" },
        "F": { "param": "linoleum_color", "fallback": "t_linoleum_white" },
        "(": { "param": "linoleum_color", "fallback": "t_linoleum_white" },
        "G": { "param": "linoleum_color", "fallback": "t_linoleum_white" },
        "L": { "param": "linoleum_color", "fallback": "t_linoleum_white" },
        "U": { "param": "linoleum_color", "fallback": "t_linoleum_white" },
        "W": { "param": "linoleum_color", "fallback": "t_linoleum_white" },
        "c": { "param": "linoleum_color", "fallback": "t_linoleum_white" },
        "f": { "param": "linoleum_color", "fallback": "t_linoleum_white" },
        "l": { "param": "linoleum_color", "fallback": "t_linoleum_white" },
        "w": { "param": "linoleum_color", "fallback": "t_linoleum_white" },
        "x": { "param": "linoleum_color", "fallback": "t_linoleum_white" },
        "+": "t_door_c",
        "3": [ "t_door_locked", "t_door_locked_alarm" ],
        "I": "t_door_locked_interior",
        "O": "t_window",
        "V": "t_wall_glass",
        "{": "t_door_glass_c",
        "<": "t_stairs_up",
        "4": "t_gutter_downspout",
        "T": "t_tree_coffee"
      },
      "furniture": {
        "M": "f_region_flower",
        "^": [ "f_indoor_plant", "f_indoor_plant_y" ],
        "x": "f_counter",
        "-": "f_counter",
        ">": "f_counter",
        "W": "f_counter_gate_c",
        "%": "f_trashcan",
        "D": "f_trashcan",
        "6": "f_table",
        "?": "f_sofa",
        "B": "f_chair",
        "C": "f_desk",
        "L": "f_locker",
        "A": "f_sink",
        "U": "f_sink",
        "f": { "param": "display_fridge", "fallback": "f_glass_fridge" },
        "F": "f_heavy_duty_fridge",
        "(": "f_glass_fridge_double",
        "G": "f_oven",
        "X": "f_rack",
        "9": "f_rack",
        "l": "f_rack",
        "r": "f_rack"
      },
      "toilets": { ";": {  } },
      "items": {
        "x": { "item": "cash_register_random", "chance": 100 },
        "-": { "item": "coffee_counter", "chance": 10 },
        "6": { "item": "coffee_table", "chance": 35 },
        "9": { "item": "coffee_display_2", "chance": 85, "repeat": [ 1, 8 ] },
        ";": { "item": "coffee_bathroom", "chance": 15 },
        "=": { "item": "coffee_bathroom", "chance": 35 },
        ">": { "item": "coffee_table", "chance": 25 },
        "A": { "item": "coffee_bathroom", "chance": 35 },
        "C": { "item": "SUS_office_desk", "chance": 33 },
        "D": { "item": "SUS_trash_trashcan", "chance": 75 },
        "F": { "item": "coffee_fridge", "chance": 80, "repeat": [ 1, 8 ] },
        "G": { "item": "oven", "chance": 35 },
        "L": { "item": "coffee_locker", "chance": 75 },
        "U": { "item": "coffee_dishes", "chance": 75 },
        "X": { "item": "coffee_newsstand", "chance": 90, "repeat": [ 1, 8 ] },
        "f": { "item": "coffee_freezer", "chance": 85, "repeat": [ 1, 8 ] },
        "l": { "item": "coffee_prep", "chance": 50 },
        "r": { "item": "coffee_condiments", "chance": 80, "repeat": [ 1, 8 ] }
      },
      "monster": { "!": { "monster": "mon_zombie", "chance": 10 } },
      "place_monster": [ { "group": "GROUP_ZOMBIE", "x": [ 3, 17 ], "y": [ 13, 18 ], "chance": 80, "repeat": [ 1, 2 ] } ],
      "vehicles": { "c": { "vehicle": "swivel_chair" } }
    }
  },
  {
    "type": "mapgen",
    "method": "json",
    "om_terrain": [ "s_restaurant_coffee_roof" ],
    "object": {
      "fill_ter": "t_tile_flat_roof",
      "rows": [
        "                        ",
        "                        ",
        "                        ",
        "                        ",
        "                        ",
        "              ||||||||| ",
        "              |.....|>| ",
        "              |.......| ",
        "              |.......| ",
        " |||||||      |.....bt| ",
        " |.....|      |tb.....| ",
        " |.....|      |tb...bt| ",
        " |.....|      |tb...bt| ",
        " |.....|      |.....bt| ",
        " |.....|      |tb...bt| ",
        " |.....||||||||.....bt| ",
        " |....................| ",
        " |b...................| ",
        " |b.tt......btb.btb...| ",
        " |b.tt......btb.btb...| ",
        " |bbbbb...............| ",
        " |||||||||||||||||||||| ",
        " 5--------------------- ",
        "                        "
      ],
      "palettes": [ "roof_palette" ],
      "terrain": { ".": "t_tile_flat_roof", "|": "t_glass_railing" },
      "place_items": [
        { "item": "coffee_table", "x": [ 4, 5 ], "y": [ 18, 19 ], "chance": 50, "repeat": [ 1, 3 ] },
        { "item": "coffee_table", "x": 13, "y": [ 18, 19 ], "chance": 50, "repeat": [ 1, 3 ] },
        { "item": "coffee_table", "x": 17, "y": [ 18, 19 ], "chance": 50, "repeat": [ 1, 3 ] },
        { "item": "coffee_table", "x": 15, "y": [ 10, 13 ], "chance": 50, "repeat": [ 1, 3 ] },
        { "item": "coffee_table", "x": 15, "y": 14, "chance": 50, "repeat": [ 1, 3 ] },
        { "item": "coffee_table", "x": 21, "y": [ 11, 15 ], "chance": 50, "repeat": [ 1, 3 ] }
      ],
      "place_nested": [ { "chunks": [ [ "roof_2x2_golf", 10 ], [ "null", 80 ], [ "roof_3x3_wine", 10 ] ], "x": [ 3, 4 ], "y": [ 10, 13 ] } ]
    }
  },
  {
    "type": "mapgen",
    "method": "json",
    "om_terrain": [ "s_restaurant_coffee_1" ],
    "object": {
      "//": "Default fill is floor but some tables are outside",
      "fill_ter": { "param": "linoleum_color", "fallback": "t_linoleum_white" },
      "rows": [
        "_______,,,,,,,ss--------",
        "______________ss-pppppp-",
        "______________sssphtthp-",
        "______________ssspppppp-",
        "______________sssphpphp-",
        "_______,,,,,,,sssptpptp-",
        "______________sssphpphp-",
        "______________ssspppppp-",
        "______________ss-phtthp-",
        "______________ss-pppppp-",
        "_______,,,,,,,ss##5555##",
        "______________ss#.HTTH.#",
        "______________ss%......#",
        "______________ss+.....&#",
        "______________ss+......#",
        "s4ssssssssssssss%....HH#",
        "###555#555#555###....TT#",
        "#..HTH.HTH.HTH.......TT#",
        "#....................HH#",
        "#......................#",
        "#|D|||D|||cWWcccxccxccc#",
        "#S==|==S|==============#",
        "#P==|==P|llSO==rrrrrSce#",
        "##############L#########"
      ],
      "palettes": [ "parametrized_linoleum_palette", "parametrized_walls_palette" ],
      "terrain": {
        "-": "t_region_shrub_decorative",
        "%": "t_wall_glass",
        "+": "t_door_glass_c",
        ",": "t_pavement_y",
        ".": "t_floor",
        "H": "t_floor",
        "T": "t_floor",
        "&": "t_floor",
        "5": "t_wall_glass",
        "D": "t_door_c",
        "L": "t_door_locked",
        "_": "t_pavement",
        "p": "t_concrete",
        "t": "t_concrete",
        "h": "t_concrete",
        "=": { "param": "linoleum_color", "fallback": "t_linoleum_white" },
        "s": "t_sidewalk",
        "4": "t_gutter_downspout"
      },
      "furniture": {
        "x": "f_counter",
        "&": "f_trashcan",
        "H": "f_chair",
        "h": "f_chair",
        "O": "f_oven",
        "S": "f_sink",
        "T": "f_table",
        "t": "f_table",
        "c": "f_counter",
        "e": "f_heavy_duty_fridge",
        "l": "f_locker",
        "W": "f_counter_gate_c",
        "r": "f_rack"
      },
      "toilets": { "P": {  } },
      "place_items": [
        { "item": "coffee_locker", "x": [ 9, 10 ], "y": 22, "chance": 75, "repeat": [ 1, 3 ] },
        { "item": "coffee_display", "x": [ 15, 19 ], "y": 22, "chance": 80, "repeat": [ 1, 8 ] },
        { "item": "coffee_display", "x": [ 15, 19 ], "y": 22, "chance": 80, "repeat": [ 1, 8 ] },
        { "item": "coffee_dishes", "x": 20, "y": 22, "chance": 85, "repeat": [ 1, 2 ] },
        { "item": "coffee_fridge", "x": 22, "y": 22, "chance": 85, "repeat": [ 1, 8 ] },
        { "item": "coffee_table", "x": [ 21, 22 ], "y": [ 16, 17 ], "chance": 20, "repeat": [ 1, 2 ] },
        { "item": "coffee_table", "x": 12, "y": 17, "chance": 20, "repeat": [ 1, 2 ] },
        { "item": "coffee_table", "x": 8, "y": 17, "chance": 20, "repeat": [ 1, 2 ] },
        { "item": "coffee_table", "x": 4, "y": 17, "chance": 20, "repeat": [ 1, 2 ] },
        { "item": "coffee_table", "x": [ 19, 20 ], "y": 11, "chance": 20, "repeat": [ 1, 2 ] },
        { "item": "coffee_table", "x": [ 19, 20 ], "y": 8, "chance": 20, "repeat": [ 1, 2 ] },
        { "item": "coffee_table", "x": 21, "y": 5, "chance": 20, "repeat": [ 1, 2 ] },
        { "item": "coffee_table", "x": 18, "y": 5, "chance": 20, "repeat": [ 1, 2 ] },
        { "item": "coffee_table", "x": [ 19, 20 ], "y": 2, "chance": 20, "repeat": [ 1, 2 ] },
        { "item": "SUS_trash_trashcan", "x": 22, "y": 13, "chance": 75, "repeat": [ 2, 4 ] },
        { "item": "coffee_bathroom", "x": [ 5, 6 ], "y": [ 21, 22 ], "chance": 20, "repeat": [ 1, 2 ] },
        { "item": "coffee_bathroom", "x": [ 2, 3 ], "y": [ 21, 22 ], "chance": 20, "repeat": [ 1, 2 ] }
      ],
      "place_item": [ { "item": "coffeemaker", "x": 21, "y": 22 }, { "item": "atomic_coffeepot", "x": 21, "y": 22, "chance": 20 } ],
      "items": { "x": { "item": "cash_register_random", "chance": 100 } }
    }
  },
  {
    "type": "mapgen",
    "method": "json",
    "om_terrain": "s_restaurant_coffee_roof_1",
    "object": {
      "fill_ter": "t_flat_roof",
      "rows": [
        "                        ",
        "                        ",
        "                        ",
        "                        ",
        "                        ",
        "                        ",
        "                        ",
        "                        ",
        "                        ",
        "                        ",
        "                --------",
        "                -......-",
        "                -....&.-",
        "                -......-",
        "                -......-",
        "                -......-",
        "-5---------------......-",
        "-......................-",
        "-......................-",
        "-......................-",
        "-......................-",
        "-......................-",
        "-.=....................-",
        "-......................-"
      ],
      "palettes": [ "roof_palette" ],
      "place_items": [ { "item": "SUS_trash_roof", "x": [ 3, 19 ], "y": [ 18, 22 ], "chance": 50, "repeat": [ 1, 3 ] } ],
      "place_nested": [
        { "chunks": [ [ "null", 40 ], [ "roof_4x4_utility", 60 ] ], "x": [ 3, 15 ], "y": 18 },
        { "chunks": [ [ "null", 40 ], [ "roof_2x2_utilities_d", 60 ] ], "x": 18, "y": 14 }
      ]
    }
  },
  {
    "method": "json",
    "om_terrain": "s_restaurant_coffee_2",
    "type": "mapgen",
    "object": {
      "rows": [
        "              sss       ",
        "              sss       ",
        "        SSSS  sss SSS   ",
        "  ############sss##w##  ",
        "  #{{o|Atr{tA#sss#..^#  ",
        "  #...|.AAtA.#+#+#...#  ",
        "  #...D..A..Ar{rvr...#  ",
        "  #...|......A.tt....#  ",
        "  #...c..............#  ",
        "  #...c.............^#  ",
        "  #...c..............#  ",
        "  #...c..............#  ",
        "  #...x......A.......#  ",
        "  #..c|.....AtA......#  ",
        "  #..c|......A....|D|#  ",
        "  #..&|...........|''#  ",
        "  #...|||||A...A..|''#  ",
        "  #.....D<|tA.AtA.|aT#  ",
        "  #.....||############  ",
        "  #AtA....bppppdd4ppS   ",
        "  #AtA.lll#pppppppppS   ",
        "  #########pppppppppS   ",
        "           pppppppppS   ",
        "                        "
      ],
      "palettes": [ "parametrized_linoleum_palette", "parametrized_linoleum_palette", "parametrized_walls_palette" ],
      "fill_ter": "t_floor",
      "furniture": {
        "A": "f_chair",
        "&": "f_trashcan",
        "T": "f_toilet",
        "^": "f_indoor_plant",
        "a": "f_sink",
        "c": "f_counter",
        "d": "f_dumpster",
        "l": "f_locker",
        "o": "f_oven",
        "r": "f_rack",
        "t": "f_table",
        "{": [ "f_heavy_duty_fridge", "f_heavy_duty_freezer" ],
        "x": "f_counter"
      },
      "terrain": {
        "+": "t_door_glass_c",
        "-": "t_wall_glass",
        "D": "t_door_c",
        "S": "t_region_shrub_decorative",
        " ": "t_region_groundcover_urban",
        "b": "t_door_metal_pickable",
        "d": "t_concrete",
        "p": "t_concrete",
        "'": { "param": "linoleum_color", "fallback": "t_linoleum_gray" },
        "a": { "param": "linoleum_color", "fallback": "t_linoleum_gray" },
        "T": { "param": "linoleum_color", "fallback": "t_linoleum_gray" },
        "s": "t_sidewalk",
        "w": "t_window_boarded_noglass",
        "4": "t_gutter_downspout",
        "<": "t_ladder_up"
      },
      "vendingmachines": { "v": { "item_group": "vending_drink", "lootable": true } },
      "place_items": [
        { "chance": 80, "repeat": [ 1, 8 ], "item": "coffee_freezer", "x": [ 3, 4 ], "y": 4 },
        { "chance": 70, "repeat": [ 1, 8 ], "item": "coffee_display_2", "x": 7, "y": 13 },
        { "chance": 70, "repeat": [ 1, 8 ], "item": "coffee_display_2", "x": 6, "y": 11 },
        { "chance": 75, "repeat": [ 1, 8 ], "item": "coffee_condiments", "x": [ 5, 6 ], "y": 12 },
        { "chance": 75, "repeat": [ 1, 8 ], "item": "coffee_condiments", "x": 6, "y": 9 },
        { "chance": 35, "item": "clothing_work_torso", "x": [ 7, 9 ], "y": 20 },
        { "chance": 40, "item": "SUS_trash_trashcan", "x": 5, "y": 15 },
        { "chance": 75, "repeat": [ 1, 3 ], "item": "kitchen_nonfood", "x": 5, "y": [ 13, 14 ] },
        { "chance": 35, "item": "coffee_dishes", "x": 6, "y": 8 },
        { "chance": 50, "item": "SUS_trash_dumpster", "x": [ 15, 16 ], "y": 19 },
        { "chance": 65, "repeat": [ 1, 3 ], "item": "coffee_newsstand", "x": 15, "y": 6 }
      ],
      "place_monsters": [
        { "chance": 4, "density": 1, "monster": "GROUP_ZOMBIE", "x": 8, "y": 10 },
        { "chance": 3, "density": 1, "monster": "GROUP_ZOMBIE_FAT_BASE", "x": 17, "y": 11 }
      ],
      "place_toilets": [ { "x": 20, "y": 17 } ],
      "items": { "x": { "item": "cash_register_random_ransacked", "chance": 100 } }
    }
  },
  {
    "type": "mapgen",
    "method": "json",
    "om_terrain": "s_restaurant_coffee_roof_2",
    "object": {
      "fill_ter": "t_flat_roof",
      "rows": [
        "                        ",
        "                        ",
        "                        ",
        "  ------------   -----  ",
        "  -..........-   -...-  ",
        "  -...&......-----...-  ",
        "  -..................-  ",
        "  -..................-  ",
        "  -..................-  ",
        "  -..................-  ",
        "  -..................-  ",
        "  -..................-  ",
        "  -..................-  ",
        "  -..................-  ",
        "  -..................-  ",
        "  -..................-  ",
        "  -..................-  ",
        "  -......v...........-  ",
        "  -.......-------5----  ",
        "  -.......-             ",
        "  -.......-             ",
        "  ---------             ",
        "                        ",
        "                        "
      ],
      "palettes": [ "roof_palette" ],
      "place_items": [ { "item": "SUS_trash_roof", "x": [ 3, 19 ], "y": [ 5, 18 ], "chance": 50, "repeat": [ 1, 3 ] } ],
      "place_nested": [
        { "chunks": [ [ "null", 40 ], [ "roof_4x4_utility", 60 ], [ "roof_4x4_holdout", 10 ] ], "x": [ 4, 16 ], "y": [ 7, 13 ] }
      ]
    }
  }
]
