[
  {
    "type": "mapgen",
    "method": "json",
    "om_terrain": [ "s_gas" ],
    "weight": 350,
    "object": {
      "fill_ter": "t_pavement",
      "rows": [
        "........................",
        ".-----..................",
        ".|...|..........sss.....",
        ".|.Q.|...........&s.....",
        ".|...|...........1s.....",
        ".|...|P..........2s.....",
        ".--+--..........sss.....",
        "........................",
        "...s9s...........s9s....",
        "........................",
        "....5.............5.....",
        "........................",
        "........................",
        "........................",
        "........................",
        "....5.............5.....",
        "........................",
        "........................",
        "........................",
        "........................",
        "........................",
        "....5.............5.....",
        "...s9s...........s9s....",
        "........................"
      ],
      "place_terrain": [ { "ter": "t_gas_tank", "x": 3, "y": 5 } ],
      "terrain": {
        "&": "t_atm",
        "+": "t_chaingate_l",
        "-": "t_chainfence_h",
        ".": "t_pavement",
        "5": "t_gas_pump",
        "s": "t_little_column",
        "|": "t_chainfence_v"
      },
      "furniture": { "9": "f_aut_gas_console" },
      "signs": { "P": { "signage": "Danger!  Do not smoke!  Risk of explosion!" } },
      "vendingmachines": { "1": { "item_group": "vending_drink" }, "2": { "item_group": "vending_food" } },
      "place_liquids": [ { "liquid": "gasoline", "x": 3, "y": 5, "repeat": [ 200, 1075 ] } ]
    }
  },
  {
    "type": "mapgen",
    "method": "json",
    "om_terrain": [ "s_gas" ],
    "weight": 200,
    "object": {
      "fill_ter": "t_floor",
      "rows": [
        "____:]:____:____:]:____]",
        "____]]]____:____]]]____]",
        "____!#!____:____!#!____]",
        "____]]]____:____]]]____]",
        "____:]:____:____:]:____]",
        "____]]]____:____]]]____]",
        "____!#!____:____!#!____]",
        "____]]]____:____]]]____]",
        "____:]:____:____:]:____]",
        "]]]]]]]]]]]]]]]]]]]]]]]]",
        "]]]]]]]]]]]]]Pr]]]]]]]]]",
        "#xxxxxxxxx///xxxxxxxxx#]",
        "#1.......&...&.......1#]",
        "#r...................{#]",
        "#r..rrrrr.....rrrrr..{#]",
        "#r..rrrrr.....rrrrr..{#]",
        "#r...................{#]",
        "#r...................{#]",
        "#&.AFFD#.CCCCC#rrrrrr1#]",
        "##+#####...s..#########]",
        "#S.#...+......+.......~]",
        "#T.#TSl#.rrrrr#HHtcCfl#]",
        "########~##############]",
        "        ]]]]]]]]]]]]]]]]"
      ],
      "palettes": [ "road" ],
      "signs": { "P": { "signage": "Wide selection of storage batteries!  Discounts!" } },
      "items": { "l": { "item": "cleaning", "chance": 70 }, "&": { "item": "trash_cart", "chance": 50 } },
      "place_loot": [
        { "group": "fridgesnacks", "x": 21, "y": [ 13, 17 ], "chance": 70, "repeat": [ 1, 2 ] },
        { "group": "fridge", "x": 20, "y": 21, "chance": 60, "repeat": [ 1, 2 ] },
        { "group": "snacks", "x": [ 14, 18 ], "y": [ 14, 15 ], "chance": 70, "repeat": [ 1, 2 ] },
        { "group": "magazines", "x": [ 4, 8 ], "y": [ 14, 15 ], "chance": 70, "repeat": [ 1, 2 ] },
        { "group": "softdrugs", "x": 1, "y": [ 13, 17 ], "chance": 70, "repeat": [ 1, 2 ] },
        { "group": "behindcounter", "x": [ 9, 13 ], "y": 21, "chance": 70, "repeat": [ 1, 2 ] },
        { "group": "road", "x": [ 7, 15 ], "y": [ 0, 8 ], "chance": 30, "repeat": [ 1, 2 ] },
        { "group": "gas_charging_rack", "x": [ 15, 20 ], "y": 18, "chance": 50, "repeat": [ 1, 2 ] },
        { "group": "gas_charging_rack", "x": 14, "y": 10, "chance": 50 },
        { "group": "dining", "x": 17, "y": 21, "chance": 45 },
        { "group": "bed", "x": [ 15, 16 ], "y": 21, "chance": 70 },
        { "item": "microwave", "x": 19, "y": 21, "chance": 80 },
        { "item": "laptop", "x": 11, "y": 18, "chance": 70 }
      ],
      "place_monsters": [ { "monster": "GROUP_ZOMBIE", "x": [ 2, 20 ], "y": [ 16, 17 ], "chance": 2 } ]
    }
  },
  {
    "type": "mapgen",
    "method": "json",
    "om_terrain": [ "s_gas_rural" ],
    "//": "Rural Gas Station",
    "weight": 333,
    "object": {
      "rows": [
        "________________________",
        "________________________",
        "________________________",
        "________________________",
        "________________________",
        "_______O________O_______",
        "________________________",
        "________________________",
        "________________________",
        "........................",
        ".#~~~~~~~#    #~~~~~~~#.",
        ".[                    [.",
        ".####0#####33#####0####.",
        ".#9999  99      >S   9#.",
        ".#      99      >    9#.",
        ".#9999  99      >     #.",
        ".#              >  >>>#.",
        ".#FFFFFFFF            #.",
        ".##########3########  #.",
        ".#@@  BC#?  B66  F>#3##.",
        ".#@@   C#?        ># ;#.",
        ".#:     3      H  =#A #.",
        ".##00##################.",
        "........................"
      ],
      "set": [
        { "point": "terrain", "id": "t_dirt", "x": 0, "y": [ 0, 23 ], "repeat": [ 5, 10 ] },
        { "point": "terrain", "id": "t_dirt", "x": 23, "y": [ 0, 23 ], "repeat": [ 5, 10 ] },
        { "point": "terrain", "id": "t_dirt", "x": [ 0, 23 ], "y": 23, "repeat": [ 5, 8 ] },
        { "point": "terrain", "id": "t_dirt", "x": [ 0, 23 ], "y": [ 0, 2 ], "repeat": [ 8, 10 ] },
        { "point": "terrain", "id": "t_dirt", "x": [ 0, 23 ], "y": [ 0, 4 ], "repeat": [ 8, 2 ] }
      ],
      "terrain": {
        " ": "t_floor",
        "#": "t_wall_log",
        ".": "t_grass",
        "0": "t_curtains",
        "3": "t_door_locked",
        "6": "t_floor",
        "9": "t_floor",
        ":": "t_floor",
        ";": "t_floor",
        "=": "t_rock_floor",
        ">": "t_floor",
        "?": "t_floor",
        "@": "t_floor",
        "A": "t_floor",
        "B": "t_floor",
        "C": "t_floor",
        "F": "t_floor",
        "H": "t_floor",
        "O": "t_dirt",
        "S": "t_floor",
        "[": "t_fence_v",
        "_": "t_pavement",
        "~": "t_fence_h"
      },
      "furniture": {
        "6": "f_table",
        "9": "f_rack",
        ":": "f_dresser",
        "=": "f_woodstove",
        ">": "f_counter",
        "?": "f_sofa",
        "@": "f_bed",
        "A": "f_sink",
        "B": "f_chair",
        "C": "f_desk",
        "F": "f_glass_fridge",
        "H": "f_armchair",
        "S": "f_stool"
      },
      "toilets": { ";": {  } },
      "gaspumps": { "O": {  } },
      "place_items": [
        { "item": "bed", "x": [ 2, 3 ], "y": [ 19, 20 ], "chance": 80 },
        { "item": "dresser", "x": 2, "y": 21, "chance": 80 },
        { "item": "fridgesnacks", "x": [ 2, 9 ], "y": 17, "chance": 80 },
        { "item": "fridge", "x": 17, "y": 19, "chance": 80 },
        { "item": "snacks", "x": [ 2, 5 ], "y": 15, "chance": 80 },
        { "item": "behindcounter", "x": [ 21, 21 ], "y": [ 13, 14 ], "chance": 80 },
        { "item": "road", "x": [ 20, 20 ], "y": [ 13, 14 ], "chance": 20 },
        { "item": "snacks", "x": [ 2, 5 ], "y": 13, "chance": 13 },
        { "item": "camping", "x": [ 9, 9 ], "y": [ 15, 15 ], "chance": 70 },
        { "item": "homebooks", "x": [ 7, 7 ], "y": [ 19, 20 ], "chance": 60 },
        { "item": "magazines", "x": [ 9, 9 ], "y": [ 13, 15 ], "chance": 90 },
        { "item": "softdrugs", "x": [ 8, 8 ], "y": [ 13, 15 ], "chance": 80 }
      ],
      "place_item": [
        { "item": "shotgun_s", "x": 3, "y": 20 },
        { "item": "pot", "x": 18, "y": 21 },
        { "item": "shot_00", "x": 7, "y": 19, "chance": 50 }
      ]
    }
  }
]
