[
  {
    "type": "mapgen",
    "method": "json",
    "om_terrain": [ "s_gas" ],
    "weight": 100,
    "object": {
      "fill_ter": "t_floor",
      "rows": [
        "____:]:____:____:]:____]",
        "____:]:____:____:]:____]",
        "____:]:____:____:]:____]",
        "____]]]____:____]]]____]",
        "____!#!____:____!#!____]",
        "____]]]____:____]]]____]",
        "____:]:____:____:]:____]",
        "____:]:____:____:]:____]",
        "____:]:____:____:]:____]",
        "]]]]]]]]]]]]]]]]]]]]]]]]",
        "]]]]]]]]]]]]]]]]]]]]]]]]",
        "#xxxxxxxxx///xxxxxxxxx#]",
        "#1.......&...&.......1#]",
        "#r...................r#]",
        "#r..rrrrr.....rrrrr..r#]",
        "#r..rrrrr.....rrrrr..r#]",
        "#r...................r#]",
        "#r...................r#]",
        "#&.DFFD#.CCCCC#########]",
        "##+#####...c..#flrrrrr#]",
        "#S.#...+......+.......+]",
        "#T.#TSl#.rrrrr#tcrrrrr#]",
        "########+##############]",
        "        ]]]]]]]]]]]]]]]]"
      ],
      "palettes": [
        "road"
      ]
    }
  }
]
