[
  {
    "type": "mapgen",
    "method": "json",
    "om_terrain": [ "s_gun" ],
    "weight": 300,
    "object": {
      "fill_ter": "t_floor",
      "rows": [
        ",,____________________''",
        ",,*___*___*______*___*''",
        ",,*___*___*______*___*''",
        ",,*___*___*______*___*''",
        ",,*___*___*______*___*''",
        ",,*___*___*______*___*''",
        ",,###:::########:::###''",
        ",,#|rC..{{{{{{..DDDLL#''",
        ",,#Xa?..............L#''",
        ",,#|.c...............+''",
        ",,#|....{{{{{{..LLLLL#__",
        ",,#---D--------------#__",
        ",,#&q-.-lll.AnA.r.sss#__",
        ",,#//D.+...........ss#__",
        ",,#---D-----------.ss#__",
        ",;#..n..n=.n..n..-.--#__",
        ",,#..=........=..-.D<#__",
        ",,WWWRWWRWWRWWRWWW+###__",
        ",,W....=...=.....W_www__",
        ",,W=.............W______",
        ",,W..............W______",
        ",,W..T..T..T..T..W______",
        ",,WxxxxxxxxxxxxxxW______",
        ",,WWWWWWWWWWWWWWWW______"
      ],
	  "palettes": [ "gun_store_palette" ],
      "place_loot": [
        { "group": "clothing_tactical_leg", "x": 16, "y": 11, "chance": 50, "repeat": [ 1, 6 ]},
		{ "group": "clothing_tactical_torso", "x": 16, "y": [ 9, 10 ], "chance": 50, "repeat": [ 1, 6 ]},
		{ "group": "guns_pistol_rare_display", "x": [ 16, 17 ], "y": 13, "chance": 60, "repeat": [ 1, 3 ], "magazine": 100 },
        { "group": "mags_rifle_rare", "x": 3, "y": 9, "chance": 76, "repeat": [ 5, 10 ] },
        { "group": "guns_shotgun_common_display", "x": 18, "y": 13, "chance": 80, "magazine": 100, "repeat": [ 1, 4 ] },
        { "group": "guns_shotgun_rare_display", "x": 19, "y": 13, "chance": 70, "magazine": 100, "repeat": [ 1, 2 ]  },
        { "group": "guns_rifle_common_display", "x": 20, "y": [ 7, 8 ], "chance": 80, "magazine": 100, "repeat": [ 1, 4 ] },
        { "group": "guns_rifle_rare_display", "x": 3, "y": 10, "chance": 70, "repeat": [ 1, 2 ], "magazine": 100 },
        { "group": "guns_rifle_common_display", "x": 20, "y": 9, "chance": 80, "repeat": [ 1, 4 ], "magazine": 100 },
        { "group": "guns_pistol_common_display", "x": 20, "y": [ 10, 13 ], "chance": 80, "repeat": [ 1, 4 ], "magazine": 100 },
        { "group": "ammo_common", "x": 3, "y": 10, "chance": 85, "repeat": [ 30, 40 ] },
		{ "group": "ammo_rare", "x": 3, "y": 10, "chance": 90, "repeat": [ 5, 15 ] },
        { "group": "mags_common", "x": 3, "y": 7, "chance": 65, "repeat": [ 5, 10 ] },
        { "group": "mags_pistol_rare", "x": 3, "y": 8, "chance": 75, "repeat": [ 4, 8 ] },
        { "group": "mags_shotgun_rare", "x": 3, "y": 9, "chance": 75, "repeat": [ 1, 3 ] },
        { "group": "gun_cases", "x": 13, "y": [ 9, 11 ], "chance": 80, "repeat": [ 1, 2 ] },
        { "group": "book_gunmags", "x": 12, "y": [ 9, 11 ], "chance": 90, "repeat": [ 2, 4 ] },
        { "group": "guns_pistol_common_display", "x": 5, "y": 16, "chance": 25, "repeat": [ 1, 2 ], "magazine": 100 },
        { "group": "guns_pistol_rare_display", "x": 8, "y": 16, "chance": 25, "repeat": [ 1, 2 ], "magazine": 100 },
        { "group": "guns_shotgun_common_display", "x": 11, "y": 16, "chance": 25, "repeat": [ 1, 2 ], "magazine": 100 },
        { "group": "guns_pistol_rare_display", "x": 14, "y": 16, "chance": 25, "repeat": [ 1, 2 ], "magazine": 100 },
        { "group": "guns_pistol_common_display", "x": 17, "y": 16, "chance": 25, "repeat": [ 1, 2 ], "magazine": 100}
      ],
      "item": {
        "l": [ { "item": "ear_plugs", "chance": 50, "repeat": 12 }, { "item": "powered_earmuffs", "chance": 30, "repeat": 3 } ]
      },
      "place_monsters": [ { "monster": "GROUP_ZOMBIE", "x": [ 0, 0 ], "y": [ 23, 23 ], "chance": 2, "repeat": [ 2, 3 ] } ]
    }
  },
  {
    "type": "mapgen",
    "method": "json",
    "om_terrain": "s_gun_roof",
    "object": {
      "fill_ter": "t_flat_roof",
      "rows": [
        "                        ",
        "                        ",
        "                        ",
        "                        ",
        "                        ",
        "                        ",
        "  |2222222222222222223  ",
        "  |..................3  ",
        "  |..................3  ",
        "  |..................3  ",
        "  |..................3  ",
        "  |..X...............3  ",
        "  |..................3  ",
        "  |..................3  ",
        "  |..................3  ",
        "  5...............1113  ",
        "  |...............1>13  ",
        "  |...............1013  ",
        "  |...............1+13  ",
        "  |..............32223  ",
        "  |..............2      ",
        "  |..............2      ",
        "  |..............2      ",
        "  |222222222222222      "
      ],
      "palettes": [ "roof_palette" ],
      "terrain": { ">": "t_ladder_down", "1": "t_wall_w", "+": "t_door_metal_pickable", "0": "t_thconc_floor" },
      "place_nested": [
        {
          "chunks": [
            [ "null", 20 ],
            [ "roof_2x2_utilities_b", 15 ],
            [ "roof_2x2_utilities_c", 5 ],
            [ "roof_2x2_utilities_d", 30 ],
            [ "roof_2x2_utilities", 30 ],
            [ "roof_2x2_golf", 10 ],
            [ "roof_3x3_wine", 10 ]
          ],
          "x": [ 4, 15 ],
          "y": [ 8, 9 ]
        },
        {
          "chunks": [
            [ "null", 20 ],
            [ "roof_4x4_party", 5 ],
            [ "roof_4x4_holdout", 15 ],
            [ "roof_4x4_utility", 40 ],
            [ "roof_4x4_utility_1", 10 ],
            [ "roof_6x6_survivor", 20 ],
            [ "roof_6x6_utility", 20 ]
          ],
          "x": [ 4, 13 ],
          "y": [ 11, 16 ]
        }
      ]
    }
  },
  {
    "type": "mapgen",
    "method": "json",
    "om_terrain": [ "s_gun_1" ],
    "//": "Home defense gun store",
    "weight": 300,
    "object": {
      "fill_ter": "t_floor",
      "rows": [
        "_ssssssssssssssssssssss_",
        "__@@@@@@@_ssss_@@@@@@@__",
        "__##:::##_ssss_##:::##__",
        "__#^...^:_ssss_:^...^#__",
        "__#..a..:_ssss_:..a..#__",
        "__#.n?n.:_ssss_:.n?n.#__",
        "__#.....#::++::#.....#__",
        "__#..................#__",
        "__#..................#__",
        "__#....{{{....{{{....#__",
        "__#....{{{....{{{....#__",
        "__#^................^#__",
        "s##....LLL....LLL....#__",
        "s$#....LLL....LLL....#__",
        "s##..................#__",
        "__#..................#__",
        "__#-D-t-ZZ----ZZ--t--#__",
        "__#&/-.-VVllllVV-..aE#__",
        "__#//-.D........D..aE#__",
        "__#q/-<-llllllll-l...#;_",
        "__#################+##-_",
        "______________________-_",
        "________________________",
        "________________________"
      ]
	  "palettes": [ "gun_store_palette" ],
      "furniture": {
        "V": "f_counter",
		"//": "^ to allow just vending ammo to spawn, not misc items as well"
	  },
      "place_loot": [
        { "group": "vending_ammo", "x": 8, "y": 17, "chance": 90, "repeat": [ 1, 4 ] },
        { "group": "vending_ammo", "x": 9, "y": 17, "chance": 90, "repeat": [ 1, 4 ] },
        { "group": "vending_ammo", "x": 14, "y": 17, "chance": 90, "repeat": [ 1, 4 ] },
        { "group": "vending_ammo", "x": 15, "y": 17, "chance": 90, "repeat": [ 1, 4 ] }
      ]
    }
  },
  {
    "type": "mapgen",
    "method": "json",
    "om_terrain": "s_gun_roof_1",
    "object": {
      "fill_ter": "t_flat_roof",
      "rows": [
        "                        ",
        "                        ",
        "  |222223      |222223  ",
        "  |.....3      |.....3  ",
        "  |.....3      |.....3  ",
        "  |.....3      |.....3  ",
        "  |.....3222222|.....3  ",
        "  |..................3  ",
        "  |..................3  ",
        "  |..................3  ",
        "  |..................3  ",
        "  |..................3  ",
        "  |..................3  ",
        "  |..................3  ",
        "  |..................3  ",
        "  |..................3  ",
        "  |..................3  ",
        "  |.1111.............3  ",
        "  |.+0>1.............3  ",
        "  |.1111.............5  ",
        "  |##################3  ",
        "                        ",
        "                        ",
        "                        "
      ],
      "palettes": [ "roof_palette" ],
      "terrain": { ">": "t_ladder_down", "1": "t_wall_w", "+": "t_door_metal_pickable", "0": "t_thconc_floor" },
      "place_nested": [
        {
          "chunks": [
            [ "null", 20 ],
            [ "roof_2x2_utilities_b", 15 ],
            [ "roof_2x2_utilities_c", 5 ],
            [ "roof_2x2_utilities_d", 30 ],
            [ "roof_2x2_utilities", 30 ]
          ],
          "x": [ 4, 15 ],
          "y": [ 7, 8 ]
        },
        {
          "chunks": [
            [ "null", 20 ],
            [ "roof_4x4_party", 5 ],
            [ "roof_4x4_holdout", 15 ],
            [ "roof_4x4_utility", 40 ],
            [ "roof_4x4_utility_1", 10 ],
            [ "roof_6x6_survivor", 20 ],
            [ "roof_6x6_utility", 20 ]
          ],
          "x": [ 4, 13 ],
          "y": 12
        }
      ]
    }
  },
  {
    "type": "mapgen",
    "method": "json",
    "om_terrain": [ "s_gun_2" ],
    "//": "Public holdout based on Home Defense Gunstore. Uses same roof as s_gunstore_1.",
    "weight": 100,
    "object": {
      "fill_ter": "t_floor",
      "rows": [
        "_ssssssssssssssssssssss_",
        "__@@,,@@@@ssss@@@@@@@@__",
        "__##:N:###ssss###:::##__",
        "__#.NNN..#ssss#5NNNN^#__",
        "__#NaaN..#ssss#5N..r.#__",
        "__#.EN...#ssss#5C....#__",
        "__#......##++##-C....#__",
        "__#.r....aCNNCa......#__",
        "__#..................#__",
        "__#...........d......#__",
        "__#....d.............#__",
        "__#^................^#__",
        "s##.......MMMM.......#__",
        "s$#......MM..MM......#__",
        "s##.....MM...........#__",
        "__#....MM..c.c.cMM.M.#__",
        "__#|F|.|ZZ----ZZ-|F--#__",
        "__#&/|.|ar......-..c.#__",
        "__#//|.F........F.A..#__",
        "__#qr|<|a...N...-.NEA#;_",
        "__#################N##__",
        "________________________",
        "________________________",
        "________________________"
      ],
	  "palettes": [ "gun_store_palette" ],
      "items": { "B": { "item": "bed", "chance": 65, "repeat": [ 1, 3 ] } },
      "monster": { "7": { "monster": "mon_zombie_cop" } },
      "place_monsters": [
        { "monster": "GROUP_ZOMBIE", "x": [ 11, 13 ], "y": [ 17, 19 ], "density": 0.08 },
        { "monster": "GROUP_ZOMBIE", "x": 18, "y": [ 14, 15 ], "density": 0.08 }
      ],
      "place_fields": [
        { "field": "fd_blood", "x": [ 10, 11 ], "y": [ 14, 15 ], "repeat": [ 2, 4 ] },
        { "field": "fd_gibs_flesh", "x": 10, "y": 15, "repeat": [ 1, 5 ] },
        { "field": "fd_blood", "x": 12, "y": [ 14, 15 ], "repeat": [ 2, 3 ] }
      ],
      "place_loot": [
        { "item":  "corpse", "x": 10, "y": 14, "chance": 100 },
        { "item":  "corpse", "x": 12, "y": 15, "chance": 100 },
        { "group": "guns_pistol_common", "x": 10, "y": 14, "chance": 60, "repeat": [ 1, 2 ], "magazine": 100 },
        { "group": "guns_shotgun_common", "x": 12, "y": 15, "chance": 60, "repeat": [ 1, 2 ] },
        { "group": "ammo_common", "x": 18, "y": 4, "chance": 75, "repeat": [ 1, 10 ] },
		{ "group": "ammo_rifle_common", "x": 4, "y": 4, "chance": 75, "repeat": [ 5, 10] },
        { "group": "guns_pistol_rare", "x": 9, "y": 14, "chance": 45, "magazine": 100, "repeat": [ 1, 2 ] },
        { "group": "guns_shotgun_rare", "x": 12, "y": 16, "chance": 10, "magazine": 100, "repeat": [ 1, 2 ] },
		{ "group": "ammo_shotgun_common", "x": 13, "y": [ 15, 16 ], "chance": 75, "repeat": [ 1, 10 ] },
		{ "group": "mags_pistol_rare", "x": 11, "y": [ 14, 15 ], "chance": 25, "repeat": [ 1, 5 ] },
		{ "group": "mags_pistol_common", "x": 10, "y": 13, "chance": 50, "repeat": [ 1, 5 ] },
        { "group": "default_zombie_death_drops", "x": 10, "y": 14, "chance": 100 },
        { "group": "default_zombie_death_drops", "x": 12, "y": 15, "chance": 100 },
        { "item":  "can_food", "x": 8, "y": 18, "chance": 100, "repeat": [ 1, 3 ] },
        { "item":  "can_food", "x": 11, "y": 17, "chance": 100, "repeat": [ 1, 2 ] },
        { "group": "vending_food_items", "x": [ 11, 13 ], "y": [ 17, 19 ], "chance": 85, "repeat": [ 2, 8 ] },
        { "item":  "bottle_plastic_small", "x": [ 11, 12 ], "y": [ 17, 19 ], "chance": 80, "repeat": [ 1, 3 ] },
        { "item":  "pipe", "x": 18, "y": [ 14, 15 ], "chance": 100, "repeat": [ 6, 18 ] },
        { "item":  "sheet_metal_small", "x": 18, "y": [ 14, 15 ], "chance": 85, "repeat": [ 1, 5 ] },
        { "item":  "pipe", "x": [ 14, 15 ], "y": 14, "chance": 70, "repeat": [ 6, 18 ] },
        { "item":  "sheet_metal_small", "x": [ 14, 15 ], "y": 14, "chance": 85, "repeat": [ 1, 5 ] }
      ]
    }
  },
  {
    "method": "json",
    "om_terrain": "s_gun_3",
    "type": "mapgen",
    "weight": 200,
    "object": {
      "fill_ter": "t_floor",
      "rows": [
        ",,,,,,,,B,,,,ss,,,BB,B,,",
        ",,,,,,,B,,,,,ss,,,,,,,,,",
        "B,,,,,,,,,,,,ss,B,B,,,,,",
        ",,B,,,,B,,B,dssss,,,,,,B",
        ",,,,B##::###:#+#:####,,,",
        "B,,,,#X.rD..^....LLL#u,,",
        "B,,,,#{.a?.........L#,,,",
        ",B,,,#{..D..rr.rr..L#u,B",
        ",,,u;#{.....rr.rr..L#u,,",
        "B.####--------D-----#,,,",
        ",u#r.AnA..t.....t..C#u,B",
        ",u#{.....s-.--D--.nn#,,,",
        "B,#{.sssss-.-&rq-O.H#,,,",
        ",,#--------D--------#,,,",
        ",u#.nn..=n...n=..nn.#u,,",
        "Bu#=.=...=.....=...=#u,,",
        ",,W.WWRWWWWRWWWWRWW.W,,,",
        ",,W....=.........=..W,,B",
        "BuW......=..........Wu,,",
        ",,W.................W,,B",
        ",uW.................W,,B",
        "B,W...T....T....T...Wu,,",
        ",,WsssssssssssssssssW,,,",
        ",BWWWWWWWWWWWWWWWWWWW,B."
      ],
	  "palettes": [ "gun_store_palette" ],
      "place_loot": [
        { "group": "ammo_casings_bulk", "x": [ 14, 15 ], "y": 14, "chance": 90, "repeat": [ 5, 15 ] },
        { "group": "guns_common_display", "x": 19, "y": [ 5, 8 ], "chance": 90, "repeat": [ 1, 4 ] },
		{ "group": "guns_common_display", "x": [ 17, 19 ], "y": 5, "chance": 90, "repeat": [ 1, 4 ] },
        { "group": "guns_common_display", "x": 3, "y": 10, "chance": 90, "repeat": [ 1, 4 ] },
        { "group": "gunmod_rare", "x": 3, "y": 12, "chance": 55, "repeat": [ 1, 4 ] },
		{ "group": "guns_common_display", "x": 18, "y": 14, "chance": 90, "repeat": [ 1, 4 ] },
        { "group": "guns_rifle_rare_display", "x": 9, "y": 7, "chance": 90, "repeat": [ 1, 2 ] },
		{ "group": "guns_pistol_rare_display", "x": 9, "y": 6, "chance": 90, "repeat": [ 1, 2 ] },
        { "group": "book_gunmags", "x": 9, "y": 8, "chance": 85, "repeat": [ 2, 6 ] },
        { "group": "guns_pistol_rare_display", "x": 3, "y": 11, "chance": 90, "repeat": [ 1, 2 ] },
        { "group": "gunmod_common", "x": [ 12, 13 ], "y": 9, "chance": 60, "repeat": [ 1, 5 ] },
        { "group": "ammo_common", "x": 6, "y": 5, "chance": 90, "repeat": [ 30, 40 ] },
		{ "group": "ammo_rare", "x": 6, "y": 5, "chance": 90, "repeat": [ 5, 15 ] },
        { "group": "gun_cases", "x": 14 , "y": 9, "chance": 90, "repeat": [ 1, 3 ] },
        { "group": "mags_common", "x": 6, "y": 7, "chance": 90, "repeat": [ 3, 8 ] },
        { "group": "mags_rare", "x": 6, "y": 6, "chance": 90, "repeat": [ 1, 5 ] },
        { "group": "trash", "x": 13, "y": 12, "chance": 45 },
        { "group": "trash", "x": 10, "y": 12, "chance": 45 }
      ]
    }
  },
  {
    "type": "mapgen",
    "method": "json",
    "om_terrain": "s_gun_roof_3",
    "object": {
      "fill_ter": "t_flat_roof",
      "rows": [
        "                        ",
        "                        ",
        "                        ",
        "                        ",
        "     |222222222222223   ",
        "     |..............3   ",
        "     |..............3   ",
        "     |..............3   ",
        "     |..............3   ",
        "  |225..............3   ",
        "  |.................3   ",
        "  |.................3   ",
        "  |.................3   ",
        "  |.................3   ",
        "  |.................3   ",
        "  |.................3   ",
        "  |.................3   ",
        "  |.................3   ",
        "  |.................3   ",
        "  |.................3   ",
        "  |.................3   ",
        "  |.................3   ",
        "  |.................3   ",
        "  2222222222222222223   "
      ],
      "palettes": [ "roof_palette" ],
      "terrain": { "?": "t_open_air_rooved" },
      "place_nested": [
        {
          "chunks": [
            [ "null", 20 ],
            [ "roof_2x2_utilities_b", 15 ],
            [ "roof_2x2_utilities_c", 5 ],
            [ "roof_2x2_utilities_d", 40 ],
            [ "roof_2x2_utilities", 50 ]
          ],
          "x": [ 7, 17 ],
          "y": [ 6, 10 ]
        }
      ]
    }
  }
]
