[
  {
    "type": "mapgen",
    "method": "json",
    "om_terrain": [ "s_gun" ],
    "weight": 300,
    "object": {
      "fill_ter": "t_floor",
      "rows": [
        "  ____________________  ",
        "  *___*___*______*___*  ",
        "  *___*___*______*___*  ",
        "  *___*___*______*___*  ",
        "  *___*___*______*___*  ",
        "  *___*___*______*___*  ",
        "  ---:::--------:::---  ",
        "  |{....#...........d|  ",
        "  |{..S.?...........d|  ",
        "  |{....#...{{..{...d|  ",
        "  |X....#...{{..{...d|  ",
        "  |---..#...{{..{...d|  ",
        "  |&N|..............d|  ",
        "  |..D..........ddddd|  ",
        "  |---:::::::::------|  ",
        " 4|l~~~~~~~~~~~~~~D~<|  ",
        "  |--H--H--H--H--H-+-|  ",
        "  |~~~~~~~~~~~~~~~~~~|  ",
        "  |~~~~~~~~~~~~~~~~~~|  ",
        "  |~~~~~~~~~~~~~~~~~~|  ",
        "  |~~~~~~~~~~~~~~~~~~|  ",
        "  |~~~~~~~~~~~~~~~~~~|  ",
        "  |ssssssssssssssssss|  ",
        "  ====================  "
      ],
      "place_terrain": [
        { "ter": "t_door_metal_pickable", "x": [ 11, 14 ], "y": 6 },
        { "ter": "t_door_metal_pickable", "x": [ 7, 14 ], "y": 14 }
      ],
      "terrain": {
        " ": "t_region_groundcover_urban",
        "*": "t_pavement_y",
        "+": "t_door_metal_pickable",
        "-": "t_wall_w",
        ".": "t_floor",
        ":": "t_window_bars_alarm",
        "=": "t_strconc_wall",
        "_": "t_pavement",
        "~": "t_thconc_floor",
        "H": "t_thconc_floor",
        "s": "t_thconc_floor",
        "l": "t_thconc_floor",
        "|": "t_wall_w",
        "D": "t_door_c",
        "<": "t_ladder_up",
        "4": "t_gutter_downspout"
      },
      "toilets": { "&": {  } },
      "furniture": {
        "?": "f_console_broken",
        "#": "f_counter",
        "H": "f_counter",
        "S": "f_stool",
        "l": "f_locker",
        "s": "f_sandbag_wall",
        "{": "f_rack",
		"X": "f_gunsafe_ml",
		"d": "f_displaycase",
        "N": "f_sink"
      },
      "place_loot": [
        { "group": "clothing_tactical_leg", "x": 16, "y": 11, "chance": 50, "repeat": [ 1, 6 ]},
		{ "group": "clothing_tactical_torso", "x": 16, "y": [ 9, 10 ], "chance": 50, "repeat": [ 1, 6 ]},
		{ "group": "guns_pistol_rare_display", "x": [ 16, 17 ], "y": 13, "chance": 60, "repeat": [ 1, 3 ], "magazine": 100 },
        { "group": "mags_rifle_rare", "x": 3, "y": 9, "chance": 76, "repeat": [ 5, 10 ] },
        { "group": "guns_shotgun_common_display", "x": 18, "y": 13, "chance": 80, "magazine": 100, "repeat": [ 1, 4 ] },
        { "group": "guns_shotgun_rare_display", "x": 19, "y": 13, "chance": 70, "magazine": 100, "repeat": [ 1, 2 ]  },
        { "group": "guns_rifle_common_display", "x": 20, "y": [ 7, 8 ], "chance": 80, "magazine": 100, "repeat": [ 1, 4 ] },
        { "group": "guns_rifle_rare_display", "x": 3, "y": 10, "chance": 70, "repeat": [ 1, 2 ], "magazine": 100 },
        { "group": "guns_rifle_common_display", "x": 20, "y": 9, "chance": 80, "repeat": [ 1, 4 ], "magazine": 100 },
        { "group": "guns_pistol_common_display", "x": 20, "y": [ 10, 13 ], "chance": 80, "repeat": [ 1, 4 ], "magazine": 100 },
        { "group": "ammo_common", "x": 3, "y": 10, "chance": 85, "repeat": [ 30, 40 ] },
		{ "group": "ammo_rare", "x": 3, "y": 10, "chance": 90, "repeat": [ 5, 15 ] },
        { "group": "mags_common", "x": 3, "y": 7, "chance": 65, "repeat": [ 5, 10 ] },
        { "group": "mags_pistol_rare", "x": 3, "y": 8, "chance": 75, "repeat": [ 4, 8 ] },
        { "group": "mags_shotgun_rare", "x": 3, "y": 9, "chance": 75, "repeat": [ 1, 3 ] },
        { "group": "gun_cases", "x": 13, "y": [ 9, 11 ], "chance": 80, "repeat": [ 1, 2 ] },
        { "group": "book_gunmags", "x": 12, "y": [ 9, 11 ], "chance": 90, "repeat": [ 2, 4 ] },
        { "group": "guns_pistol_common_display", "x": 5, "y": 16, "chance": 25, "repeat": [ 1, 2 ], "magazine": 100 },
        { "group": "guns_pistol_rare_display", "x": 8, "y": 16, "chance": 25, "repeat": [ 1, 2 ], "magazine": 100 },
        { "group": "guns_shotgun_common_display", "x": 11, "y": 16, "chance": 25, "repeat": [ 1, 2 ], "magazine": 100 },
        { "group": "guns_pistol_rare_display", "x": 14, "y": 16, "chance": 25, "repeat": [ 1, 2 ], "magazine": 100 },
        { "group": "guns_pistol_common_display", "x": 17, "y": 16, "chance": 25, "repeat": [ 1, 2 ], "magazine": 100}
      ],
      "item": {
        "l": [ { "item": "ear_plugs", "chance": 50, "repeat": 12 }, { "item": "powered_earmuffs", "chance": 30, "repeat": 3 } ]
      },
      "place_monsters": [ { "monster": "GROUP_ZOMBIE", "x": [ 0, 0 ], "y": [ 23, 23 ], "chance": 2, "repeat": [ 2, 3 ] } ]
    }
  },
  {
    "type": "mapgen",
    "method": "json",
    "om_terrain": "s_gun_roof",
    "object": {
      "fill_ter": "t_flat_roof",
      "rows": [
        "                        ",
        "                        ",
        "                        ",
        "                        ",
        "                        ",
        "                        ",
        "  |2222222222222222223  ",
        "  |..................3  ",
        "  |..................3  ",
        "  |..................3  ",
        "  |..................3  ",
        "  |..X...............3  ",
        "  |..................3  ",
        "  |..................3  ",
        "  |...............1113  ",
        "  5...............1>13  ",
        "  |...............1013  ",
        "  |...............1+13  ",
        "  |..................3  ",
        "  |..................3  ",
        "  |..................3  ",
        "  |..................3  ",
        "  |..................3  ",
        "  |------------------3  "
      ],
      "palettes": [ "roof_palette" ],
      "terrain": { ">": "t_ladder_down", "1": "t_wall_w", "+": "t_door_metal_pickable", "0": "t_thconc_floor" },
      "place_nested": [
        {
          "chunks": [
            [ "null", 20 ],
            [ "roof_2x2_utilities_b", 15 ],
            [ "roof_2x2_utilities_c", 5 ],
            [ "roof_2x2_utilities_d", 30 ],
            [ "roof_2x2_utilities", 30 ],
            [ "roof_2x2_golf", 10 ],
            [ "roof_3x3_wine", 10 ]
          ],
          "x": [ 4, 15 ],
          "y": [ 8, 9 ]
        },
        {
          "chunks": [
            [ "null", 20 ],
            [ "roof_4x4_party", 5 ],
            [ "roof_4x4_holdout", 15 ],
            [ "roof_4x4_utility", 40 ],
            [ "roof_4x4_utility_1", 10 ],
            [ "roof_6x6_survivor", 20 ],
            [ "roof_6x6_utility", 20 ]
          ],
          "x": [ 4, 13 ],
          "y": [ 11, 16 ]
        }
      ]
    }
  },
  {
    "type": "mapgen",
    "method": "json",
    "om_terrain": [ "s_gun_1" ],
    "//": "Home defense gun store",
    "weight": 300,
    "object": {
      "fill_ter": "t_floor",
      "rows": [
        "_ssssssssssssssssssssss_",
        "_s@@@@@@@_ssss_@@@@@@@s_",
        "_s||555||_ssss_||555||s_",
        "_s|#####5_ssss_5#####|s_",
        "_s|..a..5_ssss_5..a..|s_",
        "_s|.#?#.5_ssss_5.#?#.|s_",
        "_s|.....|55++55|.....|s_",
        "_s|..................|s_",
        "_s|..................|s_",
        "_s|....ddd....ddd....|s_",
        "_s|....ddd....ddd....|s_",
        "_s|^................^|s_",
        "_||....rrr....rrr....|s_",
        "_A|....rrr....rrr....|s_",
        "_||..................|s_",
        "_s|..................|s_",
        "_s||D|*|&&&&&&&&||+|||s_",
        "_s|;.|.|rr####rr|..cE|s_",
        "_s|..|.|........*...E|s_",
        "_s|S.|<|lll##lll|l...|4_",
        "_s|||||||||||||||||+||s_",
        "_ssssssssssssssssssssss_",
        "________________________",
        "________________________"
      ],
      "terrain": {
        "&": "t_bars",
        "*": "t_door_locked_alarm",
        "+": "t_door_metal_pickable",
        ".": "t_floor",
        "5": "t_window_bars_alarm",
        "@": "t_region_shrub_decorative",
        "A": "t_atm",
        "D": "t_door_c",
        "L": "t_door_metal_locked",
        "_": "t_pavement",
        "s": "t_sidewalk",
        "|": "t_wall_w",
        "<": "t_ladder_up",
        "4": "t_gutter_downspout"
      },
      "furniture": {
        "?": "f_console_broken",
        "#": "f_counter",
        "a": "f_stool",
        "E": "f_desk",
        "S": "f_sink",
        "^": "f_indoor_plant",
        "c": "f_chair",
        "l": "f_locker",
		"d": "f_displaycase",
        "r": "f_rack"
      },
      "toilets": { ";": {  } },
      "place_loot": [
        { "group": "vending_ammo", "x": 8, "y": 17, "chance": 90, "repeat": [ 1, 4 ] },
        { "group": "vending_ammo", "x": 9, "y": 17, "chance": 90, "repeat": [ 1, 4 ] },
        { "group": "vending_ammo", "x": 14, "y": 17, "chance": 90, "repeat": [ 1, 4 ] },
        { "group": "vending_ammo", "x": 15, "y": 17, "chance": 90, "repeat": [ 1, 4 ] },
        { "group": "guns_pistol_rare_display", "x": [ 8, 9 ], "y": 19, "chance": 90, "magazine": 100, "repeat": [ 1, 2 ] },
        { "group": "guns_shotgun_rare_display", "x": 10, "y": 19, "chance": 90, "magazine": 100, "repeat": [ 1, 2 ]  },
        { "group": "guns_rifle_common_display", "x": [ 13, 15 ], "y": 19, "chance": 90, "magazine": 100, "repeat": [ 1, 4 ] },
        { "group": "guns_pistol_common_display", "x": 14, "y": [ 9, 10 ], "chance": 90, "magazine": 100, "repeat": [ 1, 6 ] },
        { "group": "guns_shotgun_rare_display", "x": 15, "y": 9, "chance": 90, "repeat": [ 1, 2 ] },
        { "group": "guns_rifle_rare_display", "x": 15, "y": 10, "chance": 90, "magazine": 100, "repeat": [ 1, 2 ] },
		{ "group": "guns_shotgun_common_display", "x": [ 10, 13 ], "y": 17, "chance": 90, "repeat": [ 1, 4 ] },
        { "group": "guns_pistol_common_display", "x": [ 7, 9 ], "y": [ 9, 10 ], "chance": 90, "magazine": 100, "repeat": [ 1, 6 ] },
        { "group": "mags_common", "x": [ 7, 9 ], "y": [ 12, 13 ], "chance": 90, "repeat": [ 5, 15 ] },
        { "group": "mags_rare", "x": [ 14, 16 ], "y": [ 12, 13 ], "chance": 90, "repeat": [ 1, 5 ] }
      ]
    }
  },
  {
    "type": "mapgen",
    "method": "json",
    "om_terrain": "s_gun_roof_1",
    "object": {
      "fill_ter": "t_flat_roof",
      "rows": [
        "                        ",
        "                        ",
        "  |222223      |222223  ",
        "  |.....3      |.....3  ",
        "  |.....3      |.....3  ",
        "  |.....3      |.....3  ",
        "  |.....3222222|.....3  ",
        "  |..................3  ",
        "  |..................3  ",
        "  |..................3  ",
        "  |..................3  ",
        "  |..................3  ",
        "  |..................3  ",
        "  |..................3  ",
        "  |..................3  ",
        "  |..................3  ",
        "  |..................3  ",
        "  |.1111.............3  ",
        "  |.+0>1.............3  ",
        "  |.1111.............5  ",
        "  |------------------3  ",
        "                        ",
        "                        ",
        "                        "
      ],
      "palettes": [ "roof_palette" ],
      "terrain": { ">": "t_ladder_down", "1": "t_wall_w", "+": "t_door_metal_pickable", "0": "t_thconc_floor" },
      "place_nested": [
        {
          "chunks": [
            [ "null", 20 ],
            [ "roof_2x2_utilities_b", 15 ],
            [ "roof_2x2_utilities_c", 5 ],
            [ "roof_2x2_utilities_d", 30 ],
            [ "roof_2x2_utilities", 30 ]
          ],
          "x": [ 4, 15 ],
          "y": [ 7, 8 ]
        },
        {
          "chunks": [
            [ "null", 20 ],
            [ "roof_4x4_party", 5 ],
            [ "roof_4x4_holdout", 15 ],
            [ "roof_4x4_utility", 40 ],
            [ "roof_4x4_utility_1", 10 ],
            [ "roof_6x6_survivor", 20 ],
            [ "roof_6x6_utility", 20 ]
          ],
          "x": [ 4, 13 ],
          "y": 12
        }
      ]
    }
  },
  {
    "type": "mapgen",
    "method": "json",
    "om_terrain": [ "s_gun_2" ],
    "//": "Public holdout based on Home Defense Gunstore. Uses same roof as s_gunstore_1.",
    "weight": 100,
    "object": {
      "fill_ter": "t_floor",
      "rows": [
        "_ssssssssssssssssssssss_",
        "_s@@xx@@@_ssss_@@@@@@@s_",
        "_s||5l5||_ssss_||555||s_",
        "_s|#lll#5_ssss_5#####|s_",
        "_s|do#d#5_ssss_5l.X..|s_",
        "_s|.dd.#5_ssss_5#....|s_",
        "_s|.....|55++55|#....|s_",
        "_s|......##ll##......|s_",
        "_s|..................|s_",
        "_s|...........d......|s_",
        "_s|....d.............|s_",
        "_s|^................^|s_",
        "_||.......rrrr.......|s_",
        "_A|......dr..rr......|s_",
        "_||.....dr...........|s_",
        "_s|....dr..B.B.rdd.d.|s_",
        "_s||D|D|&&&&&&&&||p|||s_",
        "_s|;.|.|B.......|..c.|s_",
        "_s|..|.|........C.#..|s_",
        "_s|S.|<|B...B...|.EE#|4_",
        "_s|||||||||||||||||L||s_",
        "_ssssssssssssssssssssss_",
        "________________________",
        "________________________"
      ],
      "terrain": {
        "&": "t_bars",
        "*": "t_door_locked_alarm",
        "+": "t_door_metal_pickable",
        ".": "t_floor",
        "5": "t_window_bars_alarm",
        "@": "t_region_shrub_decorative",
        "A": "t_atm",
        "C": "t_door_frame",
        "D": "t_door_o",
        "L": "t_door_metal_locked",
        "_": "t_pavement",
        "p": "t_door_metal_o",
        "s": "t_sidewalk",
        "|": "t_wall_w",
        "x": "t_region_groundcover_barren",
        "<": "t_ladder_up",
        "4": "t_gutter_downspout"
      },
      "furniture": {
        "#": "f_counter",
        "E": "f_desk",
        "S": "f_sink",
        "^": "f_indoor_plant",
        "c": "f_chair",
        "l": "f_locker",
        "r": "f_rack",
        "x": "f_locker",
		"o": "f_gunsafe_o",
		"X": "f_gunsafe_mj",
		"d": "f_displaycase"
      },
      "toilets": { ";": {  } },
      "items": { "B": { "item": "bed", "chance": 65, "repeat": [ 1, 3 ] } },
      "monster": { "7": { "monster": "mon_zombie_cop" } },
      "place_monsters": [
        { "monster": "GROUP_ZOMBIE", "x": [ 11, 13 ], "y": [ 17, 19 ], "density": 0.08 },
        { "monster": "GROUP_ZOMBIE", "x": 18, "y": [ 14, 15 ], "density": 0.08 }
      ],
      "place_fields": [
        { "field": "fd_blood", "x": [ 10, 11 ], "y": [ 14, 15 ], "repeat": [ 2, 4 ] },
        { "field": "fd_gibs_flesh", "x": 10, "y": 15, "repeat": [ 1, 5 ] },
        { "field": "fd_blood", "x": 12, "y": [ 14, 15 ], "repeat": [ 2, 3 ] }
      ],
      "place_loot": [
        { "item":  "corpse", "x": 10, "y": 14, "chance": 100 },
        { "item":  "corpse", "x": 12, "y": 15, "chance": 100 },
        { "group": "guns_pistol_common", "x": 10, "y": 14, "chance": 60, "repeat": [ 1, 2 ], "magazine": 100 },
        { "group": "guns_shotgun_common", "x": 12, "y": 15, "chance": 60, "repeat": [ 1, 2 ] },
        { "group": "ammo_common", "x": 18, "y": 4, "chance": 75, "repeat": [ 1, 10 ] },
		{ "group": "ammo_rifle_common", "x": 4, "y": 4, "chance": 75, "repeat": [ 5, 10] },
        { "group": "guns_pistol_rare", "x": 9, "y": 14, "chance": 45, "magazine": 100, "repeat": [ 1, 2 ] },
        { "group": "guns_shotgun_rare", "x": 12, "y": 16, "chance": 10, "magazine": 100, "repeat": [ 1, 2 ] },
		{ "group": "ammo_shotgun_common", "x": 13, "y": [ 15, 16 ], "chance": 75, "repeat": [ 1, 10 ] },
		{ "group": "mags_pistol_rare", "x": 11, "y": [ 14, 15 ], "chance": 25, "repeat": [ 1, 5 ] },
		{ "group": "mags_pistol_common", "x": 10, "y": 13, "chance": 50, "repeat": [ 1, 5 ] },
        { "group": "default_zombie_death_drops", "x": 10, "y": 14, "chance": 100 },
        { "group": "default_zombie_death_drops", "x": 12, "y": 15, "chance": 100 },
        { "item":  "can_food", "x": 8, "y": 18, "chance": 100, "repeat": [ 1, 3 ] },
        { "item":  "can_food", "x": 11, "y": 17, "chance": 100, "repeat": [ 1, 2 ] },
        { "group": "vending_food_items", "x": [ 11, 13 ], "y": [ 17, 19 ], "chance": 85, "repeat": [ 2, 8 ] },
        { "item":  "bottle_plastic_small", "x": [ 11, 12 ], "y": [ 17, 19 ], "chance": 80, "repeat": [ 1, 3 ] },
        { "item":  "pipe", "x": 18, "y": [ 14, 15 ], "chance": 100, "repeat": [ 6, 18 ] },
        { "item":  "sheet_metal_small", "x": 18, "y": [ 14, 15 ], "chance": 85, "repeat": [ 1, 5 ] },
        { "item":  "pipe", "x": [ 14, 15 ], "y": 14, "chance": 70, "repeat": [ 6, 18 ] },
        { "item":  "sheet_metal_small", "x": [ 14, 15 ], "y": 14, "chance": 85, "repeat": [ 1, 5 ] }
      ]
    }
  },
  {
    "method": "json",
    "om_terrain": "s_gun_3",
    "type": "mapgen",
    "weight": 200,
    "object": {
      "fill_ter": "t_floor",
      "rows": [
        "....d...d....dss..dd.d..",
        ".......d......ss........",
        "d.............ssd.d.....",
        "..d....d..d.dssss......d",
        "....dwWeaWwwWaffaWwwa...",
        "d....WX_Cc__^____DDDWu..",
        "d....ar__D_________Dw...",
        ".d...|r__D_________D|u.d",
        "...u4|__cc_________D|u..",
        "d.||||______rrr__||||...",
        ".u|{_|||||_______+_C|u.d",
        ".u|{_+______||+|||_t|...",
        "d.|{_|___|&_|;_N|i_H|...",
        "..|||||e|||g|||||||||...",
        ".u-___________tt_tt_-u..",
        "du-_________________-u..",
        "..-b#-bdSSSSbS.SS-Sb-...",
        "..-ddd..........dddd-..d",
        "du-ddddd.d.....ddddd-u..",
        "..-ddddddddddddddddd-..d",
        ".u-ddddddddddddddddd-..d",
        "d.-#dTdddddTdddddTd#-u..",
        "..-#################-...",
        ".d-------------------.d."
      ],
      "terrain": {
        "#": "t_region_groundcover_barren",
        "+": "t_door_metal_pickable",
        "-": "t_brick_wall",
        ".": "t_region_groundcover_urban",
        "S": "t_region_groundcover_urban",
        "T": "t_region_groundcover_barren",
        "W": "t_wall_w",
        "_": "t_floor",
        "a": "t_wall_r",
        "b": "t_region_groundcover_barren",
        "d": "t_region_groundcover_barren",
        "e": "t_window_boarded",
        "f": "t_door_boarded",
        "g": "t_door_c",
        "s": "t_sidewalk",
        "u": "t_region_shrub",
        "w": "t_wall_b",
        "|": "t_wall_w",
        "4": "t_gutter_downspout"
      },
      "toilets": { ";": {  } },
      "furniture": {
        "#": "f_sandbag_wall",
        "&": "f_trashcan",
        "C": "f_chair",
        "D": "f_displaycase",
        "H": "f_armchair",
        "S": "f_sandbag_half",
        "T": "f_table",
        "^": "f_indoor_plant_y",
        "b": "f_sandbag_half",
        "c": "f_counter",
        "i": "f_indoor_plant",
        "r": "f_rack",
        "t": "f_table",
        "N": "f_sink",
        "{": "f_locker",
		"X": "f_gunsafe_ml"
      },
      "place_loot": [
        { "group": "ammo_casings_bulk", "x": [ 14, 15 ], "y": 14, "chance": 90, "repeat": [ 5, 15 ] },
        { "group": "guns_common_display", "x": 19, "y": [ 5, 8 ], "chance": 90, "repeat": [ 1, 4 ] },
		{ "group": "guns_common_display", "x": [ 17, 19 ], "y": 5, "chance": 90, "repeat": [ 1, 4 ] },
        { "group": "guns_common_display", "x": 3, "y": 10, "chance": 90, "repeat": [ 1, 4 ] },
        { "group": "gunmod_rare", "x": 3, "y": 12, "chance": 55, "repeat": [ 1, 4 ] },
		{ "group": "guns_common_display", "x": 18, "y": 14, "chance": 90, "repeat": [ 1, 4 ] },
        { "group": "guns_rifle_rare_display", "x": 9, "y": 7, "chance": 90, "repeat": [ 1, 2 ] },
		{ "group": "guns_pistol_rare_display", "x": 9, "y": 6, "chance": 90, "repeat": [ 1, 2 ] },
        { "group": "book_gunmags", "x": 9, "y": 8, "chance": 85, "repeat": [ 2, 6 ] },
        { "group": "guns_pistol_rare_display", "x": 3, "y": 11, "chance": 90, "repeat": [ 1, 2 ] },
        { "group": "gunmod_common", "x": [ 12, 13 ], "y": 9, "chance": 60, "repeat": [ 1, 5 ] },
        { "group": "ammo_common", "x": 6, "y": 5, "chance": 90, "repeat": [ 30, 40 ] },
		{ "group": "ammo_rare", "x": 6, "y": 5, "chance": 90, "repeat": [ 5, 15 ] },
        { "group": "gun_cases", "x": 14 , "y": 9, "chance": 90, "repeat": [ 1, 3 ] },
        { "group": "mags_common", "x": 6, "y": 7, "chance": 90, "repeat": [ 3, 8 ] },
        { "group": "mags_rare", "x": 6, "y": 6, "chance": 90, "repeat": [ 1, 5 ] },
        { "group": "trash", "x": 13, "y": 12, "chance": 45 },
        { "group": "trash", "x": 10, "y": 12, "chance": 45 }
      ]
    }
  },
  {
    "type": "mapgen",
    "method": "json",
    "om_terrain": "s_gun_roof_3",
    "object": {
      "fill_ter": "t_flat_roof",
      "rows": [
        "                        ",
        "                        ",
        "                        ",
        "                        ",
        "     |222222222222223   ",
        "     |..............3   ",
        "     |..............3   ",
        "     |..............3   ",
        "     |..............3   ",
        "  |225..............3   ",
        "  |.................3   ",
        "  |.................3   ",
        "  |.................3   ",
        "  |-----------------3   ",
        "  ???????????????????   ",
        "  ???????????????????   ",
        "  ?  ?           ?  ?   ",
        "  ?                 ?   ",
        "  ?                 ?   ",
        "  ?                 ?   ",
        "  ?                 ?   ",
        "  ?                 ?   ",
        "  ?                 ?   ",
        "  ???????????????????   "
      ],
      "palettes": [ "roof_palette" ],
      "terrain": { "?": "t_open_air_rooved" },
      "place_nested": [
        {
          "chunks": [
            [ "null", 20 ],
            [ "roof_2x2_utilities_b", 15 ],
            [ "roof_2x2_utilities_c", 5 ],
            [ "roof_2x2_utilities_d", 40 ],
            [ "roof_2x2_utilities", 50 ]
          ],
          "x": [ 7, 17 ],
          "y": [ 6, 10 ]
        }
      ]
    }
  }
]
