[
  {
    "type": "mapgen",
    "method": "json",
    "om_terrain": [ "small_storage_units" ],
    "object": {
      "fill_ter": "t_thconc_floor",
      "rows": [
        "sssssss..........sssssss",
        "sssssss..........sssssss",
        "sssssss..........sssssss",
        "sssssss..........sssssss",
        "#######ppp....ppp#######",
        "#__JJJc..........cJ__bb#",
        "#M___J#8........8#Jt__b#",
        "#M____7..........7_____#",
        "#__t__7..........7__MM_#",
        "#__M__7..........7___M_#",
        "#######ppp....ppp#######",
        "#__{b_#..........#___MJ#",
        "#t__M_#q........8#___M_#",
        "#M___^^.........._____M#",
        "#___^^^.........._J___M#",
        "#JJ___^q.........___b_t#",
        "#######pRp....ppp#######",
        "#M__t_7..........7_{_M_#",
        "#_____7..........7_____#",
        "#_M___7..........7_MM__#",
        "#____J#8........8#J_J_M#",
        "#_J_MJc..........cJ___t#",
        "#######ppp....ppp#######",
        "666666666666666666666666"
      ],
      "palettes": [ "storage_unit_palette" ],
      "place_loot": [ { "item": "television", "x": 3, "y": 6, "chance": 75 }, { "item": "stepladder", "x": 5, "y": 19, "chance": 100 } ],
      "place_items": [
        { "item": "novels", "x": 2, "y": 17, "chance": 30 },
        { "item": "novels", "x": 2, "y": 15, "chance": 10 },
        { "item": "novels", "x": 22, "y": 7, "chance": 30 },
        { "item": "novels", "x": 22, "y": 5, "chance": 30 },
        { "item": "tools_earthworking", "x": 1, "y": 17, "chance": 10 },
        { "item": "tools_earthworking", "x": 4, "y": 12, "chance": 10 },
        { "item": "tools_earthworking", "x": 19, "y": 5, "chance": 10 },
        { "item": "camping", "x": 19, "y": 11, "chance": 30 },
        { "item": "textbooks", "x": [ 3, 4 ], "y": 9, "chance": 10 },
        { "item": "tools_electronics", "x": [ 20, 21 ], "y": 17, "chance": 20 },
        { "item": "tools_electronics", "x": 22, "y": 9, "chance": 20 },
        { "item": "tools_home", "x": 22, "y": 12, "chance": 15 },
        { "item": "tools_home", "x": 1, "y": 8, "chance": 25 },
        { "item": "SUS_trash_floor", "x": 4, "y": 21, "chance": 25 },
        { "item": "SUS_trash_floor", "x": 18, "y": 20, "chance": 25 },
        { "item": "SUS_trash_floor", "x": 14, "y": 20, "chance": 25 },
        { "item": "SUS_trash_floor", "x": 18, "y": 15, "chance": 25 },
        { "item": "SUS_trash_floor", "x": 8, "y": 14, "chance": 25 },
        { "item": "SUS_trash_floor", "x": 18, "y": 7, "chance": 25 },
        { "item": "SUS_trash_floor", "x": 12, "y": 4, "chance": 25 },
        { "item": "alcohol", "x": 22, "y": 14, "chance": 25 },
        { "item": "jackets", "x": 20, "y": 19, "chance": 10 },
        { "item": "jackets", "x": 20, "y": 12, "chance": 10 },
        { "item": "jackets", "x": 2, "y": 11, "chance": 30 },
        { "item": "jackets", "x": 19, "y": 9, "chance": 10 },
        { "item": "shoes", "x": 20, "y": 21, "chance": 25 },
        { "item": "shoes", "x": 1, "y": 19, "chance": 25 },
        { "item": "homebooks", "x": 22, "y": 11, "chance": 100 }
      ],
      "place_monsters": [
        { "monster": "GROUP_ZOMBIE", "x": 21, "y": 19, "chance": 6 },
        { "monster": "GROUP_ZOMBIE", "x": 3, "y": 19, "chance": 6 },
        { "monster": "GROUP_ZOMBIE", "x": 21, "y": 13, "chance": 6 },
        { "monster": "GROUP_ZOMBIE", "x": 3, "y": 13, "chance": 6 },
        { "monster": "GROUP_ZOMBIE", "x": 20, "y": 7, "chance": 6 },
        { "monster": "GROUP_ZOMBIE", "x": 3, "y": 7, "chance": 6 }
      ]
    }
  },
  {
    "type": "mapgen",
    "method": "json",
    "om_terrain": "small_storage_units_roof",
    "object": {
      "fill_ter": "t_tar_flat_roof",
      "rows": [
        "                        ",
        "                        ",
        "                        ",
        "                        ",
        ".......          .......",
        ".......          .......",
        ".......          .......",
        ".......          .......",
        ".......          .......",
        ".......          .......",
        ".......          .......",
        ".......          .......",
        ".......          .......",
        ".......          .......",
        ".......          .......",
        ".......          .......",
        ".......          .......",
        ".......          .......",
        ".......          .......",
        ".......          .......",
        ".......          .......",
        ".......          .......",
        ".......          .......",
        "                        "
      ],
      "palettes": [ "roof_palette" ],
      "terrain": { ".": "t_tar_flat_roof" }
    }
  },
  {
    "type": "mapgen",
    "method": "json",
    "om_terrain": [ "small_storage_units_1" ],
    "object": {
      "fill_ter": "t_thconc_floor",
      "rows": [
        "######...######...######",
        "#bbJ8#8..#____#..8#8__M#",
        "#bbJJ7.p.7____#.p.7J_JJ#",
        "#dM__7...7____#...7__JJ#",
        "#vJJ_#..8#8___#...#_Jdv#",
        "######.p.###w##.p.######",
        "#____#...s^ss^s...#_JJ_#",
        "#M___7..^#w_ww#...7__JM#",
        "#____7.p.#_w__#.p.7J__J#",
        "#M_M8#8..#____#..8#8ooo#",
        "######...#_MM_#...######",
        "ssssss.p.######.p.ssssss",
        "######...#KKKK#...######",
        "#uuu8#8..#KKKK#..8#8_MM#",
        "#u_u_7.p.6ssss6.p.7___M#",
        "#u_M_7...6ssss6...7__MM#",
        "#uuu_#...ssssss...#___M#",
        "######.p.######.p.######",
        "#____#..8#8___#...#__ww#",
        "#_M__7...7__w_#...7___w#",
        "#M_M_7.p.7____#.p.7_wMM#",
        "#___8#8..#__ww#..8#8LLL#",
        "######...######...######",
        "666666666666666666666666"
      ],
      "palettes": [ "storage_unit_palette" ],
      "place_loot": [ { "item": "television", "x": 3, "y": 6, "chance": 75 }, { "item": "stepladder", "x": 5, "y": 19, "chance": 100 } ],
      "items": {
        "_": { "item": "SUS_trash_floor", "chance": 20 },
        "o": { "item": "novels", "chance": 70 },
        "b": { "item": "bed", "chance": 10 },
        "v": { "item": "jackets", "chance": 35 },
        "u": { "item": "tools_home", "chance": 20 },
        "K": { "item": "SUS_trash_floor", "chance": 70, "repeat": 3 },
        "d": { "item": "dresser", "chance": 50 },
        "L": { "item": "cleaning", "chance": 70 }
      },
      "place_monsters": [ { "monster": "GROUP_ZOMBIE", "x": 1, "y": 24, "chance": 5 } ]
    }
  },
  {
    "type": "mapgen",
    "method": "json",
    "om_terrain": "small_storage_units_roof_1",
    "object": {
      "fill_ter": "t_tar_flat_roof",
      "rows": [
        "......   ......   ......",
        "......   ......   ......",
        "......   ......   ......",
        "......   ......   ......",
        "......   ......   ......",
        "......   ......   ......",
        "......            ......",
        "......   ......   ......",
        "......   ......   ......",
        "......   ......   ......",
        "......   ......   ......",
        "         ......         ",
        "......   .    .   ......",
        "......   .    .   ......",
        "......            ......",
        "......            ......",
        "......            ......",
        "......   ......   ......",
        "......   ......   ......",
        "......   ......   ......",
        "......   ......   ......",
        "......   ......   ......",
        "......   ......   ......",
        "                        "
      ],
      "palettes": [ "roof_palette" ],
      "terrain": { ".": "t_tar_flat_roof" }
    }
  }
]
