[
  {
    "type": "mapgen",
    "om_terrain": "stripclub",
    "object": {
      "fill_ter": { "param": "carpet_color_type", "fallback": "t_carpet_purple" },
      "rows": [
        "........__..............",
        "........__#############.",
        "........__#  o,,|@c@c@#.",
        "........__+  oá,|á,á,á#.",
        "^##########  |,,*,,,,,#.",
        ".#hth hthy|  *,,|BB,,,#.",
        ".#§       |ee||||||,,|#.",
        ".#h hth        Y|l,,,l#.",
        ".#t             |l,,,l#.",
        ".#h             |l,,,l#.",
        ".#              |l,,,l#.",
        ".#y    hhhhhhh §||,,,|#.",
        ".#H  h----------|,,,,,#.",
        ".#H  h-,,,,,,,,,E,,SSS#.",
        ".#H  h----------||+|||#.",
        ".#H    hhhhhhh  |L''''#.",
        ".#              |'''|+#.",
        ".#             y|&à&|T#.",
        ".#Á Á Á         ||||||#.",
        ".#ààààà|  HHHt  +'''''#.",
        ".#'''''+        |'|+|+#.",
        ".#FF&FF|y HHHt§Y|&|T|T#.",
        ".######################.",
        "......................^."
      ],
      "palettes": [ "stripclub_palette" ],
      "terrain": {
        "'": { "param": "linoleum_color", "fallback": "t_linoleum_gray" },
        "g": { "param": "linoleum_color", "fallback": "t_linoleum_gray" },
        "&": { "param": "linoleum_color", "fallback": "t_linoleum_gray" },
        "T": { "param": "linoleum_color", "fallback": "t_linoleum_gray" },
        "L": { "param": "linoleum_color", "fallback": "t_linoleum_gray" },
        "à": { "param": "linoleum_color", "fallback": "t_linoleum_gray" },
        "F": { "param": "linoleum_color", "fallback": "t_linoleum_gray" },
        "E": "t_thconc_floor",
        "|": "t_wall_r",
        "c": "t_thconc_floor",
        "@": "t_thconc_floor"
      },
      "furniture": { "@": "f_sink", "à": "f_counter" },
      "items": {
        "l": [
          { "item": "female_underwear_bottom", "chance": 60, "repeat": [ 1, 3 ] },
          { "item": "female_underwear_top", "chance": 60, "repeat": [ 1, 3 ] },
          { "item": "dresser_female", "chance": 50, "repeat": [ 1, 2 ] },
          { "item": "sex_lair", "chance": 40, "repeat": [ 1, 2 ] }
        ],
        "-": [ { "item": "female_underwear_bottom", "chance": 15 }, { "item": "female_underwear_top", "chance": 15 } ],
        "_": { "item": "sex_lair", "chance": 10 },
        "g": { "item": "alcohol", "chance": 80, "repeat": [ 1, 6 ] },
        "à": { "item": "alcohol", "chance": 30 },
        "t": { "item": "alcohol", "chance": 15 }
      },
      "toilets": { "T": {  } },
      "place_fields": [
        { "field": "fd_blood", "x": [ 2, 7 ], "y": [ 5, 18 ], "repeat": [ 1, 5 ] },
        { "field": "fd_bile", "x": [ 2, 7 ], "y": [ 5, 18 ], "repeat": [ 1, 16 ] },
        { "field": "fd_blood", "x": [ 8, 15 ], "y": [ 7, 21 ], "repeat": [ 1, 5 ] },
        { "field": "fd_bile", "x": [ 8, 15 ], "y": [ 7, 21 ], "repeat": [ 1, 16 ] }
      ],
      "item": {
        ".": [
          { "item": "bottle_glass", "chance": 4 },
          { "item": "can_drink", "chance": 2 },
          { "item": "glass_shard", "chance": 7 }
        ]
      },
      "place_loot": [ { "group": "cash_register_random", "x": [ 2, 6 ], "y": 19 } ],
      "place_monsters": [ { "monster": "GROUP_RESORT_DANCERS", "x": [ 2, 22 ], "y": [ 2, 22 ], "density": 0.5 } ],
      "nested": { "§": { "chunks": [ "fire_extinguisher" ] } }
    }
  },
  {
    "type": "mapgen",
    "om_terrain": "stripclub_roof",
    "object": {
      "fill_ter": "t_flat_roof",
      "rows": [
        "                        ",
        "          ------------- ",
        "          -...........- ",
        "          -...:...&...- ",
        " ----------...........- ",
        " -....................- ",
        " -....................- ",
        " -....................- ",
        " -....................- ",
        " -....................5 ",
        " -....................- ",
        " -....................- ",
        " -....................- ",
        " -....................- ",
        " -....................- ",
        " -....................- ",
        " -....................- ",
        " -....................- ",
        " -....................- ",
        " -....................- ",
        " -.................=..- ",
        " -....................- ",
        " ---------------------- ",
        "                        "
      ],
      "palettes": [ "roof_palette" ],
      "place_nested": [
        {
          "chunks": [
            [ "null", 20 ],
            [ "roof_2x2_utilities_b", 15 ],
            [ "roof_2x2_utilities_c", 5 ],
            [ "roof_2x2_utilities_d", 40 ],
            [ "roof_2x2_utilities", 50 ]
          ],
          "x": [ 4, 17 ],
          "y": [ 5, 15 ]
        }
      ]
    }
  },
  {
    "om_terrain": "stripclub_1",
    "type": "mapgen",
    "object": {
      "fill_ter": "t_thconc_floor",
      "rows": [
        "..........___...........",
        "..........___...........",
        "..########___##########.",
        "..#&á'QQL#___#y  +'&FF#.",
        "..#c'''''##+##   |''''#.",
        "..#&á'|'áo   e   |((((#.",
        "..#c''|''*   e   YÁÁÁÁ#.",
        "..#&á'||||||||       §#.",
        "..#B''HHH|CtC   CtC  C#.",
        "..#B'''''|           t#.",
        "..#B'''''|           C#.",
        "..#l'bb'l|§ hhhhh     #.",
        "..#l'bb'l|-------h    #.",
        "..#l'bb''|;;;;,;-h   Y#.",
        "..#l'''''E;;;;I;-h   y#.",
        "..#l'''''|;;;;;;-h    #.",
        "..#llllll|-------h   S#.",
        "..#|||||||y hhhhh    S#.",
        "..#''''''+           S#.",
        "..#+||'''|           t#^",
        "..#'T|&c&|Y hth §SSSty#.",
        "..#####################.",
        "........................",
        "........................"
      ],
      "palettes": [ "stripclub_palette" ],
      "terrain": {
        "'": { "param": "linoleum_color", "fallback": "t_linoleum_gray" },
        "T": { "param": "linoleum_color", "fallback": "t_linoleum_gray" },
        "c": { "param": "linoleum_color", "fallback": "t_linoleum_gray" },
        "B": { "param": "linoleum_color", "fallback": "t_linoleum_gray" },
        "&": { "param": "linoleum_color", "fallback": "t_linoleum_gray" },
        "F": { "param": "linoleum_color", "fallback": "t_linoleum_gray" },
        "l": { "param": "linoleum_color", "fallback": "t_linoleum_gray" },
        "Q": { "param": "linoleum_color", "fallback": "t_linoleum_gray" },
        "E": { "param": "linoleum_color", "fallback": "t_linoleum_gray" },
        "H": { "param": "linoleum_color", "fallback": "t_linoleum_gray" },
        "á": { "param": "linoleum_color", "fallback": "t_linoleum_gray" },
        "L": { "param": "linoleum_color", "fallback": "t_linoleum_gray" },
        "(": { "param": "linoleum_color", "fallback": "t_linoleum_gray" },
        "b": { "param": "linoleum_color", "fallback": "t_linoleum_gray" },
        ";": { "param": "carpet_color_type", "fallback": "t_carpet_red" },
        "I": { "param": "carpet_color_type", "fallback": "t_carpet_red" }
      },
      "items": {
        "l": [
          { "item": "female_underwear_bottom", "chance": 60, "repeat": [ 1, 3 ] },
          { "item": "female_underwear_top", "chance": 60, "repeat": [ 1, 3 ] },
          { "item": "dresser_female", "chance": 50, "repeat": [ 1, 2 ] },
          { "item": "sex_lair", "chance": 40, "repeat": [ 1, 2 ] },
          { "item": "softdrugs", "chance": 10, "repeat": [ 1, 2 ] },
          { "item": "harddrugs", "chance": 10, "repeat": [ 1, 2 ] },
          { "item": "contraband", "chance": 5, "repeat": [ 1, 2 ] }
        ],
        "-": [ { "item": "female_underwear_bottom", "chance": 15 }, { "item": "female_underwear_top", "chance": 15 } ],
        "3": { "item": "office_breakroom", "chance": 50, "repeat": [ 1, 2 ] },
        "b": [
          { "item": "office_breakroom", "chance": 30 },
          { "item": "female_underwear_bottom", "chance": 20 },
          { "item": "female_underwear_top", "chance": 20 }
        ],
        "t": [ { "item": "alcohol", "chance": 30 }, { "item": "softdrugs", "chance": 10 }, { "item": "harddrugs", "chance": 10 } ],
        "S": [
          { "item": "alcohol", "chance": 15 },
          { "item": "softdrugs", "chance": 10 },
          { "item": "harddrugs", "chance": 10 },
          { "item": "stripclub_dirty", "chance": 40 },
          { "item": "contraband", "chance": 10 }
        ],
        ";": { "item": "sex_lair", "chance": 10 },
        "F": { "item": "alcohol", "chance": 60, "repeat": [ 1, 3 ] },
        "(": { "item": "alcohol", "chance": 15 }
      },
      "place_fields": [
        { "field": "fd_blood", "x": [ 10, 21 ], "y": [ 8, 20 ], "repeat": [ 1, 8 ] },
        { "field": "fd_bile", "x": [ 10, 21 ], "y": [ 8, 20 ], "repeat": [ 1, 20 ] }
      ],
      "item": {
        ".": [
          { "item": "bottle_glass", "chance": 4 },
          { "item": "can_drink", "chance": 2 },
          { "item": "glass_shard", "chance": 7 }
        ]
      },
      "place_loot": [ { "group": "cash_register_random", "x": [ 18, 21 ], "y": 5 } ],
      "place_monsters": [ { "monster": "GROUP_RESORT_DANCERS", "x": [ 1, 23 ], "y": [ 0, 22 ], "density": 0.5 } ],
      "toilets": { "T": {  } },
      "nested": { "§": { "chunks": [ "fire_extinguisher" ] } }
    }
  },
  {
    "type": "mapgen",
    "om_terrain": "stripclub_roof_1",
    "object": {
      "fill_ter": "t_flat_roof",
      "rows": [
        "                        ",
        "                        ",
        "  --------   ---------- ",
        "  -......-   -........- ",
        "  -..=...-----....&...- ",
        "  -...................- ",
        "  -...................- ",
        "  -...................- ",
        "  -...................- ",
        "  -...................- ",
        "  -...................- ",
        "  -...................- ",
        "  -...................- ",
        "  -...................- ",
        "  -...................- ",
        "  -...................- ",
        "  -...................- ",
        "  -...................- ",
        "  -...................- ",
        "  -...................5 ",
        "  -...................- ",
        "  --------------------- ",
        "                        ",
        "                        "
      ],
      "palettes": [ "roof_palette" ],
      "place_nested": [
        {
          "chunks": [
            [ "null", 20 ],
            [ "roof_2x2_utilities_b", 15 ],
            [ "roof_2x2_utilities_c", 5 ],
            [ "roof_2x2_utilities_d", 40 ],
            [ "roof_2x2_utilities", 50 ]
          ],
          "x": [ 4, 17 ],
          "y": [ 6, 17 ]
        }
      ]
    }
  },
  {
    "type": "mapgen",
    "om_terrain": "stripclub_2",
    "object": {
      "fill_ter": { "param": "linoleum_color", "fallback": "t_linoleum_gray" },
      "rows": [
        "_.......___.............",
        "_#%%#%%#___#%%#%%#%%#...",
        "_#######___##########...",
        "_#@á,,,##*##§HHHH  h#...",
        "_#c,,,,|   |       t#...",
        "_#@á,,áo   e       h#...",
        "_#|,,|||||||Y       #...",
        "_#S,,,B|y           #...",
        "_#S,,,B|  //////   h#...",
        "_#S,,,B|--------/  t#...",
        "_#,,,,,,,,,,,,,-/  h#...",
        "_#,,,,,,,,,,,,,-/  §#...",
        "_#lllll|--------/   #...",
        "_#||||||y //////   h#...",
        "_#&(&(&|           t#...",
        "_#     +    hth    h#^..",
        "_#+|+|||Y           #...",
        "_#T|T|H      ÁÁÁÁ  y#...",
        "_#####H    ||((((|+|#...",
        "___DD#H    |       §#...",
        "___DD#yhthy|FFF(&( Y#...",
        "___DD################...",
        "........................",
        "........................"
      ],
      "palettes": [ "stripclub_palette" ],
      "terrain": {
        ",": { "param": "carpet_color_type", "fallback": "t_carpet_purple" },
        "B": { "param": "carpet_color_type", "fallback": "t_carpet_purple" },
        "l": { "param": "carpet_color_type", "fallback": "t_carpet_purple" },
        "S": { "param": "carpet_color_type", "fallback": "t_carpet_purple" },
        "á": { "param": "carpet_color_type", "fallback": "t_carpet_purple" },
        "c": { "param": "carpet_color_type", "fallback": "t_carpet_purple" },
        "@": { "param": "carpet_color_type", "fallback": "t_carpet_purple" },
        "|": "t_wall_p"
      },
      "furniture": { "/": "f_stool", "@": "f_sink" },
      "items": {
        "l": [
          { "item": "dresser_female", "chance": 60, "repeat": [ 1, 2 ] },
          { "item": "beauty", "chance": 20, "repeat": [ 1, 2 ] },
          { "item": "softdrugs", "chance": 60, "repeat": [ 1, 2 ] },
          { "item": "sex_lair", "chance": 24 }
        ],
        "H": [ { "item": "magazines", "chance": 35 }, { "item": "bar_alcohol", "chance": 15 } ],
        "t": [ { "item": "bar_alcohol", "chance": 25 }, { "item": "misc_smoking", "chance": 25 } ],
        "(": [ { "item": "magazines", "chance": 25 }, { "item": "bar_alcohol", "chance": 25 } ],
        "F": { "item": "beer_selection", "chance": 65, "repeat": [ 1, 3 ] },
        "h": { "item": "chair_hat", "chance": 5 }
      },
      "place_fields": [
        { "field": "fd_blood", "x": [ 8, 19 ], "y": [ 3, 20 ], "repeat": [ 1, 8 ] },
        { "field": "fd_bile", "x": [ 8, 19 ], "y": [ 3, 20 ], "repeat": [ 1, 20 ] }
      ],
      "place_loot": [ { "group": "cash_register_random", "x": [ 13, 16 ], "y": 18 } ],
      "vendingmachines": { "V": { "item_group": "vending_food", "lootable": true }, "v": { "item_group": "vending_drink", "lootable": true } },
      "place_monsters": [ { "monster": "GROUP_RESORT_DANCERS", "x": [ 1, 23 ], "y": [ 0, 22 ], "density": 0.5 } ],
      "toilets": { "T": {  } },
      "nested": { "§": { "chunks": [ "fire_extinguisher" ] } }
    }
  },
  {
    "type": "mapgen",
    "om_terrain": "stripclub_roof_2",
    "object": {
      "fill_ter": "t_flat_roof",
      "rows": [
        "                        ",
        " .  .  .   .  .  .  .   ",
        " -------   ----------   ",
        " -.....-----........-   ",
        " -.............:....-   ",
        " -..................-   ",
        " -..................-   ",
        " -..................-   ",
        " -..................-   ",
        " -..................-   ",
        " -..................-   ",
        " -..................-   ",
        " -..................-   ",
        " -..................-   ",
        " -..................-   ",
        " -..................5   ",
        " -..................-   ",
        " -..................-   ",
        " -----..............-   ",
        "     -....&...=.....-   ",
        "     -..............-   ",
        "     ----------------   ",
        "                        ",
        "                        "
      ],
      "palettes": [ "roof_palette" ],
      "place_nested": [
        {
          "chunks": [
            [ "null", 20 ],
            [ "roof_2x2_utilities_b", 15 ],
            [ "roof_2x2_utilities_c", 5 ],
            [ "roof_2x2_utilities_d", 40 ],
            [ "roof_2x2_utilities", 50 ]
          ],
          "x": [ 4, 15 ],
          "y": [ 6, 14 ]
        }
      ]
    }
  }
]
