[
  {
    "type": "mapgen",
    "method": "json",
    "om_terrain": [ "sub_ramp_above" ],
    "weight": 250,
    "object": {
      "fill_ter": "t_rock_floor_no_roof",
      "rows": [
        "#   X   X      X   X   #",
        "#  -x---x-    -x---x-  #",
        "#   X   X      X   X   #",
        "#   X   X      X   X   #",
        "#  -x---x-    -x---x-  #",
        "#   X   X      X   X   #",
        "#   X   X      X   X   #",
        "#  -x---x-    -x---x-  #",
        "#dddzdddzddddddzdddzddd#",
        "#DDD>DDD>DDDDDD>DDD>DDD#",
        ",,,,,,,,,,,,,,,,,,,,,,,,",
        ",,,,,,,,,,,,,,,,,,,,,,,,",
        ",,,,,,,,,,,,,,,,,,,,,,,,",
        ",,,,,,,,,,,,,,,,,,,,,,,,",
        ",,,,,,,,,,,,,,,,,,,,,,,,",
        ",,,,,,,,,,,,,,,,,,,,,,,,",
        ",,,,,,,,,,,,,,,,,,,,,,,,",
        ",,,,,,,,,,,,,,,,,,,,,,,,",
        ",,,,,,,,,,,,,,,,,,,,,,,,",
        ",,,,,,,,,,,,,,,,,,,,,,,,",
        ",,,,,,,,,,,,,,,,,,,,,,,,",
        ",,,,,,,,,,,,,,,,,,,,,,,,",
        ",,,,,,,,,,,,,,,,,,,,,,,,",
        ",,,,,,,,,,,,,,,,,,,,,,,,"
      ],
      "palettes": [ "subway_underground" ],
      "terrain": {
        "z": "t_railroad_ramp_down_high",
        "d": "t_concrete_ramp_down_high",
        "#": "t_rock",
        "D": "t_concrete_ramp_down_low",
        ">": "t_railroad_ramp_down_low",
        ",": "t_open_air"
      }
    }
  },
  {
    "type": "mapgen",
    "method": "json",
    "om_terrain": [ "sub_ramp_below" ],
    "weight": 250,
    "object": {
      "fill_ter": "t_rock_floor_no_roof",
      "rows": [
        "########################",
        "########################",
        "########################",
        "########################",
        "########################",
        "########################",
        "########################",
        "########################",
        "########################",
        "#DDD>DDD>DDDDDD>DDD>DDD#",
        "#dddzdddzddddddzdddzddd#",
        "#   X   X      X   X   #",
        "#   X   X      X   X   #",
        "#  -x---x-    -x---x-  #",
        "#   X   X      X   X   #",
        "#   X   X      X   X   #",
        "#  -x---x-    -x---x-  #",
        "#   X   X      X   X   #",
        "#   X   X      X   X   #",
        "#  -x---x-    -x---x-  #",
        "#   X   X      X   X   #",
        "#   X   X      X   X   #",
        "#  -x---x-    -x---x-  #",
        "#   X   X      X   X   #"
      ],
      "palettes": [ "subway_underground" ],
      "terrain": {
        "z": "t_railroad_ramp_up_low",
        "d": "t_concrete_ramp_up_low",
        "D": "t_concrete_ramp_up_high",
        ">": "t_railroad_ramp_up_high",
        "#": "t_rock",
        ",": "t_thconc_floor"
      }
    }
  }
]
