[
  {
    "type": "mapgen",
    "method": "json",
    "om_terrain": [ "survivor_forest_camp" ],
    "weight": 100,
    "object": {
      "fill_ter": "t_grass",
      "predecessor_mapgen": "forest_thick",
      "rows": [
        "                        ",
        "                        ",
        "                        ",
        ",,,,,,,,,    ,,,,,,,,,  ",
        ",,,,,,,,,    ,,,,,,,,,  ",
        ",,,,,,,,,    ,,,,,,,,,  ",
        ",,,E,,,,,    ,,,,E,,,,  ",
        ",,,,,,,,,,,,,,,,M,,,,,,,",
        ",,,,,,,,,,,,,,,,B,,,,,,,",
        ",,,,,,,,,,,,@,,,C,,,,,,,",
        ",,,,,,,,,,,,O,,,S,,,,,,,",
        ",,,,,,,,,,,,@,,,,,,,,,,,",
        ",,,,,,,,,,,,,,,,,,,,,,,,",
        ",,,,,,,,,,E,,,,,,,,,,,,,",
        ",,,,,,,,,,,,,,,,,,,,,,,,",
        "      ,,,,,,,,,,,       ",
        "      ,,,,,,,,,,,       ",
        "      ,,,,,,,,,,,       ",
        "      ,,,,,,,,,,,       ",
        "      ,,,,,@,,,,,       ",
        "       ~~~~~~~~~        ",
        "      ~~~~~~~~~~~       ",
        "     ~~~~~~~~~~~~~      ",
        "      ~~~~~~~~~~~       " 
      ],
      "flags": [ "ERASE_ALL_BEFORE_PLACING_TERRAIN" ],
      "nested": { "E": { "chunks": [ [ "leather_tent_5x5_S", 100 ] ] } },
      "terrain": { ",": [ "t_grass" ], "~": "t_water_dp", "O": "t_dirt","@": "t_grass", "E": "t_grass", "S": "t_dirt", "C": "t_dirt", "B":"t_grass", "M":"t_grass" },
      "furniture": { "O": "f_firering","@": "f_logstool", "S": "f_smoking_rack", "C": "f_kiln_empty", "B":"f_butcher_rack", "M":"f_fiber_mat"  },
      "place_traps":[ { "trap": "tr_fur_rollmat", "x": 12, "y": 15 } ],
      "place_furniture": [
        { "furn": "f_cattails", "x": [ 10, 16 ], "y": [ 21, 23 ], "repeat": [ 3, 7 ] },
        { "furn": "f_boulder_large", "x": [ 10, 16 ], "y": [ 21, 23 ], "repeat": [ 1, 3 ] } ],
      "place_monster": [
        { "monster": "mon_feral_sapien_spear", "x": 12, "y": 9, "spawn_data": { "patrol": [ { "x": 12, "y": 9 } ] } },
        { "group": "GROUP_POND_FISH_2", "x": 13, "y": 21, "chance": 100, "repeat" :[4, 8] } ],
      "place_items":[ 
        { "item": "book_survival", "x": 11,"y": 14, "chance": 100, "repeat": [ 0, 2 ]  } ],   
      "place_loot": [
        { "item": "compositebow", "x": 5, "y": 7, "chance": 100 },
        { "item": "arrow_wood_heavy", "x": 5, "y": 7, "repeat": [ 2, 3 ], "chance": 100 },
        { "item": "quiver_birchbark", "x": 5, "y": 7, "chance": 100 },
        { "item": "childnote", "x": 19, "y": 7, "chance": 100 },
        { "item": "bone_human", "x": 19, "y": 7, "chance": 100, "repeat": [ 30, 40 ] },
        { "item": "etched_skull", "x": 19, "y": 7, "chance": 100 },
        { "item": "dry_meat", "x": 16, "y": 7 , "chance": 100, "repeat": [ 10, 20 ] },
        { "item": "dry_fruit", "x": 16, "y": 7 , "chance": 100, "repeat": [ 10, 20 ] },
        { "item": "makeshift_pillow", "x": 12, "y": 15, "chance": 100 },
        { "item": "wicker_backpack", "x": 11, "y": 14, "chance": 100 },
        { "item": "fire_drill_large", "x": 12, "y": 14, "chance": 100 },
        { "item": "oil_lamp_clay", "x": 12, "y": 14, "chance": 100 },
        { "item": "primitive_axe", "x": 11, "y": 9, "chance": 100 },
        { "item": "log", "x": 8, "y": 10, "chance": 100,"repeat": 3 },
        { "item": "clay_pot", "x": 13, "y":19 , "chance": 100 },
        { "item": "fish_bait", "x": 13, "y":19 , "chance": 100, "repeat":[ 1, 2 ] },
        { "item": "fishing_rod_basic", "x": 12, "y":19 , "chance": 100 }

      ]
    }
  },
  {
    "type": "mapgen",
    "method": "json",
    "om_terrain": [ "survivor_forest_camp" ],
    "weight": 20,
    "object": {
      "fill_ter": "t_grass",
      "predecessor_mapgen": "forest_thick",
      "rows": [
        "                        ",
        "                        ",
        "                        ",
        ",,,,,,,,,    ,,,,,,,,,  ",
        ",,,,,,,,,    ,,,,,,,,,  ",
        ",,,,,,,,,    ,,,,,,,,,  ",
        ",,,E,,,,,    ,,,,E,,,,  ",
        ",,,,,,,,,,,,,,,,M,,,,,,,",
        ",,,,,,,,,,,,,,,,B,,,,,,,",
        ",,,,,,,,,,,,@,,,C,,,,,,,",
        ",,,,,,,,,,,,O,,,S,,,,,,,",
        ",,,,,,,,,,,,@,,,,,,,,,,,",
        ",,,,,,,,,,,,,,,,,,,,,,,,",
        ",,,,,,,,,,E,,,,,,,,,,,,,",
        ",,,,,,,,,,,,,,,,,,,,,,,,",
        "      ,,,,,,,,,,,       ",
        "      ,,,,,,,,,,,       ",
        "      ,,,,,,,,,,,       ",
        "      ,,,,,,,,,,,       ",
        "      ,,,,,@,,,,,       ",
        "       ~~~~~~~~~        ",
        "      ~~~~~~~~~~~       ",
        "     ~~~~~~~~~~~~~      ",
        "      ~~~~~~~~~~~       " 
      ],
      "flags": [ "ERASE_ALL_BEFORE_PLACING_TERRAIN" ],
      "nested": { "E": { "chunks": [ [ "leather_tent_5x5_S", 100 ] ] } },
      "terrain": { ",": [ "t_grass" ], "~": "t_water_dp", "O": "t_dirt","@": "t_grass", "E": "t_grass", "S": "t_dirt", "C": "t_dirt", "B":"t_grass", "M":"t_grass" },
      "furniture": { "O": "f_firering","@": "f_logstool", "S": "f_smoking_rack", "C": "f_kiln_empty", "B":"f_butcher_rack", "M":"f_fiber_mat"  },
      "place_traps":[ { "trap": "tr_fur_rollmat", "x": 12, "y": 15 } ],
      "place_furniture": [
        { "furn": "f_cattails", "x": [ 10, 16 ], "y": [ 21, 23 ], "repeat": [ 3, 7 ] },
        { "furn": "f_boulder_large", "x": [ 10, 16 ], "y": [ 21, 23 ], "repeat": [ 1, 3 ] } ],
      "place_monster": [
        { "monster": "mon_fleshy_shambler", "x": 12, "y": 9, "spawn_data": { "patrol": [ { "x": 12, "y": 9 } ] } },
        { "group": "GROUP_POND_FISH_2", "x": 13, "y": 21, "chance": 100, "repeat" :[4, 8] } ],
      "place_items":[ 
        { "item": "book_survival", "x": 11,"y": 14, "chance": 100, "repeat": [ 0, 2 ]  } ],   
      "place_loot": [
        { "item": "compositebow", "x": 5, "y": 7, "chance": 100 },
        { "item": "arrow_wood_heavy", "x": 5, "y": 7, "repeat": [ 2, 3 ], "chance": 100 },
        { "item": "quiver_birchbark", "x": 5, "y": 7, "chance": 100 },
        { "item": "childnote", "x": 19, "y": 7, "chance": 100 },
        { "item": "bone_human", "x": 19, "y": 7, "chance": 100, "repeat": [ 30, 40 ] },
        { "item": "etched_skull", "x": 19, "y": 7, "chance": 100 },
        { "item": "dry_meat", "x": 16, "y": 7 , "chance": 100, "repeat": [ 10, 20 ] },
        { "item": "dry_fruit", "x": 16, "y": 7 , "chance": 100, "repeat": [ 10, 20 ] },
        { "item": "makeshift_pillow", "x": 12, "y": 15, "chance": 100 },
        { "item": "wicker_backpack", "x": 11, "y": 14, "chance": 100 },
        { "item": "fire_drill_large", "x": 12, "y": 14, "chance": 100 },
        { "item": "oil_lamp_clay", "x": 12, "y": 14, "chance": 100 },
        { "item": "primitive_axe", "x": 11, "y": 9, "chance": 100 },
        { "item": "log", "x": 8, "y": 10, "chance": 100,"repeat": 3 },
        { "item": "clay_pot", "x": 13, "y":19 , "chance": 100 },
        { "item": "fish_bait", "x": 13, "y":19 , "chance": 100, "repeat":[ 1, 2 ] },
        { "item": "fishing_rod_basic", "x": 12, "y":19 , "chance": 100 }

      ]
    }
  }
]
