[
  {
    "type": "mapgen",
    "method": "json",
    "om_terrain": [ "survivor_forest_camp" ],
    "weight": 100,
    "object": {
      "fill_ter": "t_grass",
      "predecessor_mapgen": "forest",
      "rows": [
        "                        ",
        "                        ",
        "                        ",
        "                        ",
        "                        ",
        "                        ",
        "                        ",
        "                        ",
        "                        ",
        "     E      @      E    ",
        "            O           ",
        "                        ",
        "                        ",
        "            E           ",
        "                        ",
        "                        ",
        ",,,,,,,,,,,,M,,,,,,,,,,,",
        ",,,,,,,,,,,,,,,,,,,,,,,,",
        ",,,,,,,,,,,,,,,,,,,,,,,,",
        ",,,,,,,,,,rbd@,,,,,,,,,,",
        ",,,,,,,~~~~~~~~~,,,,,,,,",
        ",,,,,,~~~~~~~~~~~,,,,,,,",
        ",,,,,~~~~~~~~~~~~~,,,,,,",
        ",,,,,,~~~~~~~~~~~,,,,,,,"
      ],
      "nested": { "E": { "chunks": [ [ "leather_tent_5x5_E", 100 ] ] } },
      "terrain": { ",": [ [ "t_region_groundcover", 36 ], "t_region_shrub" ], "~": "t_water_dp" },
      "furniture": { "O": "f_firering", "@": "f_logstool" },
      "place_monster": [
        { "monster": "mon_feral_sapien_spear", "x": 12, "y": 12 }
    ],
      "place_loot": [
        { "item": "longbow", "x": 3, "y": 5, "chance": 100 }
      ],
      "items": {
        "r": { "item": "map_extra_science", "chance": 100 },
        "b": { "item": "map_extra_science", "chance": 100 },
        "d": { "item": "map_extra_science", "chance": 100 },
        "M": { "item": "map_extra_science", "chance": 100 }
      }
    }
  },
  {
    "type": "mapgen",
    "method": "json",
    "om_terrain": [ "survivor_forest_camp" ],
    "weight": 100,
    "object": {
      "fill_ter": "t_grass",
      "predecessor_mapgen": "forest",
      "rows": [
        "                        ",
        "                        ",
        "                        ",
        "                        ",
        "                        ",
        "                        ",
        "                        ",
        "                        ",
        "                        ",
        "     E      @      E    ",
        "            O           ",
        "                        ",
        "                        ",
        "            E           ",
        "                        ",
        "                        ",
        ",,,,,,,,,,,,M,,,,,,,,,,,",
        ",,,,,,,,,,,,,,,,,,,,,,,,",
        ",,,,,,,,,,,,,,,,,,,,,,,,",
        ",,,,,,,,,,rbd@,,,,,,,,,,",
        ",,,,,,,~~~~~~~~~,,,,,,,,",
        ",,,,,,~~~~~~~~~~~,,,,,,,",
        ",,,,,~~~~~~~~~~~~~,,,,,,",
        ",,,,,,~~~~~~~~~~~,,,,,,,"
      ],
      "nested": { "E": { "chunks": [ [ "leather_tent_5x5_E", 100 ] ] } },
      "terrain": { ",": [ [ "t_region_groundcover", 36 ], "t_region_shrub" ], "~": "t_water_dp" },
      "furniture": { "O": "f_firering", "@": "f_logstool" },
      "place_monster": [
        { "monster": "mon_feral_sapien_spear", "x": 12, "y": 12 }
    ],
      "place_loot": [
        { "item": "longbow", "x": 3, "y": 5, "chance": 100 }
      ],
      "items": {
        "r": { "item": "map_extra_science", "chance": 100 },
        "b": { "item": "map_extra_science", "chance": 100 },
        "d": { "item": "map_extra_science", "chance": 100 },
        "M": { "item": "map_extra_science", "chance": 100 }
      }
    }
  }
]
