[
  {
    "type": "mapgen",
    "method": "json",
    "om_terrain": [ "synagogue" ],
    "//": "New England Synagogue",
    "weight": 1000,
    "object": {
      "fill_ter": "t_floor",
      "rows": [
        "   s       ss           ",
        "  ss^^^^^^^ss^^^^^^^    ",
        "  s^^||||w|++|w||||^^   ",
        "  s^||tt........+.||^   ",
        "  s^|..........l|..|^   ",
        " ss^|lll.tt.....|ST|^^  ",
        " s^||||||||++||||||||^  ",
        " s^|................|^  ",
        " s^|.######..######.|^  ",
        " s^w................w^  ",
        " s^|#.#.#.rrrr.#.#.#|^  ",
        " s^w#.#.#.r££r.#.#.#w^  ",
        " s^|#.#.#..BB..#.#.#|^  ",
        " s^w#.#.#.rBBr.#.#.#w^  ",
        " s^|#.#.#.rrrr.#.#.#|^  ",
        " s^w................w^  ",
        " s^|.######..######.|^  ",
        " s^|.......AA.......|^  ",
        " s^||||+||||||||+||||^  ",
        " s^^woo.o|y.eD....ow^^  ",
        " ss^|y...+.....h.ho|^   ",
        "  s^||hd.|o..ydddd||^   ",
        "  s^^|||w||++||w|||^^   ",
        "  sssssssssss    !      "
      ],
      "palettes": [ "parametrized_linoleum_palette" ],
      "terrain": {
        " ": "t_region_groundcover_urban",
        "+": "t_door_c",
        ".": "t_floor",
        "S": { "param": "linoleum_color", "fallback": "t_linoleum_gray" },
        "T": { "param": "linoleum_color", "fallback": "t_linoleum_gray" },
        "'": { "param": "linoleum_color", "fallback": "t_linoleum_gray" },
        "^": "t_region_shrub_decorative",
        "s": "t_sidewalk",
        "w": "t_window",
        "|": "t_brick_wall",
        "B": "t_carpet_red",
        "A": "t_carpet_red",
        "£": "t_carpet_red",
        "r": "t_railing",
        "!": "t_gutter_downspout"
      },
      "furniture": {
        "#": "f_bench",
        "S": "f_sink",
        "c": "f_counter",
        "d": "f_desk",
        "e": "f_fridge",
        "h": "f_chair",
        "l": "f_rack_coat",
        "o": "f_bookcase",
        "t": "f_table",
        "y": [ "f_indoor_plant_y", "f_indoor_plant" ],
        "D": "f_wardrobe",
        "£": "f_desk",
        "A": "f_torah_ark"
      },
      "place_item": [
        { "item": "tallit_gadol", "x": 15, "y": 4, "chance": 60, "repeat": [ 2, 4 ] },
        { "item": "holybook_torah_scroll", "x": 11, "y": 17, "chance": 20 },
        { "item": "holybook_torah_scroll", "x": 12, "y": 17, "chance": 20 },
        { "item": "holybook_torah_scroll", "x": 12, "y": 17, "chance": 20 },
        { "item": "holybook_torah_scroll", "x": 11, "y": 11, "chance": 60 },
        { "item": "holybook_torah_scroll", "x": 12, "y": 11, "chance": 60 },
        { "item": "oil_lamp", "x": 11, "y": 16, "chance": 35 }
      ],
      "items": {
        "d": { "item": "SUS_office_desk", "chance": 60, "repeat": [ 1, 3 ] },
        "o": { "item": "synagogue_books", "chance": 40, "repeat": [ 2, 5 ] },
        "#": [ { "item": "synagogue", "chance": 40 } ],
        ".": { "item": "synagogue", "chance": 3 },
        ",": { "item": "synagogue", "chance": 3 },
        "l": { "item": "jackets", "chance": 60 }
      }
    }
  },
  {
    "type": "mapgen",
    "method": "json",
    "om_terrain": "synagogue_roof",
    "object": {
      "fill_ter": "t_open_air",
      "rows": [
        "                        ",
        "                        ",
        "     --------------     ",
        "    --............--    ",
        "    -..............-    ",
        "    -..............-    ",
        "   --..............--   ",
        "   -................-   ",
        "   -....|O|OO|O|....-   ",
        "   -....OooooooO....-   ",
        "   -....|oooooo|....-   ",
        "   -....OooooooO....-   ",
        "   -....|oooooo|....-   ",
        "   -....OooooooO....-   ",
        "   -....|oooooo|....-   ",
        "   -....OooooooO....-   ",
        "   -....|O|OO|O|....-   ",
        "   -................-   ",
        "   --..............--   ",
        "    -..............-    ",
        "    -..............-    ",
        "    --............--    ",
        "     ------------5-     ",
        "                        "
      ],
      "palettes": [ "roof_palette" ],
      "terrain": { ".": "t_tile_flat_roof", "|": "t_brick_wall", "o": "t_open_air_rooved", "O": "t_window" }
    }
  },
  {
    "type": "mapgen",
    "method": "json",
    "om_terrain": "synagogue_upper_roof",
    "object": {
      "fill_ter": "t_open_air",
      "rows": [
        "                        ",
        "                        ",
        "                        ",
        "                        ",
        "                        ",
        "                        ",
        "                        ",
        "                        ",
        "        --------        ",
        "        -......-        ",
        "        -......-        ",
        "        -......-        ",
        "        -......-        ",
        "        -......-        ",
        "        -......-        ",
        "        -......-        ",
        "        --------        ",
        "                        ",
        "                        ",
        "                        ",
        "                        ",
        "                        ",
        "                        ",
        "                        "
      ],
      "palettes": [ "roof_palette" ],
      "terrain": { ".": "t_shingle_flat_roof" }
    }
  }
]
