[
  {
    "type": "mapgen",
    "method": "json",
    "om_terrain": [
      [ "textile_mill_museum_0a0", "textile_mill_museum_0a1", "textile_mill_museum_0a2" ],
      [ "textile_mill_museum_0b0", "textile_mill_museum_0b1", "textile_mill_museum_0b2" ]
    ],
    "weight": 300,
    "object": {
      "fill_ter": "t_floor",
      "rows": [
        "........................................................................",
        "...........................................................~~~~~~.......",
        "..............................[.........................~~~~~~~~~~~.....",
        ".........[.....................%......................~~~~~~~~~~~~~~....",
        "............%..................................[.....~~~~~~~~~~~~~~~....",
        "...........................................%........~~~~~~~~~~~~~~~~~...",
        ".....................................................~~~~~~~~~~~~~~~~...",
        "......................................................~~~~~~~~~~~~~~....",
        ".....[..............[................................~~~~~~~~~~~~~~~....",
        "...........................%........................~~~~~~~~~~~~~~~.....",
        ".......%........................................~~~~~~~~~~~~~~~~~~~~....",
        "...............................................~~~~~~~~~~~~~~~~~~~~~....",
        "...[...........................................~~~~~~~~~~~~~~~~~~~......",
        "........--1-1-1-1-1-1-1-1-1-1-1-1-1-1-1-1-1-1-1-1-1--...~~~~~~~~~~~.....",
        "........-   ccnnnnm       mmmmnnnmmmM          :~~: -....~~~~~~~~~~.....",
        "........1                    MMMMM             :~~: 1....~~~~~~~~~~.....",
        "........-                                      :~~: -....~~~~~~~~~~.....",
        "........1                                      :~~: 1....~~~~~~~~~~..[..",
        "....%...-    b    b    b    b    bW   bW   bW  :~~: -...~~~~~~~~~~......",
        "....%...1l   mmmmMMMmmmm         wg   wg   wg  :~~: 1...~~~~~~~~~~......",
        "........-       mmmmm                          :~~: -....~~~~~~~~~......",
        "........1l                                     :~~: 1...%~~~~~~~~~~.....",
        "........-                        wg   wg   wg  :~~: -....~~~~~~~~~~%....",
        "........+    bt   bt   bt   bW   bW   bW   bW  :~~: -...~~~~~~~~~~......",
        "........-    sg   sg   sg   wg   wg   wg   wg  :~~: -....~~~~~~~~~~~....",
        "...[....1l                                     <~~< 1.....~~~~~~~~~~....",
        "........-                                      :00N -.....~~~~~~~~~.....",
        "........1l   sg   sg   sg   wg   wg   wg   wg  :00N 1..[.~~~~~~~~~~.....",
        "........-    bt   bt   bt   bW   bW   bW   bW  <~~< -....~~~~~~~~~~.....",
        "........1                                      :~~: 1....~~~~~~~~~~.....",
        "........-                                      :~~: -...~~~~~~~~~~~~....",
        "........1    cccccc      CCCCCC                :~~: 1...~~~~~~~~~~~~....",
        "........-    cccccc      CCCCCC                :~~: -....~~~~~~~~~~~%...",
        "....%...--1-1-1-1-1-1-1-1-1-1-1-1---1-+-1---1-1-1-1--....~~~~~~~~~~.%...",
        "..................................-       -.....~~.......~~~~~~~~~......",
        "..............[...................1  =    1.....~~~......~~~~~~~~.......",
        "...[.....................%........-  =   V-.....~~~~....~~~~~~~~~.......",
        "..................................1 g=    1......~~~~...~~~~~~~~....[...",
        "......%...........................-  =   D-......~~~~~..~~~~~~~~~.......",
        ".........%........................--1-+-1--.......~~~~~~~~~~~~~~~.......",
        "..........[.[..............[.########|||########.[.~~~~~~~~~~~~~~~......",
        "............%%...............|||||||||||||||||||....~~~~~~~~~~~~~~~.....",
        ".........[..[..............[.|||||||||||||||||||.[....~~~~~~~~~~~~......",
        "..........%%.................||...............||........~~~~~~~~~.......",
        ".........[...[.............[.||..%%.......%%..||.[.......~~~~~~~~.......",
        "........%....................||...............||..........~~~~~~........",
        "...........................[.||..%%.......%%..||.[......................",
        ".............................||...............||........................"
      ],
      "palettes": [ "textile_mill_museum" ]
    }
  }
]
