[
  {
    "type": "mapgen",
    "method": "json",
    "om_terrain": [ "s_thrift" ],
    "object": {
      "fill_ter": "t_thconc_floor",
      "rows": [
        "rrrrrrrrrrrrrrrrrrrrr222",
        "yrrryrrryrrryrrryrrry222",
        "yrrryrrryrrryrrryrrry222",
        "yrrryrrryrrryrrryrrry222",
        "yrrryrrryrrryrrryrrry222",
        "yrrryrrryrrryrrryrrry222",
        "yyyyyyyyyyyyyyyyyyyyy222",
        "222222222222222222222222",
        "222222222222222222222222",
        ".####11111111####gg##222",
        ".#HH           1 ooV#2<2",
        ".#HH  A  A  A  1 ooW#+##",
        ".#HH  A  A  A  ||gg|| L#",
        ".#HH  A  A  A    oo |+|#",
        ".#HH  A  A  A    oo | J#",
        ".#HH  A  A  A   CCCC|FJ#",
        ".#HH            C F + K#",
        ".#HH  HH            ||##",
        ".#    HH AAAAAAAAA   a#.",
        ".#+||                a#.",
        ".# B|AAAAAAAAAAAAA   a#.",
        ".##################+###.",
        "...Z...........2UU22U...",
        "........................"
      ],
      "palettes": [ "parametrized_concrete_carpets_palette", "parametrized_walls_palette" ],
      "terrain": {
        " ": "t_thconc_floor",
        "+": "t_door_locked",
        ".": "t_region_groundcover_urban",
        "1": "t_window",
        "2": "t_concrete",
        "U": "t_concrete",
        "g": "t_door_glass_c",
        "o": { "param": "concrete_carpet_color_type", "fallback": "t_carpet_concrete_purple" },
        "r": "t_pavement",
        "y": "t_pavement_y",
        "Z": "t_gutter_downspout",
        "<": "t_ladder_up"
      },
      "furniture": {
        "A": "f_rack",
        "a": "f_rack",
        "C": "f_counter",
        "D": "f_sink",
        "E": "f_sink",
        "F": "f_chair",
        "G": "f_locker",
        "H": [
          "f_coffee_table",
          "f_table",
          "f_sofa",
          "f_armchair",
          "f_chair",
          "f_desk",
          "f_floor_lamp",
          "f_rack_coat",
          "f_exercise",
          "f_treadmill",
          "f_ergometer",
          "f_wardrobe",
          "f_bigmirror"
        ],
        "J": "f_desk",
        "K": "f_filing_cabinet",
        "L": "f_locker",
        "U": [ "f_dumpster", "f_recycle_bin" ]
      },
      "vendingmachines": { "W": { "item_group": "vending_drink", "lootable": true }, "V": { "item_group": "vending_food", "lootable": true } },
      "toilets": { "B": {  } },
      "items": {
        "J": { "item": "office", "chance": 30, "repeat": [ 3, 4 ] },
        "A": { "item": "thrift_misc", "chance": 60, "repeat": [ 1, 6 ] },
        "B": { "item": "SUS_toilet", "chance": 50 },
        "a": { "item": "thrift_books", "chance": 60, "repeat": [ 1, 6 ] },
        "K": { "item": "SUS_office_filing_cabinet", "chance": 30 },
        "L": { "item": "cleaning", "chance": 20, "repeat": [ 2, 4 ] }
      },
      "place_items": [ { "item": "cash_register_random", "x": [ 16, 19 ], "y": 15, "chance": 100 } ]
    }
  },
  {
    "type": "mapgen",
    "method": "json",
    "om_terrain": "s_thrift_roof",
    "object": {
      "fill_ter": "t_flat_roof",
      "rows": [
        "                        ",
        "                        ",
        "                        ",
        "                        ",
        "                        ",
        "                        ",
        "                        ",
        "                        ",
        "                        ",
        " -------------------####",
        " -..................##v#",
        " -..................####",
        " -.....................-",
        " -.....................-",
        " -.....................-",
        " -.....................-",
        " -.....................-",
        " -....................--",
        " -....................- ",
        " -....................- ",
        " -....................- ",
        " --5------------------- ",
        "                        ",
        "                        "
      ],
      "palettes": [ "roof_palette" ],
      "place_nested": [
        {
          "chunks": [
            [ "null", 20 ],
            [ "roof_2x2_utilities_b", 15 ],
            [ "roof_2x2_utilities_c", 5 ],
            [ "roof_2x2_utilities_d", 40 ],
            [ "roof_2x2_utilities", 50 ],
            [ "roof_2x2_golf", 20 ],
            [ "roof_3x3_wine", 30 ]
          ],
          "x": [ 3, 15 ],
          "y": [ 11, 13 ]
        },
        {
          "chunks": [
            [ "null", 20 ],
            [ "roof_4x4_party", 15 ],
            [ "roof_4x4_utility", 40 ],
            [ "roof_6x6_survivor", 20 ],
            [ "roof_6x6_utility", 20 ]
          ],
          "x": [ 3, 12 ],
          "y": 15
        }
      ]
    }
  }
]
