[
  {
    "type": "mapgen",
    "om_terrain": [ [ "xedra_rural_church_parking", "xedra_rural_church" ] ],
    "//": "This is a rural church infested with nether creatures, with an abandoned XEDRA field investigation.",
    "object": {
      "fill_ter": "t_floor",
      "rows": [
        "                                                ",
        "                            ^^777777777777^^    ",
        "  $      $                  7WWwWVBWWGVWwWW7    ",
        "*            gg         ^7777wyh.....####yw7    ",
        "*         g gg _gg      WWwwWW.p..........W7    ",
        "*       __gggg g_gg_   *+8888+.......####.W^    ",
        "*    gg __g_  ggg__g   *+8888+............W^    ",
        "*_____gg  gg  __        W<oo>W.####..####.W7    ",
        "*gg_g gg  gggg      ssssWWwwWW............w7    ",
        "* gg _g_g _ggg_ggg_____s^7777W.####..####.W7    ",
        "*____ g_  ggggggggggÁg s^   ^W............W^    ",
        "*gggg gg  ggggg__gggg  s^   7W.####..####.W7    ",
        "gggggg_g ggggg___gg____s^   7w.....@......w7    ",
        "g______g__gg  ggggggg gs^   7W.####..####.W7    ",
        "*   ggg_  gggggg_ggggggs^   ^W............W^    ",
        "ggg  _g  ggg_gggg___Á__s^   ^W.####..####.W^    ",
        "*____g__ gg  ggggggggggs^   7W.....tt.....W7    ",
        "* ggggg  gggggggg_gggg s^   7B...b.,,.b...G7    ",
        "*   ggg  _ ggg__gg___ _s^   7Wy.....h.t..yW7    ",
        "*    gg__ ggggggggggg  s^   ^WW++||||||WWWW^    ",
        "*   g___g  gggggggg_Ág s^   77w..-...hdw77^^    ",
        "        _g___ggg gg____s^    7W>.|lo..dW7       ",
        "   E%     gggggggggggggs^^^^^^Ww-WWwWWwW^       ",
        "            gg____g g  sssssss777 777777        "
      ],
      "palettes": [ "church" ],
      "furniture": { "E": "f_active_backup_generator", "*": "f_barricade_road", "7": "f_sandbag_half", "8": "f_sandbag_half" },
      "nested": {
        "$": { "chunks": [ "tent_b_5x5_S" ] }
      },
      "terrain": {
        "Á": "t_railroad_rubble",
        "W": "t_wood_wall_w",
        "B": "t_window_stained_blue",
        "G": "t_window_stained_green",
        "V": "t_window_stained_red",
        ",": "t_carpet_red",
        "8": "t_carpet_red",
        "`": "t_concrete",
        "_": "t_region_soil",
        "7": "t_region_soil",
        "E": "t_region_soil",
        "%": "t_region_soil",
        "$": "t_region_soil",
        "*": "t_region_soil",
        "g": "t_railroad_rubble",
        "<": "t_stairs_up",
        ">": "t_stairs_down"
      },
      "items": { "o": { "item": "religious_books", "chance": 60 }, "@": { "item": "NC_XEDRA_FIELD_AGENT_worn", "chance": 100 } },
      "item": { "@": [ { "item": "corpse_generic_male" } ] },
      "vehicles": { "Á": { "vehicle": "parking_garage", "chance": 50, "rotation": 0 } },
      "monster": { "%": { "monster": "mon_turret_searchlight" }, ".": { "monster": "mon_twisting_mass"}, "#": { "monster": "mon_twisting_mass" } }
    }
  },
  {
    "type": "mapgen",
    "om_terrain": [ [ "xedra_rural_church_steeple" ] ],
    "object": {
      "fill_ter": "t_floor",
      "rows": [
        "                        ",
        "                        ",
        "     ||||||||||||||     ",
        "     ||||||||||||||     ",
        "|||||||||||||||||||     ",
        "GGOOGG|||||||||||||     ",
        "O...0G|||||||||||||     ",
        "O>...G|||||||||||||     ",
        "GGOOGG|||||||||||||     ",
        "     ||||||||||||||     ",
        "     ||||||||||||||     ",
        "     ||||||||||||||     ",
        "     ||||||||||||||     ",
        "     ||||||||||||||     ",
        "     ||||||||||||||     ",
        "     ||||||||||||||     ",
        "     ||||||||||||||     ",
        "     ||||||||||||||     ",
        "     ||||||||||||||     ",
        "     ||||||||||||||     ",
        "      ||||||||||        ",
        "      ||||||||||        ",
        "      ||||||||||        ",
        "                        "
      ],
      "palettes": [ "roof_palette" ],
      "terrain": { "|": "t_shingle_flat_roof", "G": "t_wood_wall_w", "O": "t_window", " ": "t_open_air", ".": "t_floor" },
      "computers": { "0": { "name": "Church Bells 1.0", "options": [ { "name": "Toll Bells", "action": "toll" } ] } }
    }
  },
  {
    "type": "mapgen",
    "om_terrain": [ [ "xedra_rural_church_steeple_roof" ] ],
    "object": {
      "fill_ter": "t_shingle_flat_roof",
      "rows": [
        "                        ",
        "                        ",
        "                        ",
        "                        ",
        "                        ",
        "||||||                  ",
        "||||||                  ",
        "||||||                  ",
        "||||||                  ",
        "                        ",
        "                        ",
        "                        ",
        "                        ",
        "                        ",
        "                        ",
        "                        ",
        "                        ",
        "                        ",
        "                        ",
        "                        ",
        "                        ",
        "                        ",
        "                        ",
        "                        "
      ],
      "palettes": [ "roof_palette" ],
      "terrain": { "|": "t_shingle_flat_roof", " ": "t_open_air" }
    }
  },
  {
    "type": "mapgen",
    "om_terrain": [ [ "xedra_rural_church_basement" ] ],
    "object": {
      "fill_ter": { "param": "linoleum_color", "fallback": "t_linoleum_gray" },
      "rows": [
        "########################",
        "########################",
        "#####||||||||||||||#####",
        "#####|UUU   xT x T|#####",
        "||||||      xS x S|#####",
        "|a   +      xx+x+x|#####",
        "|   <|           l|#####",
        "||||||xx++xxxxxxxx|#####",
        "#####|a    hh  hh |#####",
        "#####|     tt  tt |#####",
        "#####|h    tt  tt |#####",
        "#####|h    hh  hh |#####",
        "#####|h           |#####",
        "#####|h    hh  hh |#####",
        "#####|h    tt  tt |#####",
        "#####|h    tt  tt |#####",
        "#####|h    hh  hh |#####",
        "#####|            |#####",
        "#####|a         11|#####",
        "#####|| xCCCCx+||||#####",
        "######| +      |########",
        "######|<xe234vW|########",
        "######||||||||||########",
        "########################"
      ],
      "palettes": [ "parametrized_linoleum_palette", "cathedral" ],
      "terrain": { "#": "t_soil", " ": { "param": "linoleum_color", "fallback": "t_linoleum_gray" } }
    }
  }
]
