[
  {
    "type": "mapgen",
    "method": "json",
    "om_terrain": [ "barn_aban1" ],
    "weight": 333,
    "object": {
      "fill_ter": "t_dirtfloor",
      "rows": [
        "~~~~~~..~~.z~~~~.T.~~~~.",
        "..^...z....^....z....z[.",
        "..z...zz.........T....[^",
        "....^......^.......z.^..",
        "......^.....z.^.......[.",
        "^.....^............z..[.",
        "...z........z.....z...[.",
        ".....z......T........z[.",
        "..^.....T........^....[.",
        "................z...^...",
        "......z.........z.^.zz.^",
        "............T...........",
        ".......^.z.....z......[S",
        ".T..^......^z..z...z..[.",
        "..z####################^",
        "...#  @ @@#CC #AA>#   #.",
        ".z.#  @   #C B#   #   #.",
        "...#E     #~~ #   #   #.",
        ".z.#FG                #z",
        "...+F:                #.",
        "...+A:C               #.",
        ".zw#AE   A#~~ #~~ #   #.",
        ".S.#HH   A#9 9#   #   #.",
        "..^#HHH  A#9 9#   #   #."
      ],
      "set": [ { "point": "terrain", "id": "t_dirt", "x": [ 0, 14 ], "y": [ 0, 3 ], "repeat": [ 8, 10 ] } ],
      "terrain": {
        " ": "t_dirtfloor",
        "#": "t_wall_wood",
        "+": "t_door_c",
        ".": "t_grass",
        "0": "t_window_empty",
        "2": "t_window_domestic",
        "3": "t_door_b",
        "=": "t_rock_floor",
        "S": "t_shrub_strawberry",
        "T": "t_tree",
        "W": "t_water_dp",
        "[": "t_fence_v",
        "^": "t_tree_young",
        "_": "t_rock_floor",
        "w": "t_water_sh",
        "z": "t_underbrush",
        "{": "t_door_glass_c",
        "~": "t_fence_h"
      },
      "furniture": {
        "6": "f_table",
        "7": "f_bookcase",
        "8": "f_bathtub",
        "9": "f_rack",
        ":": "f_dresser",
        "=": "f_woodstove",
        ">": "f_counter",
        "?": "f_sofa",
        "@": "f_makeshift_bed",
        "A": "f_locker",
        "B": "f_chair",
        "C": "f_desk",
        "D": "f_trashcan",
        "E": "f_cupboard",
        "F": "f_fridge",
        "G": "f_oven",
        "H": "f_hay"
      },
      "place_item": [
        { "item": "oil_lamp", "x": 7, "y": 15 },
        { "item": "45_acp", "x": 12, "y": 15 },
        { "item": "3006", "x": 12, "y": 15 },
        { "item": "3006", "x": 12, "y": 15, "chance": 50 },
        { "item": "3006", "x": 12, "y": 15, "chance": 33 },
        { "item": "pillow", "x": 6, "y": 15 },
        { "item": "sheet", "x": 6, "y": 16 },
        { "item": "sheet", "x": 9, "y": 15 },
        { "item": "mess_kit", "x": 17, "y": 15 },
        { "item": "nail", "x": 15, "y": 15 },
        { "item": "ax", "x": 15, "y": 15 },
        { "item": "compositebow", "x": 16, "y": 15 },
        { "item": "quiver", "x": 16, "y": 15 },
        { "item": "arrow_wood_heavy", "x": 16, "y": 15 },
        { "item": "knife_hunting", "x": 16, "y": 15 },
        { "item": "flashlight", "x": 11, "y": 16 },
        { "item": "child_book", "x": 11, "y": 16 },
        { "item": "child_book", "x": 11, "y": 15 },
        { "item": "pot", "x": 11, "y": 23 },
        { "group": "any_battery_full", "x": 11, "y": 16, "chance": 33 }
      ],
      "place_loot": [
        { "group": "cabin_suicide", "x": [ 4, 4 ], "y": [ 15, 15 ], "chance": 80 },
        { "group": "cannedfood", "x": [ 11, 11 ], "y": [ 22, 23 ], "chance": 90 },
        { "group": "cannedfood", "x": [ 13, 13 ], "y": [ 22, 23 ], "chance": 90 },
        { "group": "cannedfood", "x": [ 11, 11 ], "y": [ 22, 23 ], "chance": 90 },
        { "group": "cannedfood", "x": [ 13, 13 ], "y": [ 22, 23 ], "chance": 90 },
        { "group": "stash_water", "x": [ 20, 20 ], "y": [ 15, 15 ], "chance": 80 },
        { "group": "stash_water", "x": [ 19, 19 ], "y": [ 15, 15 ], "chance": 80 },
        { "item": "survivor_special_700", "x": 13, "y": 15, "chance": 80, "ammo": 100 }
      ]
    }
  }
]
