[
  {
    "type": "mapgen",
    "method": "json",
    "om_terrain": "ants_food",
    "weight": 5000,
    "object": {
      "fill_ter": "t_dirt_underground",
      "rows": [
        "#######          #######",
        "#######          #######",
        "#######          #######",
        "######           #######",
        "#######          #######",
        "######            ######",
        "######             #####",
        "#####               ####",
        "####               #####",
        "#####              #####",
        "####                ####",
        "####                ####",
        "###                  ###",
        "###                 ####",
        "####              ######",
        "#######            #####",
        "#########           ####",
        "########          ######",
        "#######           ######",
        "########           #####",
        "##########      ########",
        "############  ##########",
        "########################",
        "########################"
      ],
      "terrain": { "#": "t_soil" },
      "place_nested": [
        { "chunks": [ "ant_tunnel_bounds_h" ], "x": [ 4, 6 ], "y": 0 },
        { "chunks": [ "ant_tunnel_bounds_h" ], "x": [ 4, 6 ], "y": 1 },
        { "chunks": [ "ant_tunnel_bounds_h" ], "x": [ 4, 6 ], "y": 2 },
        { "chunks": [ "ant_tunnel_bounds_h" ], "x": [ 4, 6 ], "y": 3 },
        { "chunks": [ "ant_tunnel_bounds_h" ], "x": [ 4, 6 ], "y": 4 }
      ],
      "items": { " ": { "item": "ant_food_innawood", "chance": 4 } }
    }
  }
]
