[
  {
    "type": "mapgen",
    "method": "json",
    "om_terrain": [ "cave_innawood" ],
    "weight": 1000,
    "object": {
      "predecessor_mapgen": "forest_thick",
      "rows": [
        "                        ",
        "                        ",
        "                        ",
        "                        ",
        "                        ",
        "                        ",
        "                        ",
        "                        ",
        "                        ",
        "        %%%;;%%%%       ",
        "       %%||;;|||%%      ",
        "       %|||;;||||%      ",
        "       %||||,,<||%      ",
        "       %|||,,||||%      ",
        "       %|||,,||||%      ",
        "       %%|||,,||%%      ",
        "       %%|||,,||%%      ",
        "       %%|||,,||%%      ",
        "       %%|||,,||%%      ",
        "    %%||||,||,,||||%%   ",
        "       %||,,,,,||%      ",
        "        %|||,|||%       ",
        "         %%|<|%%        ",
        "          %|||%         "
      ],
      "flags": [ "ERASE_ALL_BEFORE_PLACING_TERRAIN" ],
      "terrain": {
        "|": "t_rock",
        ",": "t_rock_floor",
        "%": [ "t_rock", "t_region_groundcover_forest" ],
        ";": "t_region_soil",
        "<": "t_slope_down"
      },
      "furniture": {  }
    }
  },
  {
    "type": "mapgen",
    "method": "json",
    "om_terrain": [ "cave_innawood" ],
    "weight": 1000,
    "object": {
      "predecessor_mapgen": "forest_thick",
      "rows": [
        "                        ",
        "                        ",
        "                        ",
        "     %%%%%%%%%%%%%%%    ",
        "    %||||||||||||||%%   ",
        "    ;;,,,,,,,,,,,,||%   ",
        "    ;;,,,||||||||,,|%   ",
        "    %|,,|||||||||,,|%   ",
        "    %|<||,,,,||||,,|%   ",
        "    %|||,,||,,|||,,|%   ",
        "    %|||,,|||,,,,,,|%   ",
        "    %|||,,||||||||||%   ",
        "    %|||,,,,,,||||||%   ",
        "    %|||,,|||,,|||||%   ",
        "    %|||,,||||,,||||%   ",
        "    %||,,,|||||,,|||%   ",
        "    %|,,,,|||||,,|||%   ",
        "    %||||||,,,,,,|||%   ",
        "    %|||||,,||||||||%   ",
        "    %%||||,|||,||||%%   ",
        "       %||,,,,,||%      ",
        "        %|||,|||%       ",
        "         %%|<|%%        ",
        "          %|||%         "
      ],
      "flags": [ "ERASE_ALL_BEFORE_PLACING_TERRAIN" ],
      "terrain": {
        "|": "t_rock",
        "%": [ "t_rock", "t_region_groundcover_forest" ],
        ";": "t_region_soil",
        ",": "t_rock_floor",
        "<": "t_slope_down"
      },
      "furniture": {  }
    }
  },
  {
    "type": "mapgen",
    "method": "json",
    "om_terrain": [ "cave_innawood" ],
    "weight": 1000,
    "object": {
      "predecessor_mapgen": "forest_thick",
      "rows": [
        "                        ",
        "                        ",
        "                        ",
        "     %%%%%%%%%%%%%%%    ",
        "    %||||||||||||||%%   ",
        "    ;;,,,WW,,,,WW,||%   ",
        "    ;;,,,||||||||,,|%   ",
        "    %|WW|||||||||,,|%   ",
        "    %|<||W,,,||||,,|%   ",
        "    %|||,W||,,|||,,|%   ",
        "    %|||,,|||,,,W,,|%   ",
        "    %|||,,||||||||||%   ",
        "    %|||,,,W,,||||||%   ",
        "    %|||,,|||,,|||||%   ",
        "    %|||,,||||,W||||%   ",
        "    %||WWW|||||W,|||%   ",
        "    %|WWWW|||||,,|||%   ",
        "    %||||||,,,,,,|||%   ",
        "    %|||||,,||||||||%   ",
        "    %%||||,|||,||||%%   ",
        "       %||,,W,,||%      ",
        "        %|||,|||%       ",
        "         %%|<|%%        ",
        "          %|||%         "
      ],
      "flags": [ "ERASE_ALL_BEFORE_PLACING_TERRAIN" ],
      "terrain": {
        "|": "t_rock",
        "%": [ "t_rock", "t_region_groundcover_forest" ],
        ";": "t_region_soil",
        ",": "t_rock_floor",
        "W": "t_rock_floor",
        "<": "t_slope_down"
      },
      "furniture": {  },
      "fields": { "W": { "field": "fd_web", "intensity": 2, "age": 10 } },
      "monsters": { "W": { "monster": "GROUP_SPIDER", "chance": 2, "density": 0.01 } }
    }
  },
  {
    "type": "mapgen",
    "method": "json",
    "om_terrain": [ "cave_innawood" ],
    "weight": 1000,
    "object": {
      "predecessor_mapgen": "forest_thick",
      "rows": [
        "                        ",
        "                        ",
        "                        ",
        "     %%%%%%%%%%%%%%%    ",
        "    %||||||||||||||%%   ",
        "    %|,||||,,,W,||||%   ",
        "    %|,,||,,|||,,|||%   ",
        "    %||,,,,|||||,,||%   ",
        "    %||||||||,,W,,||%   ",
        "    %|,|,,,,||||,,||%   ",
        "    %|,|W||,,||||,,,;   ",
        "    %,,|,,||,,|||,,,;   ",
        "    %|W||,,||||,,,||%   ",
        "    %|,,||,,|||,,|||%   ",
        "    %||,,||,,W,,||,|%   ",
        "    %|||,,|,|||,||,|%   ",
        "    %||||,,,|||,,W,|%   ",
        "    %||||,||||||||||%   ",
        "    %|||,,,,W,,,,,||%   ",
        "    %%||||||||,||||%%   ",
        "       %||,,W,,||%      ",
        "        %|||,|||%       ",
        "         %%|<|%%        ",
        "          %|||%         "
      ],
      "flags": [ "ERASE_ALL_BEFORE_PLACING_TERRAIN" ],
      "terrain": {
        "|": "t_rock",
        "%": [ "t_rock", "t_region_groundcover_forest" ],
        ";": "t_region_soil",
        ",": "t_rock_floor",
        "W": "t_rock_floor",
        "<": "t_slope_down"
      },
      "fields": { "W": { "field": "fd_web", "intensity": 1, "age": 10 } },
      "furniture": {  }
    }
  },
  {
    "type": "mapgen",
    "method": "json",
    "om_terrain": [ "cave_innawood" ],
    "weight": 1000,
    "object": {
      "predecessor_mapgen": "forest_thick",
      "rows": [
        "                        ",
        "                        ",
        "                        ",
        "     %%%%%%%%%%%%%%%    ",
        "    %||||||||||||||%%   ",
        "    %|,||||,,,,B||||%   ",
        "    %|,,||BB|||B,|||%   ",
        "    %||,,,,|||||,,||%   ",
        "    %||||||||,,B,,||%   ",
        "    %|,|,,,,||||,,||%   ",
        "    %|,|,||,,||||,,,;   ",
        "    %,,|BB||,,|||,,,;   ",
        "    %|,||,,||||,,,||%   ",
        "    %|,B||,,|||,,|||%   ",
        "    %||,,||,BBB,||,|%   ",
        "    %|||,,|,|||,||,|%   ",
        "    %||||,,,|||,,,,|%   ",
        "    %||||,||||||||||%   ",
        "    %|||BB,,,,,,,,||%   ",
        "    %%||||||||,||||%%   ",
        "       %||,,,,,||%      ",
        "        %|||,|||%       ",
        "         %%|<|%%        ",
        "          %|||%         "
      ],
      "flags": [ "ERASE_ALL_BEFORE_PLACING_TERRAIN" ],
      "terrain": {
        "|": "t_rock",
        "%": [ "t_rock", "t_region_groundcover_forest" ],
        ";": "t_region_soil",
        ",": "t_rock_floor",
        "B": "t_rock_floor",
        "<": "t_slope_down"
      },
      "furniture": {  },
      "monster": { "B": { "monster": "mon_bat" } }
    }
  },
  {
    "type": "mapgen",
    "method": "json",
    "om_terrain": [ "cave_innawood" ],
    "weight": 1000,
    "object": {
      "predecessor_mapgen": "forest_thick",
      "rows": [
        "                        ",
        "                        ",
        "                        ",
        "     %%%%%%%%%%%%%%%    ",
        "    %||||||||||||||%%   ",
        "    %|,||||,,W,,||||%   ",
        "    %|,,||,,|||,,|||%   ",
        "    %||,,W,|||||,,||%   ",
        "    %||||||||,,,,,||%   ",
        "    %|,|,,,,||||,,||%   ",
        "    %|W|,||,B||||,,,;   ",
        "    %,,|,,||,,|||,,,;   ",
        "    %|,||,,||||,,,||%   ",
        "    %|,,||,,|||,,|||%   ",
        "    %||,,||,,,,,||,|%   ",
        "    %|||,,|,|||W||,|%   ",
        "    %||||,W,|||,,,,|%   ",
        "    %||||,||||||||||%   ",
        "    %|||,,,,,,,W,,||%   ",
        "    %%||||||||,||||%%   ",
        "       %||,,W,,||%      ",
        "        %|||,|||%       ",
        "         %%|<|%%        ",
        "          %|||%         "
      ],
      "flags": [ "ERASE_ALL_BEFORE_PLACING_TERRAIN" ],
      "terrain": {
        "|": "t_rock",
        "%": [ "t_rock", "t_region_groundcover_forest" ],
        ";": "t_region_soil",
        ",": "t_rock_floor",
        "B": "t_rock_floor",
        "W": "t_rock_floor",
        "<": "t_slope_down"
      },
      "furniture": {  },
      "fields": { "W": { "field": "fd_web", "intensity": 1, "age": 10 } },
      "monster": { "B": { "monster": "mon_bear" } }
    }
  },
  {
    "type": "mapgen",
    "method": "json",
    "om_terrain": [ "cave_innawood" ],
    "weight": 1000,
    "object": {
      "predecessor_mapgen": "forest_thick",
      "rows": [
        "                        ",
        "         %%%%%%%        ",
        "        %|||||||%       ",
        "       %|||||||||%      ",
        "      %|||||,,,,||%     ",
        "     %||||||W||,,||%    ",
        "    %||,,,,,,|||,,||%   ",
        "   %||,,||||,,|||,,||%  ",
        "  %|||W||||||,,|||,,||% ",
        " %||||,,,,,|||,,|||,||% ",
        " %|||||||||||||,,|||||% ",
        " %||||,,,,,,W,,,,,,,,,; ",
        " %|||,,|||,||,,,,,,,,,; ",
        " %||,,||||,|||,,,,,|||% ",
        " %||W|||||,||||,,,||||% ",
        "  %|||,|||W|||||,|||||% ",
        "   %||,,||,,,||||||||%  ",
        "    %||,,|||,,||||||%   ",
        "     %||,,|||,,||||%    ",
        "      %||,,|||,,||%     ",
        "       %||,,W,,||%      ",
        "        %|||,|||%       ",
        "         %%|<|%%        ",
        "          %|||%         "
      ],
      "flags": [ "ERASE_ALL_BEFORE_PLACING_TERRAIN" ],
      "terrain": {
        "|": "t_rock",
        "%": [ "t_rock", "t_region_groundcover_forest" ],
        ";": "t_region_soil",
        ",": "t_rock_floor",
        "B": "t_rock_floor",
        "W": "t_rock_floor",
        "<": "t_slope_down"
      },
      "fields": { "W": { "field": "fd_web", "intensity": 1, "age": 10 } },
      "furniture": {  }
    }
  },
  {
    "type": "mapgen",
    "method": "json",
    "om_terrain": [ "cave_innawood" ],
    "weight": 1000,
    "object": {
      "predecessor_mapgen": "forest_thick",
      "rows": [
        "                        ",
        "         %%%%%%%        ",
        "        %|||||||%       ",
        "       %|||||||||%      ",
        "      %|||||,,W,||%     ",
        "     %||||||,||,,||%    ",
        "    %||,,W,,,|||,,||%   ",
        "   %||,,||||,,|||,W||%  ",
        "  %|||,||||||,,|||,,||% ",
        " %||||,,W,,|||,,|||,||% ",
        " %|||||||||||||,,|||||% ",
        " %||||,,,,,W,,,,,,,,,,; ",
        " %|||,,|||,||,,,,,,,,,; ",
        " %||,,||||,|||,,,,,|||% ",
        " %||W|||||,||||,B,||||% ",
        "  %|||,|||,|||||B|||||% ",
        "   %||,,||,W,||||||||%  ",
        "    %||,,|||,,||||||%   ",
        "     %||,,|||,,||||%    ",
        "      %||,,|||,,||%     ",
        "       %||,,W,,||%      ",
        "        %|||W|||%       ",
        "         %%|<|%%        ",
        "          %|||%         "
      ],
      "flags": [ "ERASE_ALL_BEFORE_PLACING_TERRAIN" ],
      "terrain": {
        "|": "t_rock",
        "%": [ "t_rock", "t_region_groundcover_forest" ],
        ";": "t_region_soil",
        ",": "t_rock_floor",
        "B": "t_rock_floor",
        "W": "t_rock_floor",
        "<": "t_slope_down"
      },
      "furniture": {  },
      "fields": { "W": { "field": "fd_web", "intensity": 1, "age": 10 } },
      "monster": { "B": { "monster": "mon_cougar" } }
    }
  },
  {
    "type": "mapgen",
    "method": "json",
    "om_terrain": [ "cave_innawood" ],
    "weight": 50,
    "object": {
      "rotation": [ 0, 3 ],
      "predecessor_mapgen": "forest_thick",
      "rows": [
        "                        ",
        "                        ",
        "                        ",
        "                        ",
        "                        ",
        "     %%%%%%%%%%%%%%%    ",
        "    %%||||||||||||||%   ",
        "    %|||,,,,,,||||||%   ",
        "    %|||,,|||,,|||||%   ",
        "    %|||,,||||,,||||%   ",
        "    %||,,,|||||,,|||%   ",
        "    %||,,,|||||,,|||%   ",
        "    %||||||,,,,,q|||%   ",
        "    %|||||,,||||||||%   ",
        "    %%|||;;||||||||%%   ",
        "     %;;|;;;;;%%%%%%    ",
        "      ~!?~~!RR?R!       ",
        "     RR~~RR#?!~~R       ",
        "    ! ??!~~RR~?!!       ",
        "     ~#RR?RR?~R#?       ",
        "     !?RR~~~R!RRR       ",
        "     RR~?R!~~?          ",
        "      !                 ",
        "                        "
      ],
      "flags": [ "ERASE_ALL_BEFORE_PLACING_TERRAIN" ],
      "terrain": {
        "|": "t_rock",
        "%": [ "t_rock", "t_region_groundcover_forest" ],
        ";": "t_rock_floor_no_roof",
        "!": "t_rock_floor_no_roof",
        "?": "t_rock_floor_no_roof",
        "#": "t_rock_floor_no_roof",
        "~": "t_rock_floor_no_roof",
        "@": "t_rock_floor",
        ",": "t_rock_floor",
        "q": "t_rock_floor",
        "R": "t_rock_floor_no_roof"
      },
      "furniture": { "R": [ [ "f_boulder_small", 1 ], [ "f_null", 10 ] ] },
      "item": { "~": { "item": "bone", "chance": 50, "repeat": [ 1, 3 ] } },
      "fields": {
        "!": { "field": "fd_gibs_flesh", "intensity": 2, "age": 10 },
        "?": { "field": "fd_blood", "intensity": 2, "age": 10 },
        "#": { "field": "fd_blood", "intensity": 3, "age": 10 }
      },
      "monster": { "q": { "monster": "mon_rabbit_dreadful" } }
    }
  },
  {
    "type": "mapgen",
    "method": "json",
    "om_terrain": [ "cave_underground_innawood" ],
    "weight": 50,
    "object": {
      "rows": [
        "........................",
        ".......~~~~~~~~~~~......",
        "......~~~~~~~~~~~~~.....",
        "......~~~~~~~~~~~~~.....",
        "......~~~~......~~~.....",
        ".....~~~~~~.....~~~.....",
        "....~~~~~~~~....~~~~....",
        "......~~~~~~~..~~~~~....",
        "....~~~~W~~~..~~~~~~....",
        "....~~~~~~~~..~~~~~.....",
        ".....~~~~~~~..~~~~~.....",
        "..............~~~~~~....",
        "............~~~~~~~.....",
        "...........~~~~~~~......",
        "....~~~~~~~~~~~~~~~~....",
        ".....~~~~~~~~~~~~~~.....",
        ".......~~~~~~~~~~~......",
        ".......~~~~~~~~~~~......",
        "........~~~~~~~~~~......",
        ".........~~~~~~~~.......",
        "..........~~~~~~~.......",
        "............,...........",
        "............>...........",
        "........................"
      ],
      "terrain": { ".": "t_soil", ",": "t_dirt_underground", "W": "t_dirt_underground", ">": "t_slope_up", "~": "t_water_dp" },
      "furniture": { "W": "f_boulder_small" },
      "monster": {
        "~": [
          { "monster": "mon_sewer_fish", "chance": 1 },
          { "monster": "mon_mutant_salmon", "chance": 1 },
          { "monster": "mon_mutant_carp", "chance": 1 }
        ]
      }
    }
  },
  {
    "type": "mapgen",
    "method": "json",
    "om_terrain": [ "cave_underground_innawood" ],
    "weight": 1000,
    "object": {
      "fill_ter": "t_dirt_underground",
      "rows": [
        "........................",
        "........................",
        "...............~~~~~~...",
        "..............~~~~~~~~..",
        "..............~~~~~~~~..",
        "............~~~~~~~~~~..",
        "...........~~~~~~~~~~~..",
        "...........~~~~~~~~~~~..",
        "...........~~~~~~~~~~...",
        ".........~~~~~~~~.......",
        "..~~~~~~~~~~~~~~~.......",
        "....~~~~~~~~~~~~~~~~~~..",
        "..~~~~~~~~~~~~~~~~~~~~~.",
        "..~~~~~~~~~~~~~~~~~~~~~.",
        "...~~~~~~~~~~~~~~~~~~~..",
        "....~~~~~~~~~~~~........",
        "....~~~~~.,,,,,.........",
        "..~~~~~~~..,,,..........",
        "..~~~~~~~...,...........",
        "...~~~~~~...,...........",
        ".....~~~....,...........",
        "............,...........",
        "............>...........",
        "........................"
      ],
      "terrain": { ".": "t_soil", ",": "t_dirt_underground", ">": "t_slope_up" },
      "furniture": {  },
      "items": {
        "~": [
          { "item": "monparts", "chance": 2 },
          { "item": "trash_forest", "chance": 2 },
          { "item": "cave_minerals", "chance": 20 }
        ]
      }
    }
  },
  {
    "type": "mapgen",
    "method": "json",
    "om_terrain": [ "cave_underground_innawood" ],
    "weight": 800,
    "object": {
      "fill_ter": "t_dirt_underground",
      "rows": [
        "........................",
        ".......... 1       .....",
        "...    ... .......  ....",
        "...1..  ..  ..   ..  ...",
        "... ...  ..       ..1 ..",
        "... ....  ...  M   .. ..",
        "...  ....  ..      .. ..",
        "....  ....  ..    ..  ..",
        ".....  ....  ......1 ...",
        "......  ....     1  ....",
        ".......  ...............",
        ".......   1       ......",
        ".... 1   ........  .....",
        ".... .............  ....",
        ".... .............. 1...",
        ".. 1  .............. ...",
        ".. ..  ............. ...",
        ".. ...        ...... ...",
        ".. ..........  ....  ...",
        ".. 1..........  1   ....",
        "...  ........  .........",
        "....      1   ..........",
        "............>...........",
        "........................"
      ],
      "terrain": { ".": "t_soil", " ": "t_dirt_underground", ">": "t_slope_up" },
      "furniture": {  },
      "items": { "1": { "item": "cave_minerals", "chance": 40, "repeat": [ 1, 3 ] } },
      "monster": { "M": { "monster": "mon_nakedmolerat_giant" }, " ": { "monster": "mon_nakedmolerat_giant", "chance": 2 } }
    }
  },
  {
    "type": "mapgen",
    "method": "json",
    "om_terrain": [ "cave_underground_innawood" ],
    "weight": 500,
    "object": {
      "fill_ter": "t_dirt_underground",
      "rows": [
        "........................",
        "........................",
        "...........!!!!!!.......",
        ".........!!!!!!!!!......",
        ".........!!!!!!!!!......",
        ".........!!!!!!!!!......",
        ".......!!!,,,,,,!.......",
        "........!!!!..,,,!......",
        ".........!!,..,,,!!.....",
        "..........,,,,,,,!......",
        "..........,,,,,,,.......",
        "..........,,,,,,,.......",
        "..........,,,,,,,.......",
        ".........,,,,.,,,.......",
        ".........,,,,...,.......",
        ".........,,,,...,.......",
        ".........,,,,...,.......",
        ".........,,,,...,.......",
        ".........,,,,...,.......",
        ".........,,,,..,,.......",
        ".........,,,..,,........",
        "..........,,.,,.........",
        "...........,>,..........",
        "........................"
      ],
      "terrain": { ".": "t_soil", ",": "t_dirt_underground", ">": "t_slope_up" },
      "items": { "!": { "item": "cave_minerals", "chance": 100, "repeat": [ 1, 3 ] } },
      "furniture": {  }
    }
  },
  {
    "type": "mapgen",
    "method": "json",
    "om_terrain": [ "cave_underground_innawood" ],
    "weight": 250,
    "object": {
      "fill_ter": "t_dirt_underground",
      "rows": [
        "........................",
        "........................",
        ".....a  11 13  1111111..",
        "...11   .........     ..",
        "...11 a .........  a ...",
        "....1   ..........1111..",
        ".......  ..........4....",
        "........   ......   ....",
        "..........2.....  ......",
        "..........1....  .......",
        ".........  ....1........",
        "........  .....5........",
        ".......11......1........",
        ".... a    .....   .11...",
        "...        ....       ..",
        "...11  a    ...  a   ...",
        ".....       ........  ..",
        "...111111............  .",
        "...  a      .....  ... .",
        "....   a     .....     .",
        "............ ....   a  .",
        "............6....      .",
        "............>.... .    .",
        "........................"
      ],
      "terrain": { ".": "t_soil", " ": "t_dirt_underground", ">": "t_slope_up" },
      "items": { "a": { "item": "cave_minerals", "chance": 40, "repeat": [ 1, 3 ] } },
      "furniture": {  },
      "fields": {
        "1": { "field": "fd_web", "intensity": 1, "age": 10 },
        "2": { "field": "fd_web", "intensity": 1, "age": 10 },
        "3": { "field": "fd_web", "intensity": 1, "age": 10 },
        "4": { "field": "fd_web", "intensity": 1, "age": 10 },
        "5": { "field": "fd_web", "intensity": 1, "age": 10 },
        "6": { "field": "fd_web", "intensity": 1, "age": 10 }
      }
    }
  },
  {
    "type": "mapgen",
    "method": "json",
    "om_terrain": [ "cave_underground_innawood" ],
    "weight": 700,
    "object": {
      "fill_ter": "t_dirt_underground",
      "rows": [
        "........................",
        ".......11111111111......",
        ".....111        1111....",
        ".....111         111....",
        "....111          111....",
        "...11              11...",
        "...11              11...",
        "...11              11...",
        "...11              11...",
        "...11              11...",
        "...11111         1111...",
        "......11         1......",
        "........         .......",
        "........         .......",
        "........         .......",
        "........         .......",
        "..........     .........",
        "...........   ..........",
        "...........   ..........",
        "...........   ..........",
        "...........   ..........",
        "...........   ..........",
        "........... > ..........",
        "........................"
      ],
      "terrain": { ".": "t_soil", " ": "t_dirt_underground", ">": "t_slope_up", "2": "t_railroad_track_small" },
      "furniture": {  },
      "items": { "1": { "item": "cave_minerals", "chance": 40, "repeat": [ 1, 3 ] } },
      "monsters": { " ": { "monster": "GROUP_CAVE", "chance": 2 } }
    }
  },
  {
    "type": "mapgen",
    "method": "json",
    "om_terrain": [ "cave_rat_underground_innawood" ],
    "object": {
      "fill_ter": "t_dirt_underground",
      "rotation": [ 0, 3 ],
      "rows": [
        "1...........2...........",
        "........................",
        "........................",
        "........................",
        "........................",
        "........................",
        "........................",
        "........................",
        "........... ............",
        "........... ............",
        "........... ............",
        "......     >............",
        "3...........4...........",
        "........................",
        "........................",
        "........................",
        "........................",
        "........................",
        "........................",
        "........................",
        "........................",
        "........................",
        "......................  ",
        "...................... <"
      ],
      "terrain": { ".": "t_soil", " ": "t_dirt_underground", ">": "t_slope_up", "<": "t_slope_down" },
      "furniture": {  },
      "nested": {
        "1": { "chunks": [ "cave_nw" ] },
        "2": { "chunks": [ "cave_ne" ] },
        "3": { "chunks": [ "cave_sw" ] },
        "4": { "chunks": [ "cave_se" ] }
      }
    }
  },
  {
    "type": "mapgen",
    "method": "json",
    "om_terrain": [ "cave_rat_innawood" ],
    "object": {
      "fill_ter": "t_rock_floor",
      "rotation": [ 0, 3 ],
      "rows": [
        "........................",
        ".........%%%%%%%........",
        "........%%%%%%%%%.......",
        ".......%%%.....%%%......",
        "......%%%%.lll.%%%%.....",
        ".....%%%%%.l l.%%%%%....",
        "....%%%%%%.l l.%%%%%%...",
        "...%%%||||.. ..||||%%%..",
        "..%%%||||||. .||||||%%%.",
        ".%%%%||||rr   rr||||%%%.",
        ".%%%%||||rr   rr||||%%%.",
        ".%%%%||||       ||||%%%.",
        ".%%%%||||   K   ||||%%%.",
        ".%%%%||||       ||||%%%.",
        ".%%%%||||rr   rr||||%%%.",
        "..%%%||||rr   rr||||%%%.",
        "...%%%|||||   |||||%%%..",
        "....%%%||||   ||||%%%...",
        ".....%%%%%%   %%%%%%....",
        "......%%%%%%<%%%%%%.....",
        ".......%%%%%%%%%%%......",
        "........%%%%%%%%%.......",
        ".........%%%%%%%........",
        "........................"
      ],
      "terrain": {
        " ": "t_rock_floor",
        ".": "t_rock",
        "|": [ [ "t_rock", 20 ], [ "t_rock_floor", 80 ] ],
        "%": [ "t_rock", "t_rock_floor" ],
        "<": "t_slope_up"
      },
      "furniture": {  },
      "monster": { "K": { "monster": "mon_rat_king" }, "r": { "monster": "mon_sewer_rat" } },
      "item": { "l": { "item": "bone", "chance": 50, "repeat": [ 1, 3 ] } }
    }
  },
  {
    "id": "archeology_tools",
    "type": "item_group",
    "subtype": "collection",
    "copy-from": "archeology_tools",
    "extend": { "entries": [ { "item": "bone", "prob": 75 } ] }
  }
]
