[
  {
    "type": "mapgen",
    "method": "json",
    "om_terrain": [ [ "lab_surface_CDC_blockA0", "lab_surface_CDC_blockB0", "lab_surface_CDC_blockC0" ], [ "lab_surface_CDC_blockA1", "lab_surface_CDC_blockB1", "lab_surface_CDC_blockC1" ] ],
    "object": {
      "fill_ter": "t_strconc_floor",
      "rows": [
        "012345678901234567890123012345678901234567890123012345678901234567890123",
        "1%%|,_____,_____,_____,_____,_____,_____]]]|%%%|....________,,_______...",
        "2%%|,_____,_____,_____,_____,_____,_____]]]|%%%|....________,,_______...",
        "3|||,_____,_____,_____,_____,_____,_____]|M|%%%|....________,,_______...",
        "4]]],_____,_____,_____,_____,_____,_____]|%%%%%:..._________,,_______...",
        "5]?],_____,_____,_____,_____,_____,_____]|%%%%%:..__________,,_______...",
        "6]]],_____,_____,_____,_____,_____,_____||}}||||____________,,_______...",
        "7,,____________________________________,!,__________________,,_______...",
        "8_,____________________________________,!,_________________,,________...",
        "9,,____________________________________,!,________________,,_________...",
        "0_,____________________________________,!,_______________,,-_________...",
        "1,,____________________________________,!,______________,,__________....",
        "2_,____________________________________|///|///|,,,,,,,,,__________.....",
        "3,,___________________________________________,!,_________________......",
        "4_,,,,,,,,____________________________________,!,________________.......",
        "5,,__,__,,____________________________________,!,_______________........",
        "6_,_,__,_,|___________________________________,!,______________.........",
        "7,,,__,__,|___________________________________,!,_____________..........",
        "8_,__,__,,|],_____,_____,_____,_____,]]]]]]]]]]|........................",
        "9,,_,__,_,|],_____,_____,_____,_____,]?]?]?]?]?||||||||||||||||||||||...",
        "0_,,__,__,|],_____,_____,_____,_____,]]]]]]]]]]]]]]]]]]]]]..........|...",
        "1,,__,__,,|],_____,_____,_____,_____,]|:::|||||]?]]]]]]]]]..........|...",
        "2_,_,__,_,|],_____,_____,_____,_____,]-   dc &|]]]|||||||||||||||||||...",
        "3,,,__,__,|],_____,_____,_____,_____,]-   d1  |]]]|                 |...",
        "0||MMMMMMM|]]]]]]]]]]]]]]]]]]]]]]]]]]]:1  dc  |]]]|                 |...",
        "1         ||::||::||::||::||::||::|||||:--||m||]]]|                 |...",
        "2         m                               |l x|]]]|                 |...",
        "3         m                               |l c|]]]|                 |...",
        "4         ||:|--||:|--||:|--||:|--||m@| 1 |l l|]]]|                 |...",
        "5          |     |     |     |     |ee| % ||M||:::|                 |...",
        "6          |     |     |     |     |ee| 1     -   -                 |...",
        "7          |     |     |     |     |||| % |||||:::|                 |...",
        "8          |     |     |     |     |< - 1 |t|t|...|                 |...",
        "9          |     |     |     |     |> - % |+|+|...|                 |...",
        "0         |||||||||||m|||||||||||||||||   +   :...|                 |...",
        "1         m            m                  |S&S|...|                 |...",
        "2         m        |+||||--|||--|||--||  ||||||...|                 |...",
        "3||||||||||||MM||||| &s|    |    |    |  -    |...|                 |...",
        "4|eee@<<>>|cd  |l s|   |    |    |    |  |    |...|                 |...",
        "5|eeeM    M    |l d|+|+|    |    |    |  |    |...|                 |...",
        "6|eeeM    M    m  s|h|t|    |    |    |  |    |...|||||||||||||||||||...",
        "7||||||||||||||||||||||||::|||::|||::||mm||::||.?.|                 |...",
        "8.......................*************]]]]]]****...|                 |...",
        "9................................?...|]]]]|....?..|                 |...",
        "0.............................?............?......|||||||||||||||||||...",
        "1...............................?..?.........?......................|...",
        "2......................................?............................|...",
        "3||||||||||||||||||||||||||||||||||||||||||||||||||||||||||||||||||||..."
      ],
      "palettes": [ "lab_surface_palette" ],
      "&": [ { "item": "tools_science", "chance": 10 }, { "item": "trash", "chance": 50, "repeat": [ 1, 2 ] } ],
      "place_nested": [
        { "chunks": [ "surface_sub_f_crate" ], "x": [ 1, 3 ], "y": [ 25, 36 ], "chance": 75, "repeat": 10 },
        { "chunks": [ "surface_sub_f_crate" ], "x": [ 4, 5 ], "y": [ 34, 36 ], "chance": 75, "repeat": 5 }
      ]
    }
  },
  {
    "type": "overmap_terrain",
    "id": "lab_surface_CDC_blockA0",
    "name": "parking lot",
    "sym": "_",
    "color": "dark_gray",
    "spawns": { "group": "GROUP_LAB_SURFACE", "population": [ 5, 20 ], "chance": 50 },
    "see_cost": 5,
    "mondensity": 2
  },
  {
    "type": "overmap_terrain",
    "id": "lab_surface_CDC_blockB0",
    "copy-from": "lab_surface_CDC_blockA0"
  },
  {
    "type": "overmap_terrain",
    "id": "lab_surface_CDC_blockC0",
    "copy-from": "lab_surface_CDC_blockA0"
  },
  {
    "type": "overmap_terrain",
    "id": "lab_surface_CDC_blockA1",
    "name": "research facility",
    "sym": "l",
    "color": "light_gray",
    "spawns": { "group": "GROUP_LAB_SURFACE", "population": [ 10, 25 ], "chance": 60 },
    "see_cost": 5,
    "mondensity": 2
  },
  {
    "type": "overmap_terrain",
    "id": "lab_surface_CDC_blockB1",
    "copy-from": "lab_surface_CDC_blockA1"
  },
  {
    "type": "overmap_terrain",
    "id": "lab_surface_CDC_blockC1",
    "copy-from": "lab_surface_CDC_blockA1"
  },
  {
    "type": "overmap_special",
    "id": "lab_surface_CDC",
    "overmaps": [
      { "point": [ 0, 0, 0 ], "overmap": "lab_surface_CDC_blockA0_north" },
      { "point": [ 1, 0, 0 ], "overmap": "lab_surface_CDC_blockB0_north" },
      { "point": [ 2, 0, 0 ], "overmap": "lab_surface_CDC_blockC0_north" },
      { "point": [ 0, 1, 0 ], "overmap": "lab_surface_CDC_blockA1_north" },
      { "point": [ 1, 1, 0 ], "overmap": "lab_surface_CDC_blockB1_north" },
      { "point": [ 2, 1, 0 ], "overmap": "lab_surface_CDC_blockC1_north" }
    ],
    "connections": [ { "point": [ 2, -1, 0 ], "terrain": "road", "connection": "local_road", "from": [ 2, 0, 0 ] } ],
    "locations": [ "land" ],
    "city_distance": [ 0, 120 ],
    "city_sizes": [ 1, 12 ],
    "occurrences": [ 1, 1 ],
    "flags": [ "UNIQUE" ]
  }
]
