[
  {
    "type": "mapgen",
    "method": "json",
    "om_terrain": [
      [
        "lab_surface_brick_blockA0",
        "lab_surface_brick_blockB0",
        "lab_surface_brick_blockC0",
        "lab_surface_brick_blockD0",
        "lab_surface_brick_blockE0"
      ],
      [
        "lab_surface_brick_blockA1",
        "lab_surface_brick_blockB1",
        "lab_surface_brick_blockC1",
        "lab_surface_brick_blockD1",
        "lab_surface_brick_blockE1"
      ],
      [
        "lab_surface_brick_blockA2",
        "lab_surface_brick_blockB2",
        "lab_surface_brick_blockC2",
        "lab_surface_brick_blockD2",
        "lab_surface_brick_blockE2"
      ],
      [
        "lab_surface_brick_blockA3",
        "lab_surface_brick_blockB3",
        "lab_surface_brick_blockC3",
        "lab_surface_brick_blockD3",
        "lab_surface_brick_blockE3"
      ],
      [
        "lab_surface_brick_blockA4",
        "lab_surface_brick_blockB4",
        "lab_surface_brick_blockC4",
        "lab_surface_brick_blockD4",
        "lab_surface_brick_blockE4"
      ]
    ],
    "object": {
      "fill_ter": "t_strconc_floor",
      "rows": [
        "................................................#!!!!!!!!|________......................................................",
        "................................................#________/________......................................................",
        "#################################################________/________|:|||#################################################",
        "#.............................................../________/________| Cl|]____,,____,,_____,,_____,,____,,____,,____]....#",
        "#.............................................../________/________}s  |]____,,____,,_____,,_____,,____,,____,,____]....#",
        "#.............................................../________/________|xx |]____,,____,,_____,,_____,,____,,____,,____]....#",
        "#.............................................../________/________|||m|]____,,____,,_____,,_____,,____,,____,,____]....#",
        "#..............................................._________|!!!!!!!!|]]]]]____,,____,,_____,,_____,,____,,____,,____]]]]]#",
        "#..........]]]]]]]]]]]]]]]]]]]]]]]]]]]]]........____________________________,,____,,_____,,_____,,____,,____,,____,,__,#",
        "#..........]*********************'*****]........____________________________,,____,,_____,,_____,,____,,____,,____,_,__#",
        "#..........]****************~***''*???*]........__________________________________________________________________,__,_#",
        "#..........]*****???????****~~**'***??*]........__________________________________________________________________,,__,#",
        "#..........]'''****????***~~~~**'**???*]........__________________________________________________________________,_,__#",
        "#..........]**''*********~~~~~**'******]........__________________________________________________________________,__,_#",
        "#..........]***'**********~~~~*''******]........____________________________,,____,,_____,,_____,,____,,____,,____,,__,#",
        "#..........]***''*&bbb*****~~**'****???]........____________________________,,____,,_____,,_____,,____,,____,,____,_,__#",
        "#..........]****''''''****~~~**'??????*]........____________________________,,____,,_____,,_____,,____,,____,,____,__,_#",
        "#..........]****???**''''']]''''''''***]........____________________________,,____,,_____,,_____,,____,,____,,____,,__,#",
        "#..........]*???????***~~~~~~b'****'''']........____________________________,,____,,_____,,_____,,____,,____,,____,_,__#",
        "#..........]***?????****~~~~.b'*???****]........____________________________,,____,,_____,,_____,,____,,____,,____,__,_#",
        "#..........]****???****~~~~**&'***??***]........____________________________,,____,,_____,,_____,,____,,____,,____,___,#",
        "#..........]**????**~~~~~****''****??**]........________________________,,,,,,,,,,,,,,,,,,,,,,,,,,,,,,,,,,,,,,,,,,,,,,,#",
        "#..........]*********~~~~'''''****??***]........____________________________________________________________,..........#",
        "#..........]*********~~*''*******???***]........____________________________________________________________,..........#",
        "#..........]************'******?????***].......]____________________________________________________________,..........#",
        "#..........]************'**************]......]]____________________________________________________________,..........#",
        "#..........]]]]]]]]]]]]]]]]]]]]]]]]]]]]].....]]_____________________________________________________________,..........#",
        "#...........................................]]______________________________________________________________,..........#",
        "#..........................................]]_______________________________________________________________,..........#",
        "#..........]]]]]]]]]]]]]]]]]]]]]]]]]]]]]]]]]]]]],,,,,,,_________________]]]]]]]]]]]]]]]]]]]]]]]]]]],,,,,,,,]]..........#",
        "#..........]|  #########################  |]***],,,,,,,_________________]***]|  ###################__,__,__|]..........#",
        "#..........]   :     #&T#T&#           :   ]***]_________________,,,,,,,]***]   #|||||||||||#&T#T&#,__,__,_ ]..........#",
        "#..........]   :     #  #  #           :   ]***]_________________,,,,,,,]***]   #|eeee|b <>|#  #  #_,__,__, ]..........#",
        "#..........]|  #     # S#S #           #  |]***]________________________]***]|  #|eeee|b <>|# S#S #__,__,__|]..........#",
        "#..........]   :     #+###+#           :   ]***]________________________]***]   #|eeee@b   |#+###+#,__,__,_ ]..........#",
        "#..........]   :     - <D< #           :   ]***],,,,,,,_________________]***]   #|eeeem    M  <D< #_,__,__, ]..........#",
        "#..........]|  ####### % % #           #  |]***],,,,,,,_________________]***]|  #||||||||||||     #__,__,__|]..........#",
        "#..........]   :     # % % #           :   ]***]_________________,,,,,,,]***]   #           m     #,__,__,_ ]..........#",
        "#..........]   :     # % % #           :   ]***]_________________,,,,,,,]***]   #           m     #_,__,__, ]..........#",
        "#..........]|  #     # %1% #           #  |]***]________________________]***]|  #           |     #__,__,__|]..........#",
        "#..........]   :     # % % -           :   ]]]]]________________________]]]]]   #           |     #,__,__,_ ]..........#",
        "#..........]   :     - % % -           :   ]***],,,,,,,_________________]***]   #           |     #_,__,__, ]..........#",
        "#..........]|  ####### %1% #############  |]***],,,,,,,_________________]***]|  #           |     #__,__,__|]..........#",
        "#..........]   #xxxxx# % % #T#T#T#T#T#T#   ]***]_________________,,,,,,,]***]   #           |     #,__,__,_ ]..........#",
        "#..........]   #xsssx# % % #+#+#+#+#+#+#   ]***]_________________,,,,,,,]***]   #           |     #_,__,__, ]..........#",
        "#..........]|  #L   L# %1% +           #  |]***]________________________]***]|  #           |     #MMMMMMMM#]..........#",
        "#..........]   M     M % % #          l#   ]***]________________________]***]   #           m              #]..........#",
        "#..........]   M     M % % #S&S&S&S&S l#   ]***],,,,,,,_________________]***]   #           m              M]..........#",
        "#..........]|  ####### %1% #############  |]***],,,,,,,_________________]***]|  #||||||||||||              #]..........#",
        "#..........]   :     # % % #           :   ]***]_________________,,,,,,,]***]   #           m              #]..........#",
        "#..........]   :     # % % #           :   ]***]_________________,,,,,,,]***]   #           m              #]..........#",
        "#..........]|  #     - %1% #           #  |]]]]]________________________]]]]]|  #           |              #]..........#",
        "#..........]   :     # % % #           :   ]***]________________________]***]   #           |              #]..........#",
        "#..........]   :     # % % #           :   ]***],,,,,,,_________________]***]   #           |              #]..........#",
        "#..........]|  ####### %1% #           #  |]***],,,,,,,_________________]***]|  #           |              #]..........#",
        "#..........]   :     # % % #           :   ]***]_________________,,,,,,,]***]   #           |              #]..........#",
        "#..........]   :     # % % #           :   ]***]_________________,,,,,,,]***]   #           |              #]..........#",
        "#..........]|  #     - %1% #           #  |]***]________________________]***]|  #           |              #]..........#",
        "#..........]   :     # % % -           :   ]***]________________________]***]   #           m              #]..........#",
        "#..........]   :     # % % -           :   ]***],,,,,,,_________________]***]   #           m              #]..........#",
        "#..........]|  ####### %1% #############  |]***],,,,,,,_________________]***]|  #||||||||||||              #]..........#",
        "#..........]   :     # % %%AFD&S% bttb :   ]]]]]_________________,,,,,,,]]]]]   #                          #]..........#",
        "#..........]   :     # % %%%%%%%% bttb :   ]***]_________________,,,,,,,]***]   #                          #]..........#",
        "#..........]|  #     - %1%%%%%%%%     &#  |]***]________________________]***]|  #                          #]..........#",
        "#..........]   :     # % % bttb % bttb :   ]***]________________________]***]   #                          #]..........#",
        "#..........]   :     # % % bttb % bttb :   ]***],,,,,,,_________________]***]   #                          #]..........#",
        "#..........]|  ####### %1%      %     &#  |]***],,,,,,,_________________]***]|  #                          #]..........#",
        "#..........]   :     # % % bttb % bttb :   ]***]_________________,,,,,,,]***]   #                          #]..........#",
        "#..........]   :     # % % bttb % bttb :   ]***]_________________,,,,,,,]***]   #                          #]..........#",
        "#..........]|  #     - %1%      %     &#  |]***]________________________]***]|  #                          #]..........#",
        "#..........]   :     # % % bttb % bttb :   ]***]________________________]***]   #                          #]..........#",
        "#..........]   :     # % % bttb % bttb :   ]***],,,,,,,_________________]***]   #                          #]..........#",
        "#..........]|  ####### %1%            &#  |]***],,,,,,,_________________]***]|  #############mm#mm#######MM#]..........#",
        "#..........]   :     : % % bttb % bttb :   ]]]]]]]]]]]]]]]]]]]]]]]]]]]]]]]]]]   :           - % % :     :   ]..........#",
        "#..........]   :     : % % bttb % bttb :   ]]*******]]]]]]]]]]]]]]]]*******]]   :           - % % :     :   ]..........#",
        "#..........]|  #     - %1%      %     &#  |]]*****]]]]]]#--::--#]]]]]]*****]]|  #           # %1% -     #  |]..........#",
        "#..........]   :     : % % bttb % bttb :   ]]****]]]]#::#      #::#]]]]****]]   :           : % % :     :   ]..........#",
        "#..........]   :     : % % bttb % bttb :   ]]***]]]#:#            #:#]]]***]]   :           : % % :     :   ]..........#",
        "#..........]|  ####### %1%      %#######  |]]***]]##                ##]]***]]|  #           # %1% #######  |]..........#",
        "#..........]   :     : % %%%%%%%%-    S:   ]]]]]]##                  ##]]]]]]   :           : % % :     :   ]..........#",
        "#..........]   :     : % %%AFD&#-#    C:   ]]]]]]:                    :]]]]]]   :           : % % :     :   ]..........#",
        "#..........]|  #     - %1% #####      C#  |  |  ##                    ##  |  |  #           # %1% -     #  |]..........#",
        "#..........]   :     : % % #U          :        -                      -        :           : % % :     :   ]..........#",
        "#..........]   :     : % % #CCffoCCCS& :        -                      -        :           : % % :     :   ]..........#",
        "#..........]|  ####### %1% #############::#::#::#                      #::#::#::#--#::#::#::# %1% #######  |]..........#",
        "#..........]   :     : % %             :                                        :             % % :     :   ]..........#",
        "#..........]   :     : % %             :                                        :             % % :     :   ]..........#",
        "#..........]|  #     - %1%             :                                        :             %1% -     #  |]..........#",
        "#..........]   :     : % %             :                                        :             % % :     :   ]..........#",
        "#..........]   :     : % %             :                                        :             % % :     :   ]..........#",
        "#..........]|  ####### %1%             |                                        |             %1% #######  |]..........#",
        "#..........]   :     : % %             :                                        :             % % :     :   ]..........#",
        "#..........]   :     : % %             :                                        :             % % :     :   ]..........#",
        "#..........]|  #     - %1%             :                                        :             %1% -     #  |]..........#",
        "#..........]   :     : % %             -                                        -             % % :     :   ]..........#",
        "#..........]   :     : % %             -                                        -             % % :     :   ]..........#",
        "#..........]|  ####### %1%             |                                        |             %1% #######  |]..........#",
        "#..........]   :     : % %             -                                        -             % % :     :   ]..........#",
        "#..........]   :     : % %             -                                        -             % % :     :   ]..........#",
        "#..........]|  #     - %1%             :             %%%%%%%%%%%%%%             :             %1% -     #  |]..........#",
        "#..........]   :     : % %             :             %<<%%%%%%%%<<%             :             % % :     :   ]..........#",
        "#..........]   :     : % %             :             %|<%%%%%%%%<|%             :             % % :     :   ]..........#",
        "#..........]|  #||||||||||||||#        |             %%%%%%%%%%%%%%             |        #||||||||||||||#  |]..........#",
        "#..........]   |T|T|T|T|T|T|ll|        :                                        :        |ll|T|T|T|T|T|T|   ]..........#",
        "#..........]   |+|+|+|+|+|+|mm|        :                                        :        |mm|+|+|+|+|+|+|   ]..........#",
        "#..........]|  #%%%%%%%%%%%%%%#        :                                        :        #%%%%%%%%%%%%%%#  |]..........#",
        "#..........]   :%%%%%%%%%%%%%%-        :                                        :        -%%%%%%%%%%%%%%:   ]..........#",
        "#..........]   :SS&SS&SS&SS&%%-        :                                        :        -%%&SS&SS&SS&SS:   ]..........#",
        "#..........]|  #::#::#::#::#::#::#::#::#::#::#::#::#--#--#:--:#--#--#::#::#::#::#::#::#::#::#::#::#::#::#  |]..........#",
        "#..........]                                       :ee@ee:    :ee@ee:                                       ]..........#",
        "#..........]                                       :ee:ee:    :ee:ee:                                       ]..........#",
        "#..........]|  |  |  |  |  |  |  |  |  |  |  |  |  |::|::|    |::|::|  |  |  |  |  |  |  |  |  |  |  |  |  |]..........#",
        "#..........]]]]]]]]]]]]]]]]]]]]]]]]]]]]]]]]]]]]]]]]]]]]]]]]]]]]]]]]]]]]]]]]]]]]]]]]]]]]]]]]]]]]]]]]]]]]]]]]]]..........#",
        "#......................................................................................................................#",
        "#......................................................................................................................#",
        "#......................................................................................................................#",
        "#......................................................................................................................#",
        "#......................................................................................................................#",
        "#......................................................................................................................#",
        "########################################################################################################################"
      ],
      "items": {
        "&": [ { "item": "tools_science", "chance": 10 }, { "item": "SUS_trash_floor", "chance": 50, "repeat": [ 1, 2 ] } ],
        "C": [ { "item": "snacks", "chance": 30, "repeat": [ 1, 2 ] }, { "item": "cannedfood", "chance": 30, "repeat": [ 1, 5 ] } ],
        "f": [
          { "item": "snacks", "chance": 60, "repeat": [ 2, 10 ] },
          { "item": "fridgesnacks", "chance": 60, "repeat": [ 2, 10 ] }
        ],
        "l": { "item": "cleaning", "chance": 70, "repeat": [ 1, 8 ] },
        "L": [
          { "item": "guns_pistol_common", "chance": 20, "repeat": [ 1, 2 ] },
          { "item": "mags_common", "chance": 40, "repeat": 5 },
          { "item": "ammo_common_boxed", "chance": 40, "repeat": [ 5, 10 ] }
        ],
        "t": [ { "item": "snacks", "chance": 5 }, { "item": "dining", "chance": 10 } ],
        "U": { "item": "snacks", "chance": 70, "repeat": [ 1, 8 ] }
      },
      "place_vehicles": [
        { "vehicle": "parkinglotbasic", "chance": 20, "fuel": -1, "rotation": 270, "x": 74, "y": 5 },
        { "vehicle": "parkinglotbasic", "chance": 20, "fuel": 20, "rotation": 270, "x": 79, "y": 5 },
        { "vehicle": "parkinglotbasic", "chance": 20, "fuel": -1, "rotation": 270, "x": 86, "y": 5 },
        { "vehicle": "parkinglotbasic", "chance": 20, "fuel": 30, "rotation": 270, "x": 91, "y": 5 },
        { "vehicle": "parkinglotbasic", "chance": 20, "fuel": -1, "rotation": 270, "x": 99, "y": 5 },
        { "vehicle": "parkinglotbasic", "chance": 20, "fuel": 20, "rotation": 270, "x": 105, "y": 5 },
        { "vehicle": "parkinglotbasic", "chance": 20, "fuel": -1, "rotation": 270, "x": 111, "y": 5 },
        { "vehicle": "parkinglotbasic", "chance": 20, "fuel": -1, "rotation": 90, "x": 80, "y": 18 },
        { "vehicle": "parkinglotbasic", "chance": 20, "fuel": 20, "rotation": 90, "x": 87, "y": 18 },
        { "vehicle": "parkinglotbasic", "chance": 20, "fuel": -1, "rotation": 90, "x": 93, "y": 18 },
        { "vehicle": "parkinglotbasic", "chance": 20, "fuel": 40, "rotation": 90, "x": 100, "y": 18 },
        { "vehicle": "parkinglotbasic", "chance": 20, "fuel": -1, "rotation": 90, "x": 106, "y": 18 },
        { "vehicle": "parkinglotbasic", "chance": 20, "fuel": 30, "rotation": 90, "x": 112, "y": 18 },
        { "vehicle": "parkinglotbasic", "chance": 20, "fuel": -1, "rotation": 180, "x": 50, "y": 33 },
        { "vehicle": "parkinglotbasic", "chance": 20, "fuel": 20, "rotation": 180, "x": 50, "y": 39 },
        { "vehicle": "parkinglotbasic", "chance": 20, "fuel": -1, "rotation": 180, "x": 50, "y": 45 },
        { "vehicle": "parkinglotbasic", "chance": 20, "fuel": -1, "rotation": 180, "x": 50, "y": 57 },
        { "vehicle": "parkinglotbasic", "chance": 20, "fuel": 20, "rotation": 180, "x": 51, "y": 63 },
        { "vehicle": "parkinglotbasic", "chance": 20, "fuel": -1, "rotation": 180, "x": 51, "y": 69 },
        { "vehicle": "parkinglotbasic", "chance": 20, "fuel": 50, "rotation": 0, "x": 69, "y": 34 },
        { "vehicle": "parkinglotbasic", "chance": 20, "fuel": -1, "rotation": 0, "x": 69, "y": 40 },
        { "vehicle": "parkinglotbasic", "chance": 20, "fuel": -1, "rotation": 0, "x": 69, "y": 52 },
        { "vehicle": "parkinglotbasic", "chance": 20, "fuel": 20, "rotation": 0, "x": 69, "y": 58 },
        { "vehicle": "parkinglotbasic", "chance": 20, "fuel": -1, "rotation": 0, "x": 68, "y": 64 },
        { "vehicle": "flatbed_truck", "chance": 20, "fuel": 50, "rotation": 270, "x": 101, "y": 33 }
      ],
      "palettes": [ "lab_surface_palette" ],
      "place_nested": [
        { "chunks": [ "lab_surface_office_5x5" ], "x": 16, "y": 31 },
        { "chunks": [ "lab_surface_office_5x5" ], "x": 16, "y": 37 },
        { "chunks": [ "lab_surface_office_5x5" ], "x": 16, "y": 49 },
        { "chunks": [ "lab_surface_office_5x5" ], "x": 16, "y": 55 },
        { "chunks": [ "lab_surface_office_5x5" ], "x": 16, "y": 61 },
        { "chunks": [ "lab_surface_office_5x5" ], "x": 16, "y": 67 },
        { "chunks": [ "lab_surface_office_5x5" ], "x": 16, "y": 73 },
        { "chunks": [ "lab_surface_office_5x5" ], "x": 16, "y": 79 },
        { "chunks": [ "lab_surface_office_5x5" ], "x": 16, "y": 85 },
        { "chunks": [ "lab_surface_office_5x5" ], "x": 16, "y": 91 },
        { "chunks": [ "lab_surface_office_5x5" ], "x": 16, "y": 97 },
        { "chunks": [ "lab_surface_room_11x11" ], "x": 28, "y": 31 },
        { "chunks": [ "lab_surface_room_11x11" ], "x": 28, "y": 49 },
        { "chunks": [ "lab_surface_cafe_8x8" ], "x": 40, "y": 85 },
        { "chunks": [ "lab_surface_cafe_8x8" ], "x": 72, "y": 85 },
        { "chunks": [ "lab_surface_centerpiece_12x12" ], "x": 55, "y": 83 },
        { "chunks": [ "lab_surface_room_11x11" ], "x": 81, "y": 73 },
        { "chunks": [ "lab_surface_meeting_5x5" ], "x": 99, "y": 73 },
        { "chunks": [ "lab_surface_meeting_5x5" ], "x": 99, "y": 79 },
        { "chunks": [ "lab_surface_meeting_5x5" ], "x": 99, "y": 85 },
        { "chunks": [ "lab_surface_meeting_5x5" ], "x": 99, "y": 91 },
        { "chunks": [ "lab_surface_meeting_5x5" ], "x": 99, "y": 97 },
        { "chunks": [ "lab_utility_room_11x11" ], "x": 81, "y": 37 },
        { "chunks": [ "lab_furnace_room_11x11" ], "x": 81, "y": 49 },
        { "chunks": [ "surface_sub_f_crate" ], "x": [ 81, 85 ], "y": [ 61, 65 ], "repeat": 5 },
        { "chunks": [ "surface_sub_f_crate" ], "x": [ 81, 85 ], "y": [ 67, 71 ], "repeat": 5 },
        { "chunks": [ "surface_sub_f_crate" ], "x": [ 88, 92 ], "y": [ 61, 65 ], "repeat": 5 },
        { "chunks": [ "surface_sub_f_crate" ], "x": [ 88, 92 ], "y": [ 67, 71 ], "repeat": 5 },
        { "chunks": [ "surface_sub_f_crate" ], "x": [ 105, 106 ], "y": [ 49, 69 ], "repeat": 30 }
      ]
    }
  }
]
