[
  {
    "type": "mapgen",
    "method": "json",
    "om_terrain": [ [ "afs_pwr_large_3", "afs_pwr_large_4" ], [ "afs_pwr_large_2", "afs_pwr_large_entrance" ] ],
    "object": {
      "fill_ter": "t_metal_floor",
      "rows": [
        "333333333333333333333333333333333333333333333333",
        "3°°°   °°°3°°°°    °°°°°°°3°  °°3°°°°     °°°°°3",
        "3°   ä   °3°°°°°° °°°°°° °3°°° °3°°ä°° °ä°°°ä°°3",
        "3°°  9  °°3°°°°°   °°°°  °3°°  °3° 9°  °9°  9 °3",
        "3°°°°5  °°3°°°      °°   °3 °   3° 5°°  5° °5 °3",
        "3°°°°â° °°3°°°°           3°°  °3  â8° 8â °8â °3",
        "3°° °9° °°3°°°  °°   °°   3°°°  3°°°6° 6° °6°°°3",
        "3°°  7°  °3°° °°°°  °°°  °3°  °°3°°  °°   °°°°°3",
        "3°°  °   °3°°  °°°  °°°°°°3°° °°3°°°7°  °  7° °3",
        "3°°°      3°° °°    °  °°°3°° °°3°   °°95° °  °3",
        "3  °°° °° 3°°°°        °°°3°°° °3°°   °7°°°   °3",
        "3°  °7°°°°3°       °°°°°  3°°°°°3°°° °°  °°°° °3",
        "3°° °â5°° 3  °°°°°°°°°°   3°°°°°3333333333343333",
        "3°° 68 °° 3   °° °°° °°°  3°°  °°° °°   °°°°°°°3",
        "3°°     °°3      °    °°° 3°°°   °° °°°7°°°° °°3",
        "3    7 °°°3° °°        °°°3°   °°°  °°°° °°°  °3",
        "3      °°°3°°° °°   °°°°°°3°°°°°°°°  °        °3",
        "3     °°°°3°°   °°°°888°°°3°°° °°      °°°°    3",
        "3°    °°7°3°7° °967°888 °73°°7  °°7°   7°°°°   3",
        "3°°°  ° °°3°°  °°°°°888°°°3°°°  °°°  °°°°°°°°°°3",
        "3°°°°°°°°°3°°°°°°   °°°°°°3°°°°°°°°°  °°° °°  °3",
        "3 °°°°°°°°3°° °°      °°° 3°°  ° °°° °    °°° °3",
        "3  °   °7°3°   °°      °° 3 °               ° °3",
        "3 °°°   °°3    °°°    °°  3 °°   °°° °°°  °°°°°3",
        "3 °°°   °°3    °°°° °°°°° 3°°° °3333333333333333",
        "3°°°      3  °°°  ° 888°°°3 °° °3°°° °°°°°  °°°3",
        "3°°   °°7 3°7°°°967 888° 73  7°°3°°795°°     °°3",
        "3°°°   °° 3°°°°° °°°888° °3°°°°°3°°   °° °â59ä°3",
        "3°°    °°°3°°°°     °°°°  3°°  °3°° °°7 °68°  °3",
        "3°°°  °°°°3°°°°°°   °°    3°°  °3°°   °  °    °3",
        "3° °°°°°0°3° °°°°0 °°°° ° 3    °3°    ° °°â59ä°3",
        "3°°°°  °  3°   °°°°°°° °°°3°    3°   °7°°68 ° °3",
        "3 °°      3   °°°  °   °°°3°°°° 3° °°   °°°   °3",
        "3      ° °3  °°         °°3°  °°3°°°°°   °â59ä°3",
        "3 °°°°° °°3 °°°   °°°°   °3°  °°3°°   7° 68° °°3",
        "3  °°°  ° 3°°°°° 0°°°°   °3°°°  3°°  °°° °°   °3",
        "3°°°°° °  3°°°     °°°  °°4° °  3333333333343333",
        "3° °    ° 3°°       °°  °°3      ° °°   °°°°°°°3",
        "3°°°°   °°3°°°    °°°° °0°3°°°      °°0° °°  °°3",
        "3°°°   °°°3°°   °°°°   °°°3°°°°°° ° °°°°°°    °3",
        "3°°     °°3°   °////====////====////°° °°°     3",
        "3°°°°  °°°3°° ///jjjjjjccccccjjjjjj///  °°   °°3",
        "3°°°°  °°°4°°°!.!.........1........!.!  °    °°3",
        "3°      °°3°°°////:/l.1...'....1..//:/  °°°33433",
        "3°°    °°°3°  °°/&*/l..éé222.%kkk./❶❺/°°°°°3°  3",
        "3   °°    3°   °////====////====//////0°°  3  °3",
        "3  °°° °  3°  °°°     °°°°3°°°   °°°   °°° 3° °3",
        "333333333333333333333333333333333333333333333433"
      ],
      "palettes": [
        "afs_habitat_structure",
        "afs_habitat_exterior",
        "afs_habitat_residential_furnishing",
        "afs_habitat_life_support",
        "afs_light_param_palette"
      ],
      "terrain": {
        "0": "t_thconc_floor_no_roof",
        "3": "t_chainfence",
        "4": "t_chaingate_c",
        "5": "t_oil_circ_brkr_l",
        "6": "t_switchgear_l",
        "7": "t_support_l",
        "8": "t_potential_trans",
        "9": "t_station_disc",
        "â": "t_current_trans",
        "ä": "t_lgtn_arrest"
      },
      "furniture": { "0": "f_utility_pole", "1": "f_stool", "2": "f_filing_cabinet", "é": "f_drone_recharge_station" },
      "items": {
        "k": { "item": "SUS_office_desk", "chance": 33 },
        "2": { "item": "SUS_office_filing_cabinet", "chance": 33 },
        "*": { "item": "softdrugs", "chance": 30 }
      },
      "place_loot": [
        { "group": "afs_common_circuitry_scrapgroup", "x": [ 17, 22 ], "y": 41, "chance": 60, "repeat": [ 1, 3 ] },
        { "group": "tools_lighting_industrial", "x": [ 17, 22 ], "y": 41, "chance": 30, "repeat": [ 1, 2 ] },
        { "group": "tools_common", "x": [ 17, 22 ], "y": 41, "chance": 50, "repeat": [ 1, 3 ] },
        { "group": "afs_civilian_hazard_outfit", "x": [ 17, 22 ], "y": 41, "chance": 35 },
        { "group": "afs_common_circuitry_scrapgroup", "x": [ 29, 34 ], "y": 41, "chance": 60, "repeat": [ 1, 3 ] },
        { "group": "tools_lighting_industrial", "x": [ 29, 34 ], "y": 41, "chance": 30, "repeat": [ 1, 2 ] },
        { "group": "tools_common", "x": [ 29, 34 ], "y": 41, "chance": 50, "repeat": [ 1, 3 ] },
        { "group": "afs_civilian_hazard_outfit", "x": [ 29, 34 ], "y": 41, "chance": 35 }
      ],
      "place_monster": [
        { "group": "AFS_GROUP_RUIN_MOXIE", "x": [ 0, 23 ], "y": [ 0, 23 ], "pack_size": [ 1, 2 ], "chance": 40 },
        { "group": "AFS_GROUP_RUIN_MOXIE", "x": [ 24, 47 ], "y": [ 0, 23 ], "pack_size": [ 1, 2 ], "chance": 40 },
        { "group": "AFS_GROUP_RUIN_MOXIE", "x": [ 0, 23 ], "y": [ 24, 47 ], "pack_size": [ 1, 2 ], "chance": 40 },
        { "group": "AFS_GROUP_RUIN_MOXIE", "x": [ 24, 47 ], "y": [ 24, 47 ], "pack_size": [ 1, 2 ], "chance": 40 },
        { "group": "AFS_GROUP_ROBOT_LOW_RISK", "x": [ 17, 23 ], "y": [ 41, 44 ], "pack_size": [ 1, 2 ], "chance": 30 },
        { "group": "AFS_GROUP_ROBOT_LOW_RISK", "x": [ 24, 34 ], "y": [ 41, 44 ], "pack_size": [ 1, 2 ], "chance": 30 }
      ],
      "place_nested": [
        { "chunks": [ { "param": "lightstatus", "fallback": "null" } ], "x": 24, "y": 24 },
        { "chunks": [ { "param": "lightstatus", "fallback": "null" } ], "x": 0, "y": 24 }
      ]
    }
  },
  {
    "type": "mapgen",
    "method": "json",
    "om_terrain": [ [ "afs_pwr_large_2_roof", "afs_pwr_large_entrance_roof" ] ],
    "object": {
      "fill_ter": "t_tar_flat_roof",
      "rows": [
        "                                                ",
        "                                                ",
        "                                                ",
        "                                                ",
        "                                                ",
        "                                                ",
        "                                                ",
        "                                                ",
        "                                                ",
        "                                                ",
        "                                                ",
        "                                                ",
        "                                                ",
        "                                                ",
        "                                                ",
        "                                                ",
        "                [[[[[[[[[[[[[[[[[[[[            ",
        "                [££££££££££££££££££[            ",
        "                [££££££££££££££££££[            ",
        "                [£££££££££2££££1£££[            ",
        "                [£3££££££££££££££££[            ",
        "                [[[[[[[[[[[[[[[[[[[[            ",
        "                                                ",
        "                                                "
      ],
      "palettes": [ "afs_habitat_structure", "afs_habitat_exterior" ],
      "terrain": { " ": "t_open_air" },
      "furniture": { "1": "f_small_satellite_dish", "2": "f_vent_pipe", "3": "f_solar_unit" }
    }
  }
]
