[
  {
    "type": "mapgen",
    "method": "json",
    "om_terrain": [ "afs_pwr_sub_s" ],
    "object": {
      "fill_ter": "t_metal_floor",
      "rows": [
        "                        ",
        "333333333333333333333333",
        "3 ° 7 °° °°°   °°  °° °3",
        "3  ° °°°   °° °°°     °3",
        "3   ä°°    °°° °°°  °° 3",
        "3 7 967° °°°    °°°°   3",
        "3°  °°°°°°°°°  /////////",
        "3°7°â57° °°°°° /j.éé..k/",
        "3°° °°    °°°  =j....1k=",
        "3°7 9á7â57°°   /c.....2=",
        "3    °°°°°°°°  /c1.'.///",
        "3  °°° °°86°°° /c..../*/",
        "3°7 °°   7 °°°°=j....:'/",
        "3   °888  °°°°°=j.%.l/&/",
        "3  ° 888   °°  ////!////",
        "3 7° 888 7°°  °°°°/.:❺❶/",
        "3 °°  °°°86     °°/!////",
        "3°°    °°°°°   °° °    3",
        "3°7°967â57°°°° °° °°  °3",
        "3° °â  °° °°°°  °°°34433",
        "3°  5 °°   °°°   °°3°   ",
        "3°7°967°  °°°   °°°3 °  ",
        "3°° ä°°°°°°°°° °°°°3 °  ",
        "33333333333333333333°   "
      ],
      "palettes": [
        "afs_habitat_structure",
        "afs_habitat_exterior",
        "afs_habitat_residential_furnishing",
        "afs_habitat_life_support",
        "afs_light_param_palette"
      ],
      "terrain": {
        "3": "t_chainfence",
        "4": "t_chaingate_c",
        "5": "t_oil_circ_brkr_l",
        "6": "t_switchgear_l",
        "7": "t_support_l",
        "8": "t_potential_trans",
        "9": "t_station_disc",
        "á": "t_switchgear_s",
        "â": "t_current_trans",
        "ä": "t_lgtn_arrest"
      },
      "furniture": { "1": "f_stool", "2": "f_filing_cabinet", "é": "f_drone_recharge_station" },
      "items": { "2": { "item": "SUS_office_filing_cabinet", "chance": 30, "repeat": [ 1, 2 ] } },
      "place_loot": [
        { "group": "afs_common_circuitry_scrapgroup", "x": 16, "y": [ 7, 8 ], "chance": 40, "repeat": [ 1, 3 ] },
        { "group": "tools_lighting_industrial", "x": 16, "y": [ 7, 8 ], "chance": 30, "repeat": [ 1, 2 ] },
        { "group": "tools_common", "x": 16, "y": [ 7, 8 ], "chance": 40, "repeat": [ 1, 2 ] },
        { "group": "afs_civilian_hazard_outfit", "x": 16, "y": [ 7, 8 ], "chance": 25 },
        { "group": "afs_common_circuitry_scrapgroup", "x": 16, "y": [ 12, 13 ], "chance": 40, "repeat": [ 1, 3 ] },
        { "group": "tools_lighting_industrial", "x": 16, "y": [ 12, 13 ], "chance": 30, "repeat": [ 1, 2 ] },
        { "group": "tools_common", "x": 16, "y": [ 12, 13 ], "chance": 40, "repeat": [ 1, 2 ] },
        { "group": "afs_civilian_hazard_outfit", "x": 16, "y": [ 12, 13 ], "chance": 25 },
        { "item": "stepladder", "x": 20, "y": 17, "chance": 100 }
      ],
      "place_monster": [
        { "group": "AFS_GROUP_RUIN_MOXIE", "x": [ 0, 23 ], "y": [ 0, 23 ], "pack_size": [ 1, 3 ], "chance": 50 },
        { "group": "AFS_GROUP_ROBOT_LOW_RISK", "x": [ 0, 23 ], "y": [ 0, 23 ], "pack_size": [ 1, 2 ], "chance": 30 }
      ],
      "place_nested": [ { "chunks": [ { "param": "lightstatus", "fallback": "null" } ], "x": 0, "y": 0 } ]
    }
  },
  {
    "type": "mapgen",
    "method": "json",
    "om_terrain": "afs_pwr_sub_s_roof",
    "object": {
      "fill_ter": "t_tar_flat_roof",
      "rows": [
        "                        ",
        "                        ",
        "                        ",
        "                        ",
        "                        ",
        "                        ",
        "               [[[[[[[[[",
        "               [£££££££[",
        "               [££22£1£[",
        "               [£££££££[",
        "               [££22£££[",
        "               [£££££££[",
        "               [£4££33£[",
        "               [£££££££[",
        "               [[[[[[[[[",
        "                        ",
        "                        ",
        "                        ",
        "                        ",
        "                        ",
        "                        ",
        "                        ",
        "                        ",
        "                        "
      ],
      "palettes": [ "afs_habitat_structure", "afs_habitat_exterior" ],
      "terrain": { " ": "t_open_air" },
      "furniture": { "1": "f_small_satellite_dish", "2": "f_vent_pipe", "3": "f_solar_unit", "4": "f_standing_tank" }
    }
  }
]
