[
  {
    "type": "mapgen",
    "om_terrain": [ [ "afs_catalytic_react_r1" ], [ "afs_catalytic_react_r2" ] ],
    "object": {
      "fill_ter": "t_metal_floor",
      "rows": [
        "                        ",
        "                        ",
        "                        ",
        "                        ",
        "                        ",
        "           __           ",
        "           __           ",
        "           __           ",
        "           pp           ",
        "           pp           ",
        "         _______ ____   ",
        "         ______  ____   ",
        "         ______  ____   ",
        "         __AA__  ____   ",
        "         _AAAA_  ____   ",
        "         __AA__00_____  ",
        "         ______00_____  ",
        "         ______  _____  ",
        "         ______  _____  ",
        "         _______        ",
        "                        ",
        "                        ",
        "                        ",
        "                        ",
        "                        ",
        "                        ",
        "                        ",
        "                        ",
        "                        ",
        "                        ",
        "                        ",
        "                        ",
        "                        ",
        "                        ",
        "                        ",
        "                        ",
        "                        ",
        "                        ",
        "                        ",
        "                        ",
        "                        ",
        "                        ",
        "                        ",
        "                        ",
        "                        ",
        "                        ",
        "                        ",
        "                        "
      ],
      "palettes": [ "afs_habitat_structure", "afs_habitat_heavy_industry_furnishing" ],
      "terrain": { " ": "t_open_air", "0": "t_bridge", "_": "t_metal_floor" }
    }
  },
  {
    "type": "mapgen",
    "om_terrain": [ [ "afs_catalytic_react_u1" ], [ "afs_catalytic_react_u2" ] ],
    "object": {
      "fill_ter": "t_metal_floor",
      "rows": [
        "                        ",
        "                        ",
        "                        ",
        "                        ",
        "                        ",
        "           --           ",
        "           --           ",
        "        [[[--[[[        ",
        "      [[[..--..[[[      ",
        "      [....--....[      ",
        "      [..-#--#--./==/   ",
        "      [..-    -../.7/   ",
        "      [.p-    -../.7/   ",
        "      [.p-    -p./.7/   ",
        "      [.p-    -p././/   ",
        "      [.p- -- -p./.L//  ",
        "      [.p- -- -p./..7=  ",
        "      [.p-    -p...h7=  ",
        "      [.p-    -p./////  ",
        "      [.p-------./      ",
        "      [.pp..p..../      ",
        "      [..33.p..../      ",
        "      [[.33.22..[/      ",
        "       [....22..[       ",
        "       [>......>[       ",
        "       [>......>[       ",
        "       [[[[[[[[[[       ",
        "         ......         ",
        "         ......         ",
        "                        ",
        "                        ",
        "                        ",
        "                        ",
        "                        ",
        "             .          ",
        "             ..         ",
        "          .. ..         ",
        "          .....         ",
        "          .....         ",
        "          . ...         ",
        "      ..... ...         ",
        "      ..........    ..  ",
        "      ........  ......  ",
        "             ....    .. ",
        "                        ",
        "                        ",
        "                        ",
        "                        "
      ],
      "palettes": [ "afs_habitat_structure", "afs_habitat_heavy_industry_furnishing" ],
      "terrain": { " ": "t_open_air", "ñ": "t_chainfence" },
      "furniture": { "2": "f_future_industy_pump", "3": "f_intermodal_crate_open", "7": "f_command_console_old" },
      "place_nested": [ { "chunks": [ [ "null", 80 ], [ "afs_map_lights_on", 20 ] ], "x": 24, "y": 0 } ]
    }
  },
  {
    "type": "mapgen",
    "om_terrain": [ [ "afs_catalytic_react_m1" ], [ "afs_catalytic_react_m2" ] ],
    "object": {
      "fill_ter": "t_metal_floor",
      "rows": [
        "                        ",
        "                        ",
        "                        ",
        "                        ",
        "      ............      ",
        "      .....//.....      ",
        "      .....// ....      ",
        "   [[[[.////////ppp     ",
        "   [..///..//..///p     ",
        "   [../__..//___./p     ",
        "   [../__-#--#-__/p     ",
        "   [.2/__-____-__/p     ",
        "   [.p/__-    -__/p     ",
        "   [.p/__-    -__/p     ",
        "   [.p/__- .. -__/p     ",
        "   [.p/__- 11 -__/////  ",
        "   [.p/__- 11 -__/..6=  ",
        "   [.p/__- .. -__/.h6=  ",
        "   [.2/__-    -__/.///[ ",
        "   [.2/__------__/...>[ ",
        "   [.p/____//____/....[ ",
        "   [.p/____//____/..[[[ ",
        "   [.p////_//_////..[   ",
        "   [.pppp/_//_/pppp.[   ",
        "   [....</_//_/<....[   ",
        "   [....</_//_/<....[   ",
        "   [..[[[/_//_/[[[..[   ",
        "   [//[  /_//_/  [//[   ",
        "    //   /_//_/   //    ",
        "         p              ",
        "         p              ",
        "                        ",
        "                        ",
        "                        ",
        "             .          ",
        "             ./         ",
        "          /. ./         ",
        "          /././         ",
        "          /././         ",
        "          /././         ",
        "      .////././         ",
        "      ...../..//pp  //  ",
        "      ...////.........  ",
        "             ////    // ",
        "                        ",
        "                        ",
        "                        ",
        "                        "
      ],
      "palettes": [ "afs_habitat_structure", "afs_habitat_heavy_industry_furnishing" ],
      "terrain": { " ": "t_open_air", "ñ": "t_chainfence", "_": "t_metal_toxic_floor" },
      "furniture": { "1": "f_catalytic_core", "2": "f_future_industy_pump", "6": "f_command_console_old" },
      "items": { "_": [ { "item": "afs_machinery_maintenance_scrapgroup", "chance": 1 } ] }
    }
  },
  {
    "type": "mapgen",
    "om_terrain": [ [ "afs_catalytic_react_g1" ], [ "afs_catalytic_react_g2" ] ],
    "object": {
      "fill_ter": "t_metal_floor",
      "rows": [
        ",,,,,,,,,,,,,____,,,,,,,",
        ",,,,,,,,,________,,,,,,,",
        ",,,,,///////___/////,,,,",
        ",,,,/___../._______/,,,,",
        ",,,,/___//////_____/,,,,",
        ",,,,/_/____//____/_/,,,,",
        ",,,,/_/____//____/_/,,,,",
        ",,,,/_/__./////__/_/,,,,",
        ",,,,/_/__________/_/,,,,",
        ",,,p/_/__________/_/,,,,",
        ",,,p/_/__------__/_/,,,,",
        ",,,p/_/__-    -__/_/,,,,",
        ",,,p/_/##-    -##/_/,,,,",
        ",,,p/_/__#    #__/_/,,,,",
        ",ppp/_/__# -- #__/_/,,,,",
        ",,,p/_/__- -- -__/_/,,,,",
        ",,__/_///- -- -///_////,",
        ",,__/_/__- -- -p_/_////,",
        ",,____/__-    -p_/_////,",
        ",________------p___/.<,,",
        ",___/__    //  p __/__,,",
        ",___/__    //ppp __/__,,",
        ",__.///,,//////p,///__,,",
        ",__p.    /..../p    __/,",
        ",__p.    /..../     ___,",
        ",__p.    /..../     _,,,",
        ",__p    pppppppp   ,_,/,",
        ",__p//   /..../   //,,,,",
        ",__p//   //////  .//,__,",
        ",__p._.          ___,__,",
        ",__p._.22    p   _._,__,",
        ",__p.___,2222p2  ______,",
        ",_____._,,,,,p,22_____,,",
        ",___.____,,,,p.,,_____,,",
        ",,,___.//__,,p.____/__,,",
        ",/,,,__//__,pp_____/////",
        ",/,,,,,//,,,p,_._,,/_,,,",
        ",/,,,,,//,,,p,___,,/,,,,",
        ",/,,/////,,/p,,,,,,/,,,,",
        ",//....//,,/p,,..,,/,,,,",
        ",/,,,,,,,..,,/,..,,,,,,,",
        ",,,,,,/,,..../,..,,,,,,,",
        ",,,,,,,,,,,......,,//,,,",
        ",,,,,,,,,,////,,,,,,,,,,",
        ",,,,,,,,,,/../,,,,,,,,,,",
        ",,/////,,,/../,,,,,,,,,,",
        ",,,,,,,,,,////,,,,,,,,,,",
        ",,,,,,,,,,,,,,,,,,,,,,,,"
      ],
      "palettes": [ "afs_habitat_structure", "afs_habitat_heavy_industry_furnishing" ],
      "terrain": { " ": "t_open_air", "2": "t_snowslope_down", "_": "t_metal_toxic_floor", ",": "t_region_groundcover_urban" },
      "furniture": { "&": "f_sealed_intermodal_crate", "e": "f_intermodal_crate_open" },
      "items": { "_": [ { "item": "afs_machinery_maintenance_scrapgroup", "chance": 1 } ] },
      "place_monster": [ { "group": "AFS_GROUP_RUIN_MOXIE", "x": [ 2, 22 ], "y": [ 2, 22 ], "pack_size": [ 1, 2 ], "chance": 50 } ]
    }
  },
  {
    "type": "mapgen",
    "om_terrain": [ [ "afs_catalytic_react_sub1" ], [ "afs_catalytic_react_sub2" ] ],
    "object": {
      "fill_ter": "t_metal_floor",
      "rows": [
        "########################",
        "########################",
        "########################",
        "########################",
        "######////////////######",
        "######/__________/######",
        "######/__________/######",
        "######/__//////__/######",
        "######/__________/######",
        "######/__________/######",
        "######/__------__/######",
        "######/__-____-__/######",
        "######/__-____-__/######",
        "######/__#____#__/######",
        "######/__#_//_#__/######",
        "######/__-_//_-__/######",
        "######/__-_//_-__/######",
        "######/__-_//_-__/######",
        "######/__-____-__/######",
        "######/__------__/######",
        "######/__________/######",
        "##_###/__________/######",
        "##__///////__///////####",
        "##_______/____/______###",
        "#________/____/______###",
        "______________________##",
        "#______________________#",
        "#__#//___/____/__#//___#",
        "####//___//////__#//__##",
        "#######__________####_##",
        "#######RR________#######",
        "#########RRRRRR__#######",
        "###############RR#######",
        "########################",
        "########################",
        "########################",
        "########################",
        "########################",
        "########################",
        "########################",
        "########################",
        "########################",
        "########################",
        "########################",
        "########################",
        "########################",
        "########################",
        "########################"
      ],
      "palettes": [ "afs_habitat_structure" ],
      "terrain": { "_": "t_toxic_water", "#": "t_ice_wall", "R": "t_iceslope_up" },
      "furniture": { "&": "f_sealed_intermodal_crate", "e": "f_intermodal_crate_open" },
      "items": {
        "_": [
          { "item": "afs_machinery_maintenance_scrapgroup", "chance": 7 },
          { "item": "afs_advanced_magnet_scrapgroup", "chance": 2 }
        ]
      }
    }
  }
]
