[
  {
    "type": "mapgen",
    "om_terrain": "inner_cabins",
    "object": {
      "rows": [
        "........................",
        "........................",
        "........................",
        "........................",
        "........................",
        "........................",
        "........................",
        "........................",
        "........................",
        "........................",
        "........................",
        "........................",
        "........................",
        "........................",
        "........................",
        "........................",
        "........................",
        "........................",
        "........................",
        "........................",
        "........................",
        "........................",
        "........................",
        "........................"
      ],
      "terrain": {
        ".": [
          [ "t_grass_tall", 8000 ],
          [ "t_grass_long", 1950 ],
          [ "t_grass", 50 ],
          [ "t_shrub_grape", 1 ],
          [ "t_shrub_peanut", 1 ],
          [ "t_shrub_raspberry", 1 ],
          [ "t_shrub_blueberry", 1 ],
          [ "t_shrub_blackberry", 1 ],
          [ "t_shrub_strawberry", 1 ],
          [ "t_shrub_huckleberry", 1 ],
          [ "t_marloss", 1 ]
        ]
      },
      "furniture": {
        ".": [ [ "f_null", 10000 ], [ "f_black_eyed_susan", 1 ], [ "f_bluebell", 1 ], [ "f_lily", 1 ], [ "f_flower_tulip", 1 ] ]
      }
    }
  },
  {
    "om_terrain": "inner_cabins_cabin",
    "type": "mapgen",
    "object": {
      "fill_ter": "t_floor",
      "rows": [
        "888888888888888888888888",
        "88888~~~8888888888~~8888",
        "8888~~8~~8888888888~~~~8",
        "88888~~~8888888888888888",
        "888888888888888~88888888",
        "8888888888##ww#+#ww##888",
        "8888888888#14&   OOO#888",
        "88~~~~8888wF       Ow888",
        "88888~~~~~w2   cc  Ow888",
        "8888888888#S   tt  A#888",
        "8888888888#35  cc  A#888",
        "8888888888####      w888",
        "8888888880#s +    BBw888",
        "888888888%#T #Y  DBB#888",
        "8888888888#####+#ww##888",
        "88888888888bbb8~88888888",
        "88888888888~~~~~88888888",
        "888888888888888~88888888",
        "888888888888888~88888888",
        "888888888888888~88888888",
        "88888888888888~~88888888",
        "8888888~~~~~~~~888888888",
        "88~~~~~~8888888888888888",
        "~~~888888888888888888888"
      ],
      "palettes": [ "cabin_palette" ],
      "terrain": { "0": "t_region_soil", "b": "t_region_groundcover", "8": "t_grass_tall", "p": "t_water_pump" },
      "furniture": {
        "8": [ [ "f_null", 410 ], [ "f_black_eyed_susan", 1 ], [ "f_bluebell", 1 ], [ "f_lily", 1 ], [ "f_flower_tulip", 1 ] ]
      },
      "items": { "A": { "item": "textbooks", "chance": 100, "repeat": 5 } }
    }
  },
  {
    "type": "mapgen",
    "om_terrain": "inner_cabins_cabin_roof",
    "object": {
      "fill_ter": "t_tar_flat_roof",
      "rows": [
        "                        ",
        "                        ",
        "                        ",
        "                        ",
        "                        ",
        "          -----------   ",
        "          -.........-   ",
        "          -.........-   ",
        "          -.........-   ",
        "          -~........-   ",
        "          -.........-   ",
        "          -.........-   ",
        "          -.........-   ",
        "          5.........-   ",
        "          -----------   ",
        "                        ",
        "                        ",
        "                        ",
        "                        ",
        "                        ",
        "                        ",
        "                        ",
        "                        ",
        "                        "
      ],
      "palettes": [ "roof_palette" ],
      "terrain": { ".": "t_tar_flat_roof" }
    }
  },
  {
    "om_terrain": "inner_cabins_empty_cabin",
    "type": "mapgen",
    "object": {
      "fill_ter": "t_floor",
      "rows": [
        "888888888888888888888888",
        "8~8888888888888888888888",
        "888888888888888888~88888",
        "88888888888888~888888888",
        "888888888888888888888888",
        "8888888888##ww#+#ww##888",
        "8888V88888#14&   OOO#888",
        "8888888888wF       Ow888",
        "8888888888w2   cc  Ow888",
        "8888888888#S   tt  A#888",
        "8888888888#35  cc  A#888",
        "8888888888####      w888",
        "8888~88880#s +    BBw888",
        "888888888%#T #   DBB#888",
        "8888888888#####+#ww##888",
        "88888888888bbb8888888888",
        "8888888888p8888888888888",
        "888888888888888888888888",
        "888888888888888888888888",
        "888888~88888888888888888",
        "88888888888888888888~888",
        "888888888888888888888888",
        "88~888888888888888888888",
        "888888888888888888888888"
      ],
      "palettes": [ "cabin_palette_abandoned" ],
      "terrain": { "0": "t_region_soil", "b": "t_region_groundcover", "8": "t_grass_tall", "V": "t_grass_tall", "p": "t_water_pump" },
      "furniture": {
        "8": [ [ "f_null", 410 ], [ "f_black_eyed_susan", 1 ], [ "f_bluebell", 1 ], [ "f_lily", 1 ], [ "f_flower_tulip", 1 ] ]
      },
      "vehicles": { "V": { "vehicle": "bicycle_dirt", "chance": 100, "rotation": 90, "status": -1 } }
    }
  },
  {
    "type": "mapgen",
    "om_terrain": "inner_cabins_empty_cabin_roof",
    "object": {
      "fill_ter": "t_tar_flat_roof",
      "rows": [
        "                        ",
        "                        ",
        "                        ",
        "                        ",
        "                        ",
        "          -----------   ",
        "          -.........-   ",
        "          -.........-   ",
        "          -.........-   ",
        "          -~........-   ",
        "          -.........-   ",
        "          -.........-   ",
        "          -.........-   ",
        "          5.........-   ",
        "          -----------   ",
        "                        ",
        "                        ",
        "                        ",
        "                        ",
        "                        ",
        "                        ",
        "                        ",
        "                        ",
        "                        "
      ],
      "palettes": [ "roof_palette" ],
      "terrain": { ".": "t_tar_flat_roof" }
    }
  },
  {
    "om_terrain": [
      [ "inner_cabins_warped_cabin_1" ],
      [ "inner_cabins_warped_cabin_2" ],
      [ "inner_cabins_warped_cabin_3" ],
      [ "inner_cabins_warped_cabin_4" ],
      [ "inner_cabins_warped_cabin_5" ],
      [ "inner_cabins_warped_cabin_6" ],
      [ "inner_cabins_warped_cabin_7" ],
      [ "inner_cabins_warped_cabin_8" ],
      [ "inner_cabins_warped_cabin_9" ],
      [ "inner_cabins_warped_cabin_10" ]
    ],
    "type": "mapgen",
    "object": {
      "fill_ter": "t_floor",
      "rows": [
        "~~~~~~~~~~~~~~~~~~~~~~~~",
        "~~~~8888888888888888~~~~",
        "~~~8888888~~~88888888~~~",
        "~8~~88888~~8~~888888888~",
        "~88~~8~8~~888~~88888888~",
        "~888~~~~~88888~~8888888~",
        "~8888~8~8888888~~888888~",
        "~8888888888888~~8888888~",
        "~88888888888888~~888888~",
        "~88888888888888~8888888~",
        "~888888888##ww#+#ww##88~",
        "~888888888##ww#+#ww##88~",
        "~888888888##ww#+#ww##88~",
        "~888888888##ww#+#ww##88~",
        "~888888888##ww#+#ww##88~",
        "~888888888#14&   OOO#88~",
        "~888888888##ww#+#ww##88~",
        "~888888888#14&   OOO#88~",
        "~888888888##ww#+#ww##88~",
        "~888888888#14&   OOO#88~",
        "~888888888##ww#+#ww##88~",
        "~888888888#14&   OOO#88~",
        "~888888888##ww#+#ww##88~",
        "~888888888#14&   OOO#88~",
        "~888888888wF       Ow88~",
        "~888888888##ww#+#ww##88~",
        "~888888888#14&   OOO#88~",
        "~888888888wF       Ow88~",
        "~888888888##ww#+#ww##88~",
        "~888888888#14&   OOO#88~",
        "~888888888wF       Ow88~",
        "~888888888##ww#+#ww##88~",
        "~888888888#14&   OOO#88~",
        "~888888888wF       Ow88~",
        "~888888888##ww#+#ww##88~",
        "~888888888#14&   OOO#88~",
        "~888888888wF       Ow88~",
        "~8888~~~~~w2   cc  Ow88~",
        "~888888888##ww#+#ww##88~",
        "~888888888#14&   OOO#88~",
        "~888888888wF       Ow88~",
        "~8888~~~~~w2   cc  Ow88~",
        "~888888888##ww#+#ww##88~",
        "~888888888#14&   OOO#88~",
        "~888888888wF       Ow88~",
        "~8888~~~~~w2   cc  Ow88~",
        "~888888888##ww#+#ww##88~",
        "~888888888#14&   OOO#88~",
        "~888888888wF       Ow88~",
        "~8888~~~~~w2   cc  Ow88~",
        "~888888888##ww#+#ww##88~",
        "~888888888#14&   OOO#88~",
        "~888888888wF       Ow88~",
        "~8888~~~~~w2   cc  Ow88~",
        "~888888888#S   tt  A#88~",
        "~888888888##ww#+#ww##88~",
        "~888888888#14&   OOO#88~",
        "~888888888wF       Ow88~",
        "~8888~~~~~w2   cc  Ow88~",
        "~888888888#S   tt  A#88~",
        "~888888888##ww#+#ww##88~",
        "~888888888#14&   OOO#88~",
        "~888888888wF       Ow88~",
        "~8888~~~~~w2   cc  Ow88~",
        "~888888888#S   tt  A#88~",
        "~888888888##ww#+#ww##88~",
        "~888888888#14&   OOO#88~",
        "~888888888wF       Ow88~",
        "~8888~~~~~w2   cc  Ow88~",
        "~888888888#S   tt  A#88~",
        "~888888888##ww#+#ww##88~",
        "~888888888#14&   OOO#88~",
        "~888888888wF       Ow88~",
        "~8888~~~~~w2   cc  Ow88~",
        "~888888888#S   tt  A#88~",
        "~888888888#35  cc  A#88~",
        "~888888888##ww#+#ww##88~",
        "~888888888#14&   OOO#88~",
        "~888888888wF       Ow88~",
        "~8888~~~~~w2   cc  Ow88~",
        "~888888888#S   tt  A#88~",
        "~888888888#35  cc  A#88~",
        "~888888888##ww#+#ww##88~",
        "~888888888#14&   OOO#88~",
        "~888888888wF       Ow88~",
        "~8888~~~~~w2   cc  Ow88~",
        "~888888888#S   tt  A#88~",
        "~888888888#35  cc  A#88~",
        "~888888888##ww#+#ww##88~",
        "~888888888#14&   OOO#88~",
        "~888888888wF       Ow88~",
        "~8888~~~~~w2   cc  Ow88~",
        "~888888888#S   tt  A#88~",
        "~888888888#35  cc  A#88~",
        "~888888888##ww#+#ww##88~",
        "~888888888#14&   OOO#88~",
        "~888888888wF       Ow88~",
        "~8888~~~~~w2   cc  Ow88~",
        "~888888888#S   tt  A#88~",
        "~888888888#35  cc  A#88~",
        "~888888888####      w88~",
        "~888888888##ww#+#ww##88~",
        "~888888888#14&   OOO#88~",
        "~888888888wF       Ow88~",
        "~8888~~~~~w2   cc  Ow88~",
        "~888888888#S   tt  A#88~",
        "~888888888#35  cc  A#88~",
        "~888888888####      w88~",
        "~888888888##ww#+#ww##88~",
        "~888888888#14&   OOO#88~",
        "~888888888wF       Ow88~",
        "~8888~~~~~w2   cc  Ow88~",
        "~888888888#S   tt  A#88~",
        "~888888888#35  cc  A#88~",
        "~888888888####      w88~",
        "~888888888##ww#+#ww##88~",
        "~888888888#14&   OOO#88~",
        "~888888888wF       Ow88~",
        "~8888~~~~~w2   cc  Ow88~",
        "~888888888#S   tt  A#88~",
        "~888888888#35  cc  A#88~",
        "~888888888####      w88~",
        "~888888888##ww#+#ww##88~",
        "~888888888#14&   OOO#88~",
        "~888888888wF       Ow88~",
        "~8888~~~~~w2   cc  Ow88~",
        "~888888888#S   tt  A#88~",
        "~888888888#35  cc  A#88~",
        "~888888888####      w88~",
        "~888888880#s +    BBw88~",
        "~888888888##ww#+#ww##88~",
        "~888888888#14&   OOO#88~",
        "~888888888wF       Ow88~",
        "~8888~~~~~w2   cc  Ow88~",
        "~888888888#S   tt  A#88~",
        "~888888888#35  cc  A#88~",
        "~888888888####      w88~",
        "~888888880#s +    BBw88~",
        "~888888888##ww#+#ww##88~",
        "~888888888#14&   OOO#88~",
        "~888888888wF       Ow88~",
        "~8888~~~~~w2   cc  Ow88~",
        "~888888888#S   tt  A#88~",
        "~888888888#35  cc  A#88~",
        "~888888888####      w88~",
        "~888888880#s +    BBw88~",
        "~888888888##ww#+#ww##88~",
        "~888888888#14&   OOO#88~",
        "~888888888wF       Ow88~",
        "~8888~~~~~w2   cc  Ow88~",
        "~888888888#S   tt  A#88~",
        "~888888888#35  cc  A#88~",
        "~888888888####      w88~",
        "~888888880#s +    BBw88~",
        "~888888888##ww#+#ww##88~",
        "~888888888#14&   OOO#88~",
        "~888888888wF       Ow88~",
        "~8888~~~~~w2   cc  Ow88~",
        "~888888888#S   tt  A#88~",
        "~888888888#35  cc  A#88~",
        "~888888888####      w88~",
        "~888888880#s +    BBw88~",
        "~88888888%#T #Y  DBB#88~",
        "~888888888##ww#+#ww##88~",
        "~888888888#14&   OOO#88~",
        "~888888888wF       Ow88~",
        "~8888~~~~~w2   cc  Ow88~",
        "~888888888#S   tt  A#88~",
        "~888888888#35  cc  A#88~",
        "~888888888####      w88~",
        "~888888880#s +    BBw88~",
        "~88888888%#T #Y  DBB#88~",
        "~888888888##ww#+#ww##88~",
        "~888888888#14&   OOO#88~",
        "~888888888wF       Ow88~",
        "~8888~~~~~w2   cc  Ow88~",
        "~888888888#S   tt  A#88~",
        "~888888888#35  cc  A#88~",
        "~888888888####      w88~",
        "~888888880#s +    BBw88~",
        "~88888888%#T #Y  DBB#88~",
        "~888888888##ww#+#ww##88~",
        "~888888888#14&   OOO#88~",
        "~888888888wF       Ow88~",
        "~8888~~~~~w2   cc  Ow88~",
        "~888888888#S   tt  A#88~",
        "~888888888#35  cc  A#88~",
        "~888888888####      w88~",
        "~888888880#s +    BBw88~",
        "~88888888%#T #Y  DBB#88~",
        "~888888888##ww#+#ww##88~",
        "~888888888#14&   OOO#88~",
        "~888888888wF       Ow88~",
        "~8888~~~~~w2   cc  Ow88~",
        "~888888888#S   tt  A#88~",
        "~888888888#35  cc  A#88~",
        "~888888888####      w88~",
        "~888888880#s +    BBw88~",
        "~88888888%#T #Y  DBB#88~",
        "~888888888#####+#ww##88~",
        "~888888888##ww#+#ww##88~",
        "~888888888#14&   OOO#88~",
        "~888888888wF       Ow88~",
        "~8888~~~~~w2   cc  Ow88~",
        "~888888888#S   tt  A#88~",
        "~888888888#35  cc  A#88~",
        "~888888888####      w88~",
        "~888888880#s +    BBw88~",
        "~88888888%#T #Y  DBB#88~",
        "~888888888#####+#ww##88~",
        "~888888888##ww#+#ww##88~",
        "~888888888#14&   OOO#88~",
        "~888888888wF       Ow88~",
        "~8888~~~~~w2   cc  Ow88~",
        "~888888888#S   tt  A#88~",
        "~888888888#35  cc  A#88~",
        "~888888888####      w88~",
        "~888888880#s +    BBw88~",
        "~88888888%#T #Y  DBB#88~",
        "~888888888#####+#ww##88~",
        "~888888888#####+#####88~",
        "~888888888#         #88~",
        "~888888888#         #88~",
        "~888888888#         #88~",
        "~888888888#         #88~",
        "~888888888#         #88~",
        "~888888888####      #88~",
        "~888888880#  +      #88~",
        "~88888888%#  #Y     #88~",
        "~888888888#####!#####88~",
        "~8888888888888888888888~",
        "~8888888888888888888888~",
        "~8888888888888888888888~",
        "~8888888888888888888888~",
        "~8888888888888888888888~",
        "~8888888888888888888888~",
        "~8888888888888888888888~",
        "~~88888888888888888888~~",
        "~~~888888888888888888~~~",
        "~~~~~~~~~~~~~~~~~~~~~~~~"
      ],
      "palettes": [ "cabin_palette" ],
      "terrain": {
        "0": "t_region_soil",
        "b": "t_region_groundcover",
        "8": [ [ "t_inner_cabins_void", 99 ], [ "t_grass_tall", 1 ] ],
        "!": "t_inner_cabins_door_o"
      },
      "traps": { "!": "tr_inner_cabins_door_o" },
      "place_nested": [
        {
          "chunks": [ [ "null", 50 ], [ "inner_cabins_tindalos_tear", 49 ], [ "inner_cabins_yrax_research", 1 ] ],
          "x": 11,
          "y": 221
        }
      ]
    }
  },
  {
    "type": "mapgen",
    "nested_mapgen_id": "inner_cabins_tindalos_tear",
    "object": {
      "mapgensize": [ 8, 8 ],
      "flags": [ "ALLOW_TERRAIN_UNDER_OTHER_DATA" ],
      "place_traps": [ { "trap": "tr_portal", "x": 3, "y": 3 } ],
      "place_monster": [ { "group": "GROUP_TINDALOS", "x": 4, "y": 4, "chance": 100 } ]
    }
  },
  {
    "type": "mapgen",
    "nested_mapgen_id": "inner_cabins_yrax_research",
    "object": {
      "mapgensize": [ 8, 8 ],
      "flags": [ "ALLOW_TERRAIN_UNDER_OTHER_DATA" ],
      "place_monster": [ { "monster": "mon_golden_monolith", "x": [ 0, 7 ], "y": [ 0, 7 ], "repeat": [ 1, 4 ] } ]
    }
  }
]
