[
  {
    "type": "mapgen",
    "method": "json",
    "om_terrain": [
      [
        "phavian_hospital_main_floor_z3_nw_upper",
        "phavian_hospital_main_floor_z3_ncw_upper",
        "phavian_hospital_main_floor_z3_nce_upper",
        "phavian_hospital_main_floor_z3_ne_upper"
      ],
      [
        "phavian_hospital_main_floor_z3_sw_upper",
        "phavian_hospital_main_floor_z3_scw_upper",
        "phavian_hospital_main_floor_z3_sce_upper",
        "phavian_hospital_main_floor_z3_se_upper"
      ]
    ],
    "weight": 250,
    "object": {
      "fill_ter": "t_linoleum_white",
      "rows": [
        "################################################################################################",
        "#                                                                                              #",
        "#                                                                                              #",
        "#                                                                                              #",
        "#                                |||||                                                         #",
        "#                                |---|                                                         #",
        "#                                |---|                                                         #",
        "#                                |&$$|                                                         #",
        "#                                                                                              #",
        "#                                                                                              #",
        "#                                                                                              #",
        "#                                                                                              #",
        "#                                                                                              #",
        "#                                                                                              #",
        "#                                                                                              #",
        "#                                                                                              #",
        "#                                                                                              #",
        "#                                                                                              #",
        "#                                                                                              #",
        "#                                                                                              #",
        "#                                                                                              #",
        "#                                                                                              #",
        "#                                                                                              #",
        "#                                                                                              #↓↓↓↓↓↓↓↓↓",
        "#                                                                                              #↑↑↑↑↑↑↑↑↑",
        "#                                                                                              #",
        "#                                                                                              #",
        "#                                                                                              #",
        "#                                                                                              #",
        "#                                                                                              #",
        "#                                                                                              #",
        "#                                                                                              #",
        "#                                                                                              #",
        "#                                                                                             <#",
        "#                                                                                              #",
        "#                                                                                              #",
        "#                                                                                              #",
        "#                                                                                              #",
        "#                                                                                              #",
        "#                                                                                              #",
        "#                                                                                              #",
        "#                                                                                              #",
        "#                                                                                              #",
        "#                                                                                              #",
        "#                                                                                              #",
        "#                                                                                              #",
        "#                                                                                              #",
        "################################################################################################"
      ],
      "palettes": [ "phavian_hospital_lab" ],
      "terrain": {
        "Ŧ": "t_linoleum_white",
        "£": "t_linoleum_whitefloor_olight",
        ".": "t_soil",
        "°": "t_wall_metal",
        ";": [ "t_door_metal_locked", "t_door_metal_elocked" ],
        "˽": "t_card_science",
        "-": "t_metal_floor"
      },
      "furniture": { "¢": "f_counter", "`": "f_dishwasher", "³": "f_rack" },
      "items": {
        "¢": { "item": "office_paper", "chance": 60, "repeat": [ 1, 2 ] },
        "p": [
          { "item": "restaur_fridge", "chance": 70, "repeat": [ 1, 2 ] },
          { "item": "baked_goods", "chance": 40 },
          { "item": "fridge", "chance": 90, "repeat": [ 1, 2 ] }
        ],
        "³": [
          { "item": "restaur_kitchen", "chance": 20, "repeat": [ 1, 2 ] },
          { "item": "groce_bread", "chance": 30, "repeat": [ 1, 2 ] },
          { "item": "pantry", "chance": 60, "repeat": [ 1, 2 ] },
          { "item": "cannedfood", "chance": 60, "repeat": [ 1, 2 ] },
          { "item": "groce_condiment", "chance": 20, "repeat": [ 1, 2 ] }
        ],
        "t": { "item": "laundry", "chance": 20, "repeat": [ 1, 2 ] },
        "J": { "item": "kitchen_appliances", "chance": 20, "repeat": [ 1, 2 ] },
        "u": { "item": "dissection", "chance": 40 },
        "N": { "item": "hospital_lab", "chance": 40 },
        "d": { "item": "dissection", "chance": 30 },
        "M": { "item": "oven", "chance": 90, "repeat": [ 1, 2 ] },
        "z": { "item": "SUS_trash_trashcan", "chance": 80, "repeat": [ 1, 2 ] },
        "C": { "item": "office_paper", "chance": 60, "repeat": [ 1, 2 ] },
        "V": { "item": "waitingroom", "chance": 40, "repeat": [ 1, 2 ] },
        "v": { "item": "office", "chance": 40, "repeat": [ 1, 2 ] },
        "X": [
          { "item": "harddrugs", "chance": 70, "repeat": [ 1, 2 ] },
          { "item": "drugs_rare", "chance": 70, "repeat": [ 1, 2 ] }
        ],
        "D": { "item": "softdrugs", "chance": 90, "repeat": [ 1, 2 ] },
        "O": { "item": "virology_lab_fridge", "chance": 80, "repeat": [ 1, 2 ] },
        "Q": { "item": "hospital_medical_items", "chance": 80, "repeat": [ 1, 2 ] },
        "B": [ { "item": "jackets", "chance": 30 }, { "item": "bags", "chance": 40 } ],
        "P": { "item": "hospital_medical_items", "chance": 80, "repeat": [ 1, 2 ] },
        "F": [ { "item": "bed", "chance": 30, "repeat": [ 1, 2 ] }, { "item": "cleaning", "chance": 60, "repeat": [ 1, 2 ] } ],
        "q": [
          { "item": "vending_drink", "chance": 40, "repeat": [ 1, 2 ] },
          { "item": "prepared_teas", "chance": 30, "repeat": [ 1, 2 ] }
        ]
      }
    }
  }
]
