[
  {
    "type": "mapgen",
    "method": "json",
    "om_terrain": [ "phavian_hospital_transition_tunnel" ],
    "object": {
      "fill_ter": "t_linoleum_white",
      "rows": [
        "........................",
        "........................",
        "........................",
        "........................",
        "........................",
        "........................",
        "........................",
        "........................",
        "........................",
        "........................",
        "........................",
        "........................",
        "........................",
        "........................",
        "........................",
        "........................",
        "........................",
        "........................",
        "........................",
        "........................",
        "....................###.",
        "....................#<#.",
        "....................#>#.",
        "....................###."
      ],
      "palettes": [ "phavian_hospital_lab" ],
      "terrain": { ".": "t_rock" }
    }
  }
]
