[
  {
    "type": "mapgen",
    "method": "json",
    "om_terrain": "unvitrified_farm_0",
    "object": {
      "fill_ter": "t_floor",
      "rows": [
        "£££££££££££çç£££££££££££",
        "£µ..p````````.µ.µ.µ.µ.µ.",
        "£...```ù%%%%%%%ù%%..µ.µ.",
        "£µ.`#*o#o#o#o#o#o##.....",
        "£..`#,,{    }     #.µ.µ.",
        "£µ.`#,,           #.....",
        "£..`#             o.µ.µ.",
        "£µ.`#             o.....",
        "£..`#             #.µ.µ.",
        "£..`#<>           #.....",
        "£..`####||+|      #.µ.µ.",
        "£..`..^#t,,|7,,1,,o...``",
        "£..`...#88S|7,,,,,*`````",
        "£.µ`µ..#o###F,,,,1#`....",
        "£..````````#2,35O4#`µ...",
        "£.µ.µ.µ.µ.`###oo###`....",
        "£.]......µ``````````µ...",
        "£.......µ.`µ0µ.µ[.......",
        "£........µ`000µ.........",
        "£...µ...µ.`000.µ...µ....",
        "£........µ`000µ.........",
        "£.......µ..µ0µ..........",
        "£........µ..µ..µ........",
        "££££££££££££££££££££££££"
      ],
      "palettes": [ "domestic_general_and_variant_palette", "parametrized_linoleum_palette", "standard_domestic_landscaping_palette" ],
      "terrain": {
        ".": "t_region_groundcover_urban",
        ",": "t_linoleum_white",
        "[": "t_region_groundcover_urban",
        "]": "t_region_groundcover_urban",
        "!": "t_fence",
        "ù": "t_column",
        "@": "t_fencegate_c",
        "£": "t_quietfarm_border_fence",
        "5": { "param": "linoleum_color", "fallback": "t_linoleum_white" },
        "6": { "param": "linoleum_color", "fallback": "t_linoleum_white" },
        "7": { "param": "linoleum_color", "fallback": "t_linoleum_white" },
        "8": { "param": "linoleum_color", "fallback": "t_linoleum_white" },
        "µ": [
          [ "t_region_groundcover_urban", 60 ],
          "t_region_tree_shade",
          [ "t_region_tree_fruit", 2 ],
          [ "t_region_tree_nut", 2 ]
        ],
        "0": "t_water_pool_shallow_outdoors",
        "c": { "param": "linoleum_color", "fallback": "t_linoleum_white" },
        "i": { "param": "linoleum_color", "fallback": "t_linoleum_white" },
        "j": { "param": "linoleum_color", "fallback": "t_linoleum_white" },
        "l": { "param": "linoleum_color", "fallback": "t_linoleum_white" },
        "t": { "param": "linoleum_color", "fallback": "t_linoleum_white" },
        "ç": "t_quietfarm_border_fence_closed"
      },
      "nested": {
        "{": { "chunks": [ "livingroom_5x5_W_1" ] },
        "}": { "chunks": [ "diningroom_6x6_N_S_1B" ] },
        "[": { "chunks": [ "firepit_5x5_1" ] },
        "]": { "chunks": [ "greenhouse_6x6_herbal" ] }
      }
    }
  },
  {
    "type": "mapgen",
    "method": "json",
    "om_terrain": "unvitrified_farm_1",
    "object": {
      "fill_ter": "t_floor",
      "rows": [
        "------------------------",
        "------------------------",
        "----##oo##o#o##oo##-----",
        "----#{   |HRH|}   #-----",
        "----o    |___|    o-----",
        "----o    |___|    o-----",
        "----#    +___+    #-----",
        "----#|||||__||||||#-----",
        "----#_______+[    #-----",
        "----#>R|||+||     o-----",
        "----####BB 8|     o-----",
        "------^#   S|     #-----",
        "-------£w t8#¶#oo##-----",
        "-------##o###~~~~~£-----",
        "-----------£~~~~~~£-----",
        "-----------££££££££-----",
        "------------------------",
        "------------------------",
        "------------------------",
        "------------------------",
        "------------------------",
        "------------------------",
        "------------------------",
        "------------------------"
      ],
      "palettes": [ "domestic_general_and_variant_palette" ],
      "terrain": {
        "-": "t_open_air",
        "~": "t_thconc_floor",
        ",": "t_linoleum_white",
        "_": "t_floor",
        "H": "t_floor",
        "£": "t_screened_porch_wall",
        "R": "t_floor"
      },
      "nested": {
        "{": { "chunks": [ "bedroom_4x4_adult_2_S" ] },
        "}": { "chunks": [ "home_office_4x4_N" ] },
        "[": { "chunks": [ "bedroom_5x4_adult_unvitrified" ] }
      }
    }
  },
  {
    "type": "mapgen",
    "method": "json",
    "om_terrain": "unvitrified_farm_neg_1",
    "//": "Unfinished basement",
    "object": {
      "fill_ter": "t_thconc_floor",
      "rows": [
        "^^^^^^^^^^^^^^^^^^^^^^^^",
        "^^^^^^^^^^^^^^^^^^^^^^^^",
        "^^^^###############^^^^^",
        "^^^^#.............#^^^^^",
        "^^^^#.............#^^^^^",
        "^^^^#.............#^^^^^",
        "^^^^#.............#^^^^^",
        "^^^^#Z......!!!...#^^^^^",
        "^^^^#W............#^^^^^",
        "^^^^#!<|...|NNUUUU#^^^^^",
        "^^^^###############^^^^^",
        "^^^^^^^^^^^^^^^^^^^^^^^^",
        "^^^^^^^^^^^^^^^^^^^^^^^^",
        "^^^^^^^^^^^^^^^^^^^^^^^^",
        "^^^^^^^^^^^^^^^^^^^^^^^^",
        "^^^^^^^^^^^^^^^^^^^^^^^^",
        "^^^^^^^^^^^^^^^^^^^^^^^^",
        "^^^^^^^^^^^^^^^^^^^^^^^^",
        "^^^^^^^^^^^^^^^^^^^^^^^^",
        "^^^^^^^^^^^^^^^^^^^^^^^^",
        "^^^^^^^^^^^^^^^^^^^^^^^^",
        "^^^^^^^^^^^^^^^^^^^^^^^^",
        "^^^^^^^^^^^^^^^^^^^^^^^^",
        "^^^^^^^^^^^^^^^^^^^^^^^^"
      ],
      "palettes": [ "standard_domestic_palette", "standard_domestic_basement_palette" ],
      "furniture": { "!": "f_table" },
      "place_nested": [
        { "chunks": [ "utility_3x3_S" ], "x": 8, "y": 7 },
        { "chunks": [ "basement_storage_1x1" ], "x": [ 5, 17 ], "y": [ 3, 6 ], "repeat": [ 4, 16 ] }
      ]
    }
  },
  {
    "type": "mapgen",
    "method": "json",
    "om_terrain": "unvitrified_farm_2",
    "object": {
      "fill_ter": "t_shingle_flat_roof",
      "rows": [
        "                        ",
        "                        ",
        "    ---------------     ",
        "    -.............-     ",
        "    -.............-     ",
        "    -.............-     ",
        "    -.............-     ",
        "    -.............-     ",
        "    -.............-     ",
        "    -.............-     ",
        "    ---5..........-     ",
        "       -..........-     ",
        "       -..........-     ",
        "       -----......-     ",
        "           -......-     ",
        "           --------     ",
        "                        ",
        "                        ",
        "                        ",
        "                        ",
        "                        ",
        "                        ",
        "                        ",
        "                        "
      ],
      "palettes": [ "roof_palette" ],
      "terrain": { ".": "t_shingle_flat_roof" }
    }
  },
  {
    "type": "mapgen",
    "method": "json",
    "om_terrain": [ "unvitrified_orchard" ],
    "object": {
      "set": [ { "point": "variable", "id": "unvitrified_orchard_center", "x": 12, "y": 12 } ],
      "fill_ter": "t_dirt",
      "rows": [
        "111111111111111111111111",
        "!**********************1",
        "!*    *    **    *    *1",
        "!* 7  7  7 ** 7  7  7 *1",
        "!*         **         *1",
        "!*         **         *1",
        "!**7     7****7     7**1",
        "!*         **         *1",
        "!*         **         *1",
        "!* 7  7  7 ** 7  7  7 *1",
        "!*    *    **    *    *1",
        "@**********************1",
        "@**********************1",
        "!*    *    **    *    *1",
        "!* 7  7  7 ** 7  7  7 *1",
        "!*         **         *1",
        "!*         **         *1",
        "!**7     7****7     7**1",
        "!*         **         *1",
        "!*         **         *1",
        "!* 7  7  7 ** 7  7  7 *1",
        "!*    *    **    *    *1",
        "!**********************1",
        "111111111111111111111111"
      ],
      "palettes": [ "orchard_tree_apple" ],
      "terrain": { "1": "t_quietfarm_border_fence", "!": "t_fence", "@": "t_fencegate_c" }
    }
  },
  {
    "type": "mapgen",
    "method": "json",
    "nested_mapgen_id": "bedroom_4x4_child_vit",
    "object": {
      "mapgensize": [ 4, 4 ],
      "rotation": [ 0, 3 ],
      "rows": [
        "¤@@¤",
        " @@ ",
        "y   ",
        "D   "
      ],
      "palettes": [ "domestic_general_and_variant_palette" ]
    }
  },
  {
    "type": "mapgen",
    "method": "json",
    "nested_mapgen_id": "bedroom_5x4_adult_unvitrified",
    "object": {
      "mapgensize": [ 5, 5 ],
      "rotation": [ 0, 3 ],
      "rows": [
        "D   ¤",
        "D  @@",
        "h  @@",
        "    ¤",
        "     "
      ],
      "palettes": [ "domestic_general_and_variant_palette" ]
    }
  }
]
