[
  {
    "type": "mapgen",
    "method": "json",
    "om_terrain": [ "central_lab_entrance" ],
    "weight": 100,
    "object": {
      "fill_ter": "t_dirt",
      "rows": [
        "                        ",
        "                        ",
        "                        ",
        "                        ",
        "                        ",
        "                        ",
        "                        ",
        "                        ",
        "                        ",
        "                        ",
        "                        ",
        "                        ",
        "                        ",
        "                        ",
        "                        ",
        "                        ",
        "                        ",
        "                        ",
        "                        ",
        "                        ",
        "                        ",
        "                        ",
        "                        ",
        "                        "
      ],
      "terrain": {
        " ": [ "t_dirt", "t_dirt", "t_dirt", "t_grass", "t_grass", "t_grass", "t_shrub", "t_tree_young", "t_tree_young", "t_tree", "t_tree" ]
      }
    }
  },
  {
    "type": "mapgen",
    "method": "json",
    "om_terrain": [ "central_lab_shaft" ],
    "weight": 100,
    "object": {
      "fill_ter": "t_rock_floor",
      "rows": [
        "          |..|         |",
        "          |..|         |",
        "          |..|         |",
        "          |..|         |",
        "          |..|         |",
        "          +..|         |",
        "          |..|         |",
        "          |..|         |",
        "          |..|         |",
        "          |..|         |",
        "----------|..|----+----|",
        ".......................+",
        ".......................+",
        "-----+----|..|---------|",
        "          |..|         |",
        "          |..|         |",
        "          |..|         |",
        "          |..|         |",
        "          |..+         |",
        "          |..|         |",
        "          |..|         |",
        "          |..|         |",
        "          |..|         |",
        "-----------++----------|"
      ],
      "palettes": [
        "lab_palette"
      ],
      "place_nested": [
        { "chunks": [ "lab_spawn_9x9" ], "x": [0, 1], "y": [0, 1] },
        { "chunks": [ "lab_spawn_9x9" ], "x": 14, "y": [0,1] },
        { "chunks": [ "lab_spawn_9x9" ], "x": [0,1], "y": 14 },
        { "chunks": [ "lab_spawn_9x9_crossdoors" ], "x": 14, "y": 14 },
        { "chunks": [ "lab_border_walls" ], "x": 0, "y": 0 }
      ]
    }
  },
  {
    "type": "mapgen",
    "method": "json",
    "om_terrain": [ "central_lab_terminal" ],
    "weight": 100,
    "object": {
      "fill_ter": "t_rock_floor",
      "rows": [
        "          |..|         |",
        "          |..|         |",
        "          |..|         |",
        "          |..|         |",
        "          |..|         |",
        "          +..|         |",
        "          |..|         |",
        "          |..|         |",
        "          |..|         |",
        "          |..|         |",
        "----------|..|----+----|",
        ".......................+",
        ".......................+",
        "-----+----|..|---------|",
        "          |..|         |",
        "          |..|         |",
        "          |..|         |",
        "          |..|         |",
        "          |..+         |",
        "          |..|         |",
        "          |..|         |",
        "          |..|         |",
        "          |..|         |",
        "-----------++----------|"
      ],
      "palettes": [
        "lab_palette"
      ],
      "place_nested": [
        { "chunks": [ "lab_spawn_9x9" ], "x": [0, 1], "y": [0, 1] },
        { "chunks": [ "lab_spawn_9x9" ], "x": 14, "y": [0,1] },
        { "chunks": [ "lab_spawn_9x9" ], "x": [0,1], "y": 14 },
        { "chunks": [ "lab_spawn_9x9_crossdoors" ], "x": 14, "y": 14 },
        { "chunks": [ "lab_border_walls" ], "x": 0, "y": 0 }
      ]
    }
  },
  {
    "type": "mapgen",
    "method": "json",
    "om_terrain": [ "central_lab_base" ],
    "weight": 100,
    "object": {
      "fill_ter": "t_rock_floor",
      "rows": [
        "          |..|         |",
        "          |..|         |",
        "          |..|         |",
        "          |..|         |",
        "          |..|         |",
        "          +..|         |",
        "          |..|         |",
        "          |..|         |",
        "          |..|         |",
        "          |..|         |",
        "----------|..|----+----|",
        ".......................+",
        ".......................+",
        "-----+----|..|---------|",
        "          |..|         |",
        "          |..|         |",
        "          |..|         |",
        "          |..|         |",
        "          |..+         |",
        "          |..|         |",
        "          |..|         |",
        "          |..|         |",
        "          |..|         |",
        "-----------++----------|"
      ],
      "palettes": [
        "lab_palette"
      ],
      "place_nested": [
        { "chunks": [ "lab_spawn_9x9" ], "x": [0, 1], "y": [0, 1] },
        { "chunks": [ "lab_spawn_9x9" ], "x": 14, "y": [0,1] },
        { "chunks": [ "lab_spawn_9x9" ], "x": [0,1], "y": 14 },
        { "chunks": [ "lab_spawn_9x9_crossdoors" ], "x": 14, "y": 14 },
        { "chunks": [ "lab_border_walls" ], "x": 0, "y": 0 }
      ]
    }
  }
]