[
  {
    "type": "mapgen",
    "method": "json",
    "om_terrain": [ "lab_train_depot" ],
    "weight": 250,
    "object": {
      "fill_ter": "t_rock_floor",
      "rows": [
        "------------------------",
        "|                      |",
        "|                      |",
        "|                      |",
        "|                      |",
        "|                      |",
        "|                      |",
        "|                      |",
        "|                      |",
        "|                      |",
        "|                      |",
        "|                      |",
        "|                      |",
        "|                      |",
        "|                      |",
        "|                      |",
        "|                      |",
        "|                      |",
        "|                      |",
        "|                      |",
        "|                      |",
        "|                      |",
        "|                      |",
        "------------------------"
      ],
      "palettes": [ "lab_palette" ],
      "place_nested": [
        { "chunks": [ "lab_train_subway_east" ], "x": 0, "y": 0, "neighbors": { "east": ["subway"] } },
        { "chunks": [ "lab_train_subway_west" ], "x": 0, "y": 0, "neighbors": { "west": ["subway"] } },
        { "chunks": [ "lab_train_subway_north" ], "x": 0, "y": 0, "neighbors": { "north": ["subway"] } },
        { "chunks": [ "lab_train_subway_south" ], "x": 0, "y": 0, "neighbors": { "south": ["subway"] } },
        { "chunks": [ "lab_train_entrance_north" ], "x": 0, "y": 0, "neighbors": { "north": ["lab"] } },
        { "chunks": [ "lab_train_entrance_south" ], "x": 0, "y": 0, "neighbors": { "south": ["lab"] } },
        { "chunks": [ "lab_train_entrance_east" ], "x": 0, "y": 0, "neighbors": { "east": ["lab"] } },
        { "chunks": [ "lab_train_entrance_west" ], "x": 0, "y": 0, "neighbors": { "west": ["lab"] } }
      ]
    }
  },
  {
    "type": "mapgen",
    "method": "json",
    "nested_mapgen_id": "lab_train_subway_east",
    "object": {
      "mapgensize": [ 24, 24 ],
      "rows": [
        "                       .",
        "        ^^|^^|^^|^^|^^|^",
        "        XXxXXxXXxXXxXXxX",
        "        ^^|^^|^^|^^|^^|^",
        "        ^^|^^|^^|^^|^^|^",
        "        ^^|^^|^^|^^|^^|^",
        "        XXxXXxXXxXXxXXxX",
        "        ^^|^^|^^|^^|^^|^",
        "                       .",
        "                       .",
        "                       #",
        "                       #",
        "                       #",
        "                       #",
        "                       .",
        "                       .",
        "        ^^|^^|^^|^^|^^|^",
        "        XXxXXxXXxXXxXXxX",
        "        ^^|^^|^^|^^|^^|^",
        "        ^^|^^|^^|^^|^^|^",
        "        ^^|^^|^^|^^|^^|^",
        "        XXxXXxXXxXXxXXxX",
        "        ^^|^^|^^|^^|^^|^",
        "                       ."
      ],
      "palettes": [ "subway_underground" ]
    }
  },
  {
    "type": "mapgen",
    "method": "json",
    "nested_mapgen_id": "lab_train_subway_west",
    "object": {
      "mapgensize": [ 24, 24 ],
      "rows": [
        ".                       ",
        "^|^^|^^|^^|^^|^^        ",
        "XxXXxXXxXXxXXxXX        ",
        "^|^^|^^|^^|^^|^^        ",
        "^|^^|^^|^^|^^|^^        ",
        "^|^^|^^|^^|^^|^^        ",
        "XxXXxXXxXXxXXxXX        ",
        "^|^^|^^|^^|^^|^^        ",
        ".                       ",
        ".                       ",
        "#                       ",
        "#                       ",
        "#                       ",
        "#                       ",
        ".                       ",
        ".                       ",
        "^|^^|^^|^^|^^|^^        ",
        "XxXXxXXxXXxXXxXX        ",
        "^|^^|^^|^^|^^|^^        ",
        "^|^^|^^|^^|^^|^^        ",
        "^|^^|^^|^^|^^|^^        ",
        "XxXXxXXxXXxXXxXX        ",
        "^|^^|^^|^^|^^|^^        ",
        ".                       "
      ],
      "palettes": [ "subway_underground" ]
    }
  },
  {
    "type": "mapgen",
    "method": "json",
    "nested_mapgen_id": "lab_train_subway_north",
    "object": {
      "mapgensize": [ 24, 24 ],
      "rows": [
        ".^X^^^X^..####..^X^^^X^.",
        " -x---x-        -x---x- ",
        " xXXxXXx        xXXxXXx ",
        " ^X^^^X^        ^X^^^X^ ",
        " -x---x-        -x---x- ",
        " ^X^^^X^        ^X^^^X^ ",
        " xXXxXXx        xXXxXXx ",
        " -x---x-        -x---x- ",
        " ^X^^^X^        ^X^^^X^ ",
        " ^X^^^X^        ^X^^^X^ ",
        " -x---x-        -x---x- ",
        " ^X^^^X^        ^X^^^X^ ",
        " ^X^^^X^        ^X^^^X^ ",
        " -x---x-        -x---x- ",
        " ^X^^^X^        ^X^^^X^ ",
        " ^X^^^X^        ^X^^^X^ ",
        "                        ",
        "                        ",
        "                        ",
        "                        ",
        "                        ",
        "                        ",
        "                        ",
        "                        "
      ],
      "palettes": [ "subway_underground" ]
    }
  },
  {
    "type": "mapgen",
    "method": "json",
    "nested_mapgen_id": "lab_train_subway_south",
    "object": {
      "mapgensize": [ 24, 24 ],
      "rows": [
        "                        ",
        "                        ",
        "                        ",
        "                        ",
        "                        ",
        "                        ",
        "                        ",
        "                        ",
        " ^X^^^X^        ^X^^^X^ ",
        " ^X^^^X^        ^X^^^X^ ",
        " -x---x-        -x---x- ",
        " ^X^^^X^        ^X^^^X^ ",
        " ^X^^^X^        ^X^^^X^ ",
        " -x---x-        -x---x- ",
        " ^X^^^X^        ^X^^^X^ ",
        " ^X^^^X^        ^X^^^X^ ",
        " -x---x-        -x---x- ",
        " xXXxXXx        xXXxXXx ",
        " ^X^^^X^        ^X^^^X^ ",
        " -x---x-        -x---x- ",
        " ^X^^^X^        ^X^^^X^ ",
        " xXXxXXx        xXXxXXx ",
        " -x---x-        -x---x- ",
        ".^X^^^X^..####..^X^^^X^."
      ],
      "palettes": [ "subway_underground" ]
    }
  },
  {
    "type": "mapgen",
    "method": "json",
    "nested_mapgen_id": "lab_train_entrance_north",
    "object": {
      "mapgensize": [ 24, 24 ],
      "rows": [
        "        ........        ",
        "        ........        ",
        "        ........        ",
        "        ........        ",
        "        ........        ",
        "        ........        ",
        "        ........        ",
        "        ........        ",
        "                        ",
        "                        ",
        "                        ",
        "                        ",
        "                        ",
        "                        ",
        "                        ",
        "                        ",
        "                        ",
        "                        ",
        "                        ",
        "                        ",
        "                        ",
        "                        ",
        "                        ",
        "                        "
      ],
      "palettes": [ "lab_palette" ]
    }
  },
  {
    "type": "mapgen",
    "method": "json",
    "nested_mapgen_id": "lab_train_entrance_south",
    "object": {
      "mapgensize": [ 24, 24 ],
      "rows": [
        "                        ",
        "                        ",
        "                        ",
        "                        ",
        "                        ",
        "                        ",
        "                        ",
        "                        ",
        "                        ",
        "                        ",
        "                        ",
        "                        ",
        "                        ",
        "                        ",
        "                        ",
        "                        ",
        "        ........        ",
        "        ........        ",
        "        ........        ",
        "        ........        ",
        "        ........        ",
        "        ........        ",
        "        ........        ",
        "-----------++-----------"
      ],
      "palettes": [ "lab_palette" ]
    }
  },
  {
    "type": "mapgen",
    "method": "json",
    "nested_mapgen_id": "lab_train_entrance_east",
    "object": {
      "mapgensize": [ 24, 24 ],
      "rows": [
        "                       |",
        "                       |",
        "                       |",
        "                       |",
        "                       |",
        "                       |",
        "                       |",
        "                       |",
        "                .......|",
        "                .......|",
        "                .......|",
        "                .......+",
        "                .......+",
        "                .......|",
        "                .......|",
        "                .......|",
        "                       |",
        "                       |",
        "                       |",
        "                       |",
        "                       |",
        "                       |",
        "                       |",
        "                       |"
      ],
      "palettes": [ "lab_palette" ]
    }
  },
  {
    "type": "mapgen",
    "method": "json",
    "nested_mapgen_id": "lab_train_entrance_west",
    "object": {
      "mapgensize": [ 24, 24 ],
      "rows": [
        "                        ",
        "                        ",
        "                        ",
        "                        ",
        "                        ",
        "                        ",
        "                        ",
        "                        ",
        "........                ",
        "........                ",
        "........                ",
        "........                ",
        "........                ",
        "........                ",
        "........                ",
        "........                ",
        "                        ",
        "                        ",
        "                        ",
        "                        ",
        "                        ",
        "                        ",
        "                        ",
        "                        "
      ],
      "palettes": [ "lab_palette" ]
    }
  }
]