[
  {
    "type": "mapgen",
    "method": "json",
    "om_terrain": [ "lumberyard_0_0" ],
    "weight": 100,
    "object": {
      "fill_ter": "t_grass",
      "rows": [
        "____________           _",
        "____________            ",
        "_                       ",
        "_                       ",
        "_                       ",
        "_                       ",
        "_                       ",
        "_                       ",
        "_                       ",
        "_                       ",
        "_                       ",
        "_                       ",
        "_                :    : ",
        "_                :    : ",
        "_                :    : ",
        "_                :    : ",
        "_     _____|||||||||||||",
        "_     _____|x.x.x.x.....",
        "_     _____|............",
        "_     _____|x.x.........",
        "_     _____|............",
        "_     _____|x......|....",
        "_     _____|............",
        "_     _____|............"
      ],
      "palettes": [ "lumberyard" ]
    }
  }
]
