[
  {
    "type": "mapgen",
    "method": "json",
    "om_terrain": "corpse_bowels_mid",
    "object": {
      "fill_ter": "t_nm_floor_flesh",
      "rows": [
        "           BBB          ",
        "           BBB          ",
        "           BBB          ",
        "           BBB          ",
        "           BBB          ",
        "           BBB          ",
        "           BBB          ",
        "           BBB          ",
        "           BBB          ",
        "           BBB          ",
        "           BBB          ",
        "BBBBBBBBBBBBBBBBBBBBBBBB",
        "BBBBBBBBBBBBBBBBBBBBBBBB",
        "BBBBBBBBBBBBBBBBBBBBBBBB",
        "           BBB          ",
        "           BBB          ",
        "           BBB          ",
        "           BBB          ",
        "           BBB          ",
        "           BBB          ",
        "           BBB          ",
        "           BBB          ",
        "           BBB          ",
        "           BBB          "
      ],
      "palettes": [ "nether_monster_palette" ],
      "place_monster": [ { "monster": "mon_nether_fish", "x": [ 12, 23 ], "y": [ 12 ], "chance": 70, "pack_size": [ 1, 3 ] } ],
      "place_monsters": [
        {
          "monster": "GROUP_NETHER_CORPSE_BOWELS",
          "x": [ 1, 23 ],
          "y": [ 8, 23 ],
          "chance": 70,
          "repeat": [ 1, 2 ],
          "density": 0.2
        }
      ],
      "terrain": {
        " ": [
          [ "t_nm_floor_flesh", 25 ],
          [ "t_nm_wall_flesh", 15 ],
          [ "t_nm_wall_cartilage", 15 ],
          [ "t_nm_wall_flesh_pupating", 10 ],
          [ "t_nm_wall_flesh", 15 ]
        ]
      },
      "furniture": {
        " ": [
          [ "f_null", 1000 ],
          [ "f_nm_tube", 20 ],
          [ "f_nm_tube_emitter", 13 ],
          [ "f_nm_nether_grass", 28 ],
          [ "f_nm_nether_grass_tall", 20 ]
        ]
      }
    }
  },
  {
    "//": "walls of tentacle wall that can shift from side to side to make the tunnel wind",
    "type": "mapgen",
    "method": "json",
    "nested_mapgen_id": "tentacle_bounds_lite_hleft",
    "object": {
      "mapgensize": [ 14, 14 ],
      "rows": [
        "####          ",
        "              ",
        "              ",
        "              ",
        "              ",
        "              ",
        "              ",
        "              ",
        "              ",
        "              ",
        "              ",
        "              ",
        "              ",
        "              "
      ],
      "flags": [ "ERASE_ALL_BEFORE_PLACING_TERRAIN" ],
      "palettes": [ "nether_monster_palette" ],
      "terrain": {  }
    }
  },
  {
    "type": "mapgen",
    "method": "json",
    "om_terrain": "corpse_bowels_tentacle_edge",
    "object": {
      "fill_ter": "t_nm_floor_flesh",
      "rows": [
        "#######          #######",
        "######           #######",
        "######            ######",
        "#####             ######",
        "#####              #####",
        "#####               ####",
        "####                ####",
        "##                    ##",
        "                        ",
        "                        ",
        "                        ",
        "                        ",
        "                        ",
        "                        ",
        "                        ",
        "                        ",
        "                        ",
        "                        ",
        "                        ",
        "                        ",
        "                        ",
        "                        ",
        "                        ",
        "                        "
      ],
      "palettes": [ "nether_monster_palette" ],
      "place_monsters": [
        {
          "monster": "GROUP_NETHER_CORPSE_BOWELS",
          "x": [ 1, 23 ],
          "y": [ 8, 23 ],
          "chance": 70,
          "repeat": [ 1, 2 ],
          "density": 0.2
        }
      ],
      "terrain": { " ": [ [ "t_nm_floor_flesh", 25 ], [ "t_nm_ichor_sh", 10 ] ] },
      "furniture": {
        " ": [
          [ "f_null", 1000 ],
          [ "f_nm_tube", 20 ],
          [ "f_nm_tube_emitter", 13 ],
          [ "f_nm_nether_lily", 5 ],
          [ "f_nm_nether_grass", 28 ],
          [ "f_nm_nether_grass_tall", 20 ],
          [ "f_nm_nether_patchwork", 10 ],
          [ "f_nm_nether_lichen", 10 ]
        ]
      },
      "place_nested": [
        { "chunks": [ "tentacle_bounds_lite_hleft" ], "x": [ 4, 6 ], "y": 0 },
        { "chunks": [ "tentacle_bounds_lite_hleft" ], "x": [ 4, 6 ], "y": 1 },
        { "chunks": [ "tentacle_bounds_lite_hleft" ], "x": [ 4, 6 ], "y": 2 },
        { "chunks": [ "tentacle_bounds_lite_hleft" ], "x": [ 4, 6 ], "y": 3 },
        { "chunks": [ "tentacle_bounds_lite_hleft" ], "x": [ 3, 5 ], "y": 4 },
        { "chunks": [ "tentacle_bounds_lite_hleft" ], "x": [ 3, 5 ], "y": 5 },
        { "chunks": [ "tentacle_bounds_lite_hleft" ], "x": [ 2, 4 ], "y": 6 },
        { "chunks": [ "tentacle_bounds_lite_hleft" ], "x": [ 1, 3 ], "y": 7 },
        { "chunks": [ "tentacle_bounds_lite_hleft" ], "x": [ 0, 2 ], "y": 8 },
        { "chunks": [ "tentacle_bounds_lite_hleft" ], "x": [ 17, 19 ], "y": 0 },
        { "chunks": [ "tentacle_bounds_lite_hleft" ], "x": [ 17, 19 ], "y": 1 },
        { "chunks": [ "tentacle_bounds_lite_hleft" ], "x": [ 17, 19 ], "y": 2 },
        { "chunks": [ "tentacle_bounds_lite_hleft" ], "x": [ 17, 19 ], "y": 3 },
        { "chunks": [ "tentacle_bounds_lite_hleft" ], "x": [ 18, 20 ], "y": 4 },
        { "chunks": [ "tentacle_bounds_lite_hleft" ], "x": [ 18, 20 ], "y": 5 },
        { "chunks": [ "tentacle_bounds_lite_hleft" ], "x": [ 19, 20 ], "y": 6 }
      ]
    }
  },
  {
    "type": "mapgen",
    "method": "json",
    "om_terrain": "corpse_bowels_neck_right",
    "object": {
      "fill_ter": "t_nm_floor_flesh",
      "rows": [
        "#########  BB   ########",
        "########   BB    #######",
        "########   BB    #######",
        "#######    BB    #######",
        "#######    BB     ######",
        "######     BB      #####",
        "#####      BB      #####",
        "####       BB        ###",
        "##         BB         ##",
        "           BB           ",
        "           BB           ",
        "           BBBBBBBBBBBBB",
        "           BBBBBBBBBBBBB",
        "           BB           ",
        "           BB           ",
        "           BB           ",
        "           BB           ",
        "           BB           ",
        "           BB           ",
        "           BB           ",
        "           BB           ",
        "           BB           ",
        "          BBB           ",
        "         BBB            "
      ],
      "palettes": [ "nether_monster_palette" ],
      "place_monster": [ { "monster": "mon_nether_fish", "x": [ 12, 23 ], "y": [ 12 ], "chance": 100, "pack_size": [ 1, 3 ] } ],
      "place_monsters": [
        {
          "monster": "GROUP_NETHER_CORPSE_BOWELS",
          "x": [ 1, 23 ],
          "y": [ 8, 23 ],
          "chance": 70,
          "repeat": [ 1, 2 ],
          "density": 0.2
        }
      ],
      "terrain": {
        " ": [
          [ "t_nm_floor_flesh", 25 ],
          [ "t_nm_wall_flesh", 15 ],
          [ "t_nm_wall_cartilage", 15 ],
          [ "t_nm_wall_flesh_pupating", 10 ],
          [ "t_nm_wall_flesh", 15 ]
        ]
      },
      "furniture": {
        " ": [
          [ "f_null", 1000 ],
          [ "f_nm_tube", 20 ],
          [ "f_nm_tube_emitter", 13 ],
          [ "f_nm_nether_grass", 28 ],
          [ "f_nm_nether_grass_tall", 20 ]
        ]
      },
      "place_nested": [
        { "chunks": [ "tentacle_bounds_lite_hleft" ], "x": [ 4, 6 ], "y": 0 },
        { "chunks": [ "tentacle_bounds_lite_hleft" ], "x": [ 4, 6 ], "y": 1 },
        { "chunks": [ "tentacle_bounds_lite_hleft" ], "x": [ 4, 6 ], "y": 2 },
        { "chunks": [ "tentacle_bounds_lite_hleft" ], "x": [ 4, 6 ], "y": 3 },
        { "chunks": [ "tentacle_bounds_lite_hleft" ], "x": [ 3, 5 ], "y": 4 },
        { "chunks": [ "tentacle_bounds_lite_hleft" ], "x": [ 3, 5 ], "y": 5 },
        { "chunks": [ "tentacle_bounds_lite_hleft" ], "x": [ 2, 4 ], "y": 6 },
        { "chunks": [ "tentacle_bounds_lite_hleft" ], "x": [ 1, 3 ], "y": 7 },
        { "chunks": [ "tentacle_bounds_lite_hleft" ], "x": [ 0, 2 ], "y": 8 },
        { "chunks": [ "tentacle_bounds_lite_hleft" ], "x": [ 17, 19 ], "y": 0 },
        { "chunks": [ "tentacle_bounds_lite_hleft" ], "x": [ 17, 19 ], "y": 1 },
        { "chunks": [ "tentacle_bounds_lite_hleft" ], "x": [ 17, 19 ], "y": 2 },
        { "chunks": [ "tentacle_bounds_lite_hleft" ], "x": [ 17, 19 ], "y": 3 },
        { "chunks": [ "tentacle_bounds_lite_hleft" ], "x": [ 18, 20 ], "y": 4 },
        { "chunks": [ "tentacle_bounds_lite_hleft" ], "x": [ 18, 20 ], "y": 5 },
        { "chunks": [ "tentacle_bounds_lite_hleft" ], "x": [ 19, 20 ], "y": 6 }
      ]
    }
  },
  {
    "type": "mapgen",
    "method": "json",
    "om_terrain": "corpse_bowels_neck_left",
    "object": {
      "fill_ter": "t_nm_floor_flesh",
      "rows": [
        "#########  BB   ########",
        "########   BB    #######",
        "########   BB    #######",
        "#######    BB    #######",
        "#######    BB     ######",
        "######     BB      #####",
        "#####      BB      #####",
        "####       BB        ###",
        "##         BB         ##",
        "           BB           ",
        "           BB           ",
        "BBBBBBBBBBBBB           ",
        "BBBBBBBBBBBBB           ",
        "           BB           ",
        "           BB           ",
        "           BB           ",
        "           BB           ",
        "           BB           ",
        "           BB           ",
        "           BB           ",
        "           BB           ",
        "           BB           ",
        "          BBB           ",
        "         BBB            "
      ],
      "palettes": [ "nether_monster_palette" ],
      "place_monster": [ { "monster": "mon_nether_fish", "x": [ 0, 10 ], "y": [ 12 ], "chance": 100, "pack_size": [ 1, 3 ] } ],
      "place_monsters": [
        {
          "monster": "GROUP_NETHER_CORPSE_BOWELS",
          "x": [ 1, 23 ],
          "y": [ 8, 23 ],
          "chance": 70,
          "repeat": [ 1, 2 ],
          "density": 0.2
        }
      ],
      "terrain": {
        " ": [
          [ "t_nm_floor_flesh", 25 ],
          [ "t_nm_wall_flesh", 15 ],
          [ "t_nm_wall_cartilage", 15 ],
          [ "t_nm_wall_flesh_pupating", 10 ],
          [ "t_nm_wall_flesh", 15 ]
        ]
      },
      "furniture": {
        " ": [
          [ "f_null", 1000 ],
          [ "f_nm_tube", 20 ],
          [ "f_nm_tube_emitter", 13 ],
          [ "f_nm_nether_grass", 28 ],
          [ "f_nm_nether_grass_tall", 20 ]
        ]
      },
      "place_nested": [
        { "chunks": [ "tentacle_bounds_lite_hleft" ], "x": [ 4, 6 ], "y": 0 },
        { "chunks": [ "tentacle_bounds_lite_hleft" ], "x": [ 4, 6 ], "y": 1 },
        { "chunks": [ "tentacle_bounds_lite_hleft" ], "x": [ 4, 6 ], "y": 2 },
        { "chunks": [ "tentacle_bounds_lite_hleft" ], "x": [ 4, 6 ], "y": 3 },
        { "chunks": [ "tentacle_bounds_lite_hleft" ], "x": [ 3, 5 ], "y": 4 },
        { "chunks": [ "tentacle_bounds_lite_hleft" ], "x": [ 3, 5 ], "y": 5 },
        { "chunks": [ "tentacle_bounds_lite_hleft" ], "x": [ 2, 4 ], "y": 6 },
        { "chunks": [ "tentacle_bounds_lite_hleft" ], "x": [ 1, 3 ], "y": 7 },
        { "chunks": [ "tentacle_bounds_lite_hleft" ], "x": [ 0, 2 ], "y": 8 },
        { "chunks": [ "tentacle_bounds_lite_hleft" ], "x": [ 17, 19 ], "y": 0 },
        { "chunks": [ "tentacle_bounds_lite_hleft" ], "x": [ 17, 19 ], "y": 1 },
        { "chunks": [ "tentacle_bounds_lite_hleft" ], "x": [ 17, 19 ], "y": 2 },
        { "chunks": [ "tentacle_bounds_lite_hleft" ], "x": [ 17, 19 ], "y": 3 },
        { "chunks": [ "tentacle_bounds_lite_hleft" ], "x": [ 18, 20 ], "y": 4 },
        { "chunks": [ "tentacle_bounds_lite_hleft" ], "x": [ 18, 20 ], "y": 5 },
        { "chunks": [ "tentacle_bounds_lite_hleft" ], "x": [ 19, 20 ], "y": 6 }
      ]
    }
  },
  {
    "type": "mapgen",
    "method": "json",
    "om_terrain": "corpse_bowels_neck_edge_center",
    "object": {
      "fill_ter": "t_nm_floor_flesh",
      "rows": [
        "########################",
        "########################",
        "########################",
        "########################",
        "########################",
        "########################",
        "########################",
        "########################",
        "###        ###    ###  #",
        "                        ",
        "                        ",
        "BBBBBBBBBBBBBBBBBBBBBBBB",
        "BBBBBBBBBBBBBBBBBBBBBBBB",
        "     CCC##BBBB##CCC     ",
        "   CCCC###BBBB###CCCC   ",
        "   CC###BBBBBBBB###CC   ",
        "   CC#BBBBBHJBBBBB#CC   ",
        "   CC#BBBBBKLBBBBB#CC   ",
        "   CC###BBBBBBBB###CC   ",
        "   CCCC###BBBB###CCCC   ",
        "      CCC######CCCC     ",
        "      CCCCCCCCCCCCC     ",
        "                        ",
        "                        "
      ],
      "palettes": [ "nether_monster_palette" ],
      "place_monster": [ { "monster": "mon_nether_fish", "x": [ 0, 23 ], "y": [ 12 ], "chance": 100, "pack_size": [ 2, 4 ] } ],
      "place_monsters": [
        {
          "monster": "GROUP_NETHER_CORPSE_BOWELS",
          "x": [ 1, 23 ],
          "y": [ 8, 23 ],
          "chance": 70,
          "repeat": [ 1, 2 ],
          "density": 0.2
        }
      ],
      "terrain": { "H": "t_nm_floor_flesh", "J": "t_nm_floor_flesh", "K": "t_nm_floor_flesh", "L": "t_nm_floor_flesh" }
    }
  },
  {
    "type": "mapgen",
    "method": "json",
    "om_terrain": [ [ "corpse_bowels_lcorner", "corpse_bowels_empty_edge", "corpse_bowels_rcorner" ] ],
    "object": {
      "fill_ter": "t_nm_floor_flesh",
      "rows": [
        "#######                                                          #######",
        "#######                                                          #######",
        "#######                                                          #######",
        "#######                                                          #######",
        "#######                                                          #######",
        "#######                                                          #######",
        "#######                                                          #######",
        "#######                                                          #######",
        "########                                                        ########",
        "########                                                        ########",
        "#########                                                      #########",
        "##########                                                    ##########",
        "###########                                                  ###########",
        "#############                                              #############",
        "###############                                          ###############",
        "##################       ##        #     ###          ##################",
        "#####################   ##### # ############ ###   #####################",
        "########################################################################",
        "########################################################################",
        "########################################################################",
        "########################################################################",
        "########################################################################",
        "########################################################################",
        "########################################################################"
      ],
      "palettes": [ "nether_monster_palette" ],
      "place_monsters": [
        {
          "monster": "GROUP_NETHER_CORPSE_BOWELS",
          "x": [ 1, 23 ],
          "y": [ 1, 14 ],
          "chance": 70,
          "repeat": [ 1, 2 ],
          "density": 0.2
        }
      ],
      "terrain": {
        " ": [
          [ "t_nm_floor_flesh", 25 ],
          [ "t_nm_wall_flesh", 15 ],
          [ "t_nm_wall_cartilage", 15 ],
          [ "t_nm_wall_flesh_pupating", 10 ],
          [ "t_nm_wall_flesh", 15 ]
        ]
      },
      "furniture": {
        " ": [
          [ "f_null", 1000 ],
          [ "f_nm_tube", 20 ],
          [ "f_nm_tube_emitter", 13 ],
          [ "f_nm_nether_grass", 28 ],
          [ "f_nm_nether_grass_tall", 20 ]
        ]
      }
    }
  }
]
