[
  {
    "type": "mapgen",
    "method": "json",
    "om_terrain": "corpse_neck",
    "object": {
      "fill_ter": "t_dirt_underground",
      "rows": [
        "#######          #######",
        "#######          #######",
        "#######          #######",
        "#######          #######",
        "#######          #######",
        "#######          #######",
        "#######          #######",
        "#######          #######",
        "#######          #######",
        "#######          #######",
        "#######          #######",
        "#######          #######",
        "#######          #######",
        "#######          #######",
        "#######          #######",
        "#######          #######",
        "#######          #######",
        "#######          #######",
        "#######          #######",
        "#######          #######",
        "#######          #######",
        "#######          #######",
        "#######          #######",
        "#######          #######"
      ],
      "terrain": { "#": "t_soil" },
      "place_nested": [
        { "chunks": [ "tentacle_bounds_h" ], "x": [ 4, 6 ], "y": 0 },
        { "chunks": [ "tentacle_bounds_h" ], "x": [ 4, 6 ], "y": 1 },
        { "chunks": [ "tentacle_bounds_h" ], "x": [ 4, 6 ], "y": 2 },
        { "chunks": [ "tentacle_bounds_h" ], "x": [ 4, 6 ], "y": 3 },
        { "chunks": [ "tentacle_bounds_h" ], "x": [ 4, 6 ], "y": 4 },
        { "chunks": [ "tentacle_bounds_h" ], "x": [ 4, 6 ], "y": 5 },
        { "chunks": [ "tentacle_bounds_h" ], "x": [ 4, 6 ], "y": 6 },
        { "chunks": [ "tentacle_bounds_h" ], "x": [ 4, 6 ], "y": 7 },
        { "chunks": [ "tentacle_bounds_h" ], "x": [ 4, 6 ], "y": 8 },
        { "chunks": [ "tentacle_bounds_h" ], "x": [ 4, 6 ], "y": 9 },
        { "chunks": [ "tentacle_bounds_h" ], "x": [ 4, 6 ], "y": 10 },
        { "chunks": [ "tentacle_bounds_h" ], "x": [ 4, 6 ], "y": 11 },
        { "chunks": [ "tentacle_bounds_h" ], "x": [ 4, 6 ], "y": 12 },
        { "chunks": [ "tentacle_bounds_h" ], "x": [ 4, 6 ], "y": 13 },
        { "chunks": [ "tentacle_bounds_h" ], "x": [ 4, 6 ], "y": 14 },
        { "chunks": [ "tentacle_bounds_h" ], "x": [ 4, 6 ], "y": 15 },
        { "chunks": [ "tentacle_bounds_h" ], "x": [ 4, 6 ], "y": 16 },
        { "chunks": [ "tentacle_bounds_h" ], "x": [ 4, 6 ], "y": 17 },
        { "chunks": [ "tentacle_bounds_h" ], "x": [ 4, 6 ], "y": 18 },
        { "chunks": [ "tentacle_bounds_h" ], "x": [ 4, 6 ], "y": 19 },
        { "chunks": [ "tentacle_bounds_h" ], "x": [ 4, 6 ], "y": 20 },
        { "chunks": [ "tentacle_bounds_h" ], "x": [ 4, 6 ], "y": 21 },
        { "chunks": [ "tentacle_bounds_h" ], "x": [ 4, 6 ], "y": 22 },
        { "chunks": [ "tentacle_bounds_h" ], "x": [ 4, 6 ], "y": 23 }
      ]
    }
  },
  {
    "type": "mapgen",
    "method": "json",
    "om_terrain": "corpse_neck_center",
    "weight": 150,
    "object": {
      "fill_ter": "t_dirt_underground",
      "rows": [
        "########################",
        "########################",
        "########################",
        "#################### #  ",
        "###################  ###",
        "############# ###   ####",
        "############     # #####",
        "############ ###########",
        "###############   ######",
        "#############   #   ####",
        "############   #### ####",
        "####    ###  # #### ####",
        "     ##     ## ####     ",
        "####  ######## #########",
        "##### ########    ######",
        "#####          ###      ",
        "############ ##### #####",
        "#########  #    ##  ####",
        "#########  #######   ###",
        "###           ##  ## ###",
        "    ### #####        ###",
        "#######     #######     ",
        "########################",
        "########################"
      ],
      "terrain": { "#": "t_soil" }
    }
  },
  {
    "type": "mapgen",
    "method": "json",
    "om_terrain": "corpse_head_neck_center",
    "object": {
      "fill_ter": "t_dirt_underground",
      "rows": [
        "                        ",
        "                        ",
        "                        ",
        "                        ",
        "                        ",
        "                        ",
        "                        ",
        "                        ",
        "                        ",
        "                        ",
        "           ##           ",
        "          ####          ",
        "         ######         ",
        "        ########        ",
        "       ##########       ",
        "      ############      ",
        "     ##############     ",
        "    ################    ",
        "   ##################   ",
        "  ####################  ",
        " ###################### ",
        "########################",
        "########################",
        "########################"
      ],
      "terrain": { "#": "t_soil" }
    }
  },
  {
    "type": "mapgen",
    "method": "json",
    "om_terrain": "corpse_head_neck_r",
    "object": {
      "fill_ter": "t_dirt_underground",
      "rows": [
        "#                       ",
        "#                       ",
        "#                       ",
        "#                       ",
        "#                       ",
        "#                       ",
        "#                       ",
        "#                       ",
        "#                       ",
        "#                       ",
        "#                       ",
        "#                       ",
        "#                       ",
        "#                       ",
        "#                       ",
        "#                       ",
        "#                       ",
        "#                       ",
        "#                       ",
        "##                      ",
        "###                     ",
        "####                   #",
        "######                ##",
        "########             ###"
      ],
      "terrain": { "#": "t_soil" }
    }
  },
  {
    "type": "mapgen",
    "method": "json",
    "om_terrain": "corpse_head_neck_l",
    "object": {
      "fill_ter": "t_dirt_underground",
      "rows": [
        "                       #",
        "                       #",
        "                       #",
        "                       #",
        "                       #",
        "                       #",
        "                       #",
        "                       #",
        "                       #",
        "                       #",
        "                       #",
        "                       #",
        "                       #",
        "                       #",
        "                       #",
        "                       #",
        "                       #",
        "                       #",
        "                       #",
        "                      ##",
        "                     ###",
        "#                   ####",
        "##                ######",
        "###             ########"
      ],
      "terrain": { "#": "t_soil" }
    }
  },
  {
    "type": "mapgen",
    "method": "json",
    "om_terrain": "corpse_head",
    "object": {
      "fill_ter": "t_dirt_underground",
      "rows": [
        "                        ",
        "                        ",
        "                        ",
        "                        ",
        "                        ",
        "                        ",
        "                        ",
        "                        ",
        "                        ",
        "                        ",
        "                        ",
        "                        ",
        "                        ",
        "                        ",
        "                        ",
        "                        ",
        "                        ",
        "                        ",
        "                        ",
        "                        ",
        "                        ",
        "                        ",
        "                        ",
        "                        "
      ],
      "terrain": { "#": "t_soil" }
    }
  },
  {
    "type": "mapgen",
    "method": "json",
    "om_terrain": "corpse_head_edge",
    "object": {
      "fill_ter": "t_dirt_underground",
      "rows": [
        "                        ",
        "                        ",
        "                        ",
        "                        ",
        "                        ",
        "                        ",
        "                        ",
        "                        ",
        "                        ",
        "                        ",
        "                        ",
        "                        ",
        "                        ",
        "                        ",
        "                        ",
        "                        ",
        "                        ",
        "                        ",
        "                        ",
        "                        ",
        "                        ",
        "                        ",
        " ###   ##     ####   ## ",
        "########################"
      ],
      "terrain": { "#": "t_soil" }
    }
  },
  {
    "type": "mapgen",
    "method": "json",
    "om_terrain": "corpse_head_fin",
    "object": {
      "fill_ter": "t_dirt_underground",
      "rows": [
        "#                      #",
        "#                      #",
        "#                      #",
        "#                      #",
        "#                      #",
        "##                    ##",
        "###                  ###",
        "####                ####",
        "#####              #####",
        "######            ######",
        "#######          #######",
        "########        ########",
        "#########      #########",
        "##########    ##########",
        "##########    ##########",
        "###########  ###########",
        "########################",
        "########################",
        "########################",
        "########################",
        "########################",
        "########################",
        "########################",
        "########################"
      ],
      "terrain": { "#": "t_soil" }
    }
  },
  {
    "type": "mapgen",
    "method": "json",
    "om_terrain": "corpse_head_rcorner",
    "object": {
      "fill_ter": "t_dirt_underground",
      "rows": [
        "                       #",
        "                       #",
        "                       #",
        "                       #",
        "                      ##",
        "                      ##",
        "                      ##",
        "                     ###",
        "                     ###",
        "                     ###",
        "                    ####",
        "                    ####",
        "                   #####",
        "                   #####",
        "                  ######",
        "                 #######",
        "                ########",
        "               #########",
        "              ##########",
        "            ############",
        "          ##############",
        "       #################",
        "    ####################",
        "########################"
      ],
      "terrain": { "#": "t_soil" }
    }
  },
  {
    "type": "mapgen",
    "method": "json",
    "om_terrain": "corpse_head_lcorner",
    "object": {
      "fill_ter": "t_dirt_underground",
      "rows": [
        "#                       ",
        "#                       ",
        "#                       ",
        "#                       ",
        "##                      ",
        "##                      ",
        "##                      ",
        "###                     ",
        "###                     ",
        "###                     ",
        "####                    ",
        "####                    ",
        "#####                   ",
        "#####                   ",
        "######                  ",
        "#######                 ",
        "########                ",
        "#########               ",
        "##########              ",
        "############            ",
        "##############          ",
        "#################       ",
        "####################    ",
        "########################"
      ],
      "terrain": { "#": "t_soil" }
    }
  }
]
