[  
    {
        "type": "mapgen",
        "method": "json",
        "om_terrain": "corpse_surface",
        "object": {
            "fill_ter": "t_dirt_underground",
            "rows": [
            "                        ",
            "                        ",
            "                        ",
            "                        ",
            "                        ",
            "                        ",
            "                        ",
            "                        ",
            "                        ",
            "#                       ",
            "                        ",
            "                        ",
            "                        ",
            "                        ",
            "                        ",
            "                        ",
            "                        ",
            "                        ",
            "#                      #",
            "#                      #",
            "#                      #",
            "#                      #",
            "#                      #",
            "#                      #"
            ],
            "terrain": { "#": "t_soil" }
        }
    },
    {
        "type": "mapgen",
        "method": "json",
        "om_terrain": "corpse_bowels_mid",
        "object": {
            "fill_ter": "t_dirt_underground",
            "rows": [
            "#######          #######",
            "#######          #######",
            "#######          #######",
            "######           #######",
            "#######          #######",
            "######            ######",
            "######             #####",
            "#####               ####",
            "####               #####",
            "#####              #####",
            "####                ####",
            "####                ####",
            "###                  ###",
            "###                 ####",
            "####              ######",
            "#######            #####",
            "#########           ####",
            "#                      #",
            "#                      #",
            "#                      #",
            "#                      #",
            "#                      #",
            "#                      #",
            "#                      #"
            ],
            "terrain": { "#": "t_soil" }
        }
    },
    {
        "type": "mapgen",
        "method": "json",
        "om_terrain": "corpse_bowels_empty_edge",
        "object": {
            "fill_ter": "t_dirt_underground",
            "rows": [
            "#######          #######",
            "#######          #######",
            "#######          #######",
            "######           #######",
            "#######          #######",
            "######            ######",
            "######             #####",
            "#####               ####",
            "####               #####",
            "#####              #####",
            "####                ####",
            "####                ####",
            "###                  ###",
            "###                 ####",
            "####              ######",
            "#######            #####",
            "#########           ####",
            "#                      #",
            "#                      #",
            "#                      #",
            "#                      #",
            "#                      #",
            "#                      #",
            "#                      #"
            ],
            "terrain": { "#": "t_soil" }
        }
    },
    {
        "type": "mapgen",
        "method": "json",
        "om_terrain": "corpse_bowels_tentacle_edge",
        "object": {
            "fill_ter": "t_dirt_underground",
            "rows": [
            "                        ",
            "                        ",
            "                        ",
            "                        ",
            "                        ",
            "                        ",
            "                        ",
            "                        ",
            "                        ",
            "#                       ",
            "                        ",
            "                        ",
            "                        ",
            "                        ",
            "                        ",
            "                        ",
            "                        ",
            "                        ",
            "#                      #",
            "#                      #",
            "#                      #",
            "#                      #",
            "#                      #",
            "#                      #"
            ],
            "terrain": { "#": "t_soil" }
        }
    },
    {
        "type": "mapgen",
        "method": "json",
        "om_terrain": "corpse_bowels_neck_edge",
        "object": {
            "fill_ter": "t_dirt_underground",
            "rows": [
            "                        ",
            "                        ",
            "                        ",
            "                        ",
            "                        ",
            "                        ",
            "                        ",
            "                        ",
            "                        ",
            "#                       ",
            "                        ",
            "                        ",
            "                        ",
            "                        ",
            "                        ",
            "                        ",
            "                        ",
            "                        ",
            "#                      #",
            "#                      #",
            "#                      #",
            "#                      #",
            "#                      #",
            "#                      #"
            ],
            "terrain": { "#": "t_soil" }
        }
    },
    {
        "type": "mapgen",
        "method": "json",
        "om_terrain": "corpse_neck",
        "object": {
            "fill_ter": "t_dirt_underground",
            "rows": [
            "                        ",
            "                        ",
            "                        ",
            "                        ",
            "                        ",
            "                        ",
            "                        ",
            "                        ",
            "                        ",
            "#                       ",
            "                        ",
            "                        ",
            "                        ",
            "                        ",
            "                        ",
            "                        ",
            "                        ",
            "                        ",
            "#                      #",
            "#                      #",
            "#                      #",
            "#                      #",
            "#                      #",
            "#                      #"
            ],
            "terrain": { "#": "t_soil" }
        }
    },
    {
        "type": "mapgen",
        "method": "json",
        "om_terrain": "corpse_head",
        "object": {
            "fill_ter": "t_dirt_underground",
            "rows": [
            "                        ",
            "                        ",
            "                        ",
            "                        ",
            "                        ",
            "                        ",
            "                        ",
            "                        ",
            "                        ",
            "#                       ",
            "                        ",
            "                        ",
            "                        ",
            "                        ",
            "                        ",
            "                        ",
            "                        ",
            "                        ",
            "#                      #",
            "#                      #",
            "#                      #",
            "#                      #",
            "#                      #",
            "#                      #"
            ],
            "terrain": { "#": "t_soil" }
        }
    },
    {
        "type": "mapgen",
        "method": "json",
        "om_terrain": "corpse_tentacle_straight",
        "object": {
            "fill_ter": "t_dirt_underground",
            "rows": [
            "                        ",
            "                        ",
            "                        ",
            "                        ",
            "                        ",
            "                        ",
            "                        ",
            "                        ",
            "                        ",
            "#                       ",
            "                        ",
            "                        ",
            "                        ",
            "                        ",
            "                        ",
            "                        ",
            "                        ",
            "                        ",
            "#                      #",
            "#                      #",
            "#                      #",
            "#                      #",
            "#                      #",
            "#                      #"
            ],
            "terrain": { "#": "t_soil" }
        }
    },
    {
        "type": "mapgen",
        "method": "json",
        "om_terrain": "corpse_tentacle_curved",
        "object": {
            "fill_ter": "t_dirt_underground",
            "rows": [
            "                        ",
            "                        ",
            "                        ",
            "                        ",
            "                        ",
            "                        ",
            "                        ",
            "                        ",
            "                        ",
            "#                       ",
            "                        ",
            "                        ",
            "                        ",
            "                        ",
            "                        ",
            "                        ",
            "                        ",
            "                        ",
            "#                      #",
            "#                      #",
            "#                      #",
            "#                      #",
            "#                      #",
            "#                      #"
            ],
            "terrain": { "#": "t_soil" }
        }
    },
    {
        "type": "mapgen",
        "method": "json",
        "om_terrain": "corpse_tentacle_tee",
        "object": {
            "fill_ter": "t_dirt_underground",
            "rows": [
            "                        ",
            "                        ",
            "                        ",
            "                        ",
            "                        ",
            "                        ",
            "                        ",
            "                        ",
            "                        ",
            "#                       ",
            "                        ",
            "                        ",
            "                        ",
            "                        ",
            "                        ",
            "                        ",
            "                        ",
            "                        ",
            "#                      #",
            "#                      #",
            "#                      #",
            "#                      #",
            "#                      #",
            "#                      #"
            ],
            "terrain": { "#": "t_soil" }
        }
    },
    {
        "type": "mapgen",
        "method": "json",
        "om_terrain": "corpse_tentacle_four_way",
        "object": {
            "fill_ter": "t_dirt_underground",
            "rows": [
            "                        ",
            "                        ",
            "                        ",
            "                        ",
            "                        ",
            "                        ",
            "                        ",
            "                        ",
            "                        ",
            "#                       ",
            "                        ",
            "                        ",
            "                        ",
            "                        ",
            "                        ",
            "                        ",
            "                        ",
            "                        ",
            "#                      #",
            "#                      #",
            "#                      #",
            "#                      #",
            "#                      #",
            "#                      #"
            ],
            "terrain": { "#": "t_soil" }
        }
    },
    {
        "type": "mapgen",
        "method": "json",
        "om_terrain": "corpse_tentacle_end",
        "object": {
            "fill_ter": "t_dirt_underground",
            "rows": [
            "                        ",
            "                        ",
            "                        ",
            "                        ",
            "                        ",
            "                        ",
            "                        ",
            "                        ",
            "                        ",
            "#                       ",
            "                        ",
            "                        ",
            "                        ",
            "                        ",
            "                        ",
            "                        ",
            "                        ",
            "                        ",
            "#                      #",
            "#                      #",
            "#                      #",
            "#                      #",
            "#                      #",
            "#                      #"
            ],
            "terrain": { "#": "t_soil" }
        }
    }
]