[
  {
    "type": "mapgen",
    "om_terrain": [ "hw_reserved", "hw_reserved_water" ],
    "object": { "fallback_predecessor_mapgen": "open_air" }
  },
  {
    "om_terrain": "hw_road",
    "type": "mapgen",
    "object": {
      "fallback_predecessor_mapgen": "open_air",
      "place_nested": [
        { "chunks": [ "24x24_highway_road_flat" ], "x": 0, "y": 0, "check_z": [ 0 ] },
        { "chunks": [ "24x24_highway_bridge_road" ], "x": 0, "y": 0, "check_z": [ 1 ] }
      ]
    }
  },
  {
    "nested_mapgen_id": "24x24_highway_road_flat",
    "type": "mapgen",
    "object": {
      "mapgensize": [ 24, 24 ],
      "rows": [
        "       |...............|",
        "       |...............|",
        "       |.......*.......|",
        "       |.......*.......|",
        "       |...............|",
        "       |...............|",
        "       |.......*.......|",
        "       |.......*.......|",
        "       |...............|",
        "       |...............|",
        "       |.......*.......|",
        "       |.......*.......|",
        "       |...............|",
        "       |...............|",
        "       |.......*.......|",
        "       |.......*.......|",
        "       |...............|",
        "       |...............|",
        "       |.......*.......|",
        "       |.......*.......|",
        "       |...............|",
        "       |...............|",
        "       |.......*.......|",
        "       |.......*.......|"
      ],
      "palettes": [ "highway_palette" ],
      "place_nested": [ { "chunks": [ "24x24_highway_road_bridge_ramp" ], "x": 0, "y": 0, "neighbors": { "above": "hw_road_bridge" } } ],
      "flags": [ "ERASE_ALL_BEFORE_PLACING_TERRAIN" ]
    }
  },
  {
    "nested_mapgen_id": "24x24_highway_road_bridge_ramp",
    "type": "mapgen",
    "object": {
      "mapgensize": [ 24, 24 ],
      "rows": [
        "                        ",
        "                        ",
        "                        ",
        "  ||###                #",
        "..._<##                #",
        "..._<##                #",
        "..._<##                #",
        "..._<##                #",
        "..._<##                #",
        "..._<##                #",
        "..._<##                #",
        ".**_<##                #",
        ".**_<##                #",
        "..._<##                #",
        "..._<##                #",
        "..._<##                #",
        "..._<##                #",
        "..._<##                #",
        "..._<##                #",
        "..._<##                #",
        "  ||###                #",
        "                        ",
        "                        ",
        "                        "
      ],
      "palettes": [ "highway_palette" ],
      "flags": [ "ERASE_ALL_BEFORE_PLACING_TERRAIN" ]
    }
  },
  {
    "nested_mapgen_id": "24x24_highway_bridge_road",
    "type": "mapgen",
    "//": "currently a copy of the flat road, but could be different",
    "object": {
      "mapgensize": [ 24, 24 ],
      "rows": [
        "       |...............|",
        "       |...............|",
        "       |.......*.......|",
        "       |.......*.......|",
        "       |...............|",
        "       |...............|",
        "       |.......*.......|",
        "       |.......*.......|",
        "       |...............|",
        "       |...............|",
        "       |.......*.......|",
        "       |.......*.......|",
        "       |...............|",
        "       |...............|",
        "       |.......*.......|",
        "       |.......*.......|",
        "       |...............|",
        "       |...............|",
        "       |.......*.......|",
        "       |.......*.......|",
        "       |...............|",
        "       |...............|",
        "       |.......*.......|",
        "       |.......*.......|"
      ],
      "palettes": [ "highway_palette" ],
      "flags": [ "ERASE_ALL_BEFORE_PLACING_TERRAIN" ]
    }
  },
  {
    "om_terrain": "hw_road_bridge",
    "type": "mapgen",
    "object": {
      "fill_ter": "t_open_air",
      "rows": [
        "                        ",
        "                        ",
        "                        ",
        "    ||||||||||||||||||||",
        "    >‾..................",
        "    >‾..................",
        "    >‾..................",
        "    >‾..................",
        "    >‾..................",
        "    >‾..................",
        "    >‾..................",
        "    >‾*.***.***.***.***.",
        "    >‾*.***.***.***.***.",
        "    >‾..................",
        "    >‾..................",
        "    >‾..................",
        "    >‾..................",
        "    >‾..................",
        "    >‾..................",
        "    >‾..................",
        "    ||||||||||||||||||||",
        "                        ",
        "                        ",
        "                        "
      ],
      "palettes": [ "highway_palette" ],
      "flags": [ "ERASE_ALL_BEFORE_PLACING_TERRAIN" ]
    }
  },
  {
    "om_terrain": "hw_supports",
    "type": "mapgen",
    "object": {
      "fallback_predecessor_mapgen": "river_center",
      "rows": [
        "                        ",
        "                        ",
        "                        ",
        "                        ",
        "                        ",
        "                        ",
        "                        ",
        "                        ",
        "                        ",
        "         ######         ",
        "        ########        ",
        "       ##########       ",
        "       ##########       ",
        "        ########        ",
        "         ######         ",
        "                        ",
        "                        ",
        "                        ",
        "                        ",
        "                        ",
        "                        ",
        "                        ",
        "                        ",
        "                        "
      ],
      "palettes": [ "highway_palette" ],
      "flags": [ "ERASE_ALL_BEFORE_PLACING_TERRAIN" ]
    }
  },
  {
    "nested_mapgen_id": "24x24_highway_underpass_road",
    "type": "mapgen",
    "object": {
      "mapgensize": [ 24, 24 ],
      "set": [
        { "square": "terrain", "id": "t_sidewalk", "x": 0, "y": 0, "x2": 23, "y2": 2 },
        { "square": "terrain", "id": "t_sidewalk", "x": 0, "y": 21, "x2": 23, "y2": 23 }
      ],
      "flags": [ "ERASE_ALL_BEFORE_PLACING_TERRAIN" ]
    }
  },
  {
    "nested_mapgen_id": "24x24_highway_underpass",
    "type": "mapgen",
    "object": {
      "mapgensize": [ 24, 24 ],
      "set": [ { "square": "terrain", "id": "t_sidewalk", "x": 0, "y": 0, "x2": 23, "y2": 23 } ],
      "flags": [ "ERASE_ALL_BEFORE_PLACING_TERRAIN" ]
    }
  },
  {
    "om_terrain": [ [ "highway_ramp_up_0", "highway_ramp_up_1" ] ],
    "type": "mapgen",
    "object": {
      "fallback_predecessor_mapgen": "field",
      "rows": [
        "                                                ",
        "                                                ",
        "                                                ",
        "                                                ",
        "                                                ",
        "                                                ",
        "                                                ",
        "                                                ",
        "                                                ",
        "       ##################################       ",
        "       ##################################       ",
        "       #<<<<<<<<<<<<<<<##<<<<<<<<<<<<<<<#       ",
        "       |_______________||_______________|       ",
        "       |...............||...............|       ",
        "       |.......*.......||...............|       ",
        "       |.......*.......||...............|       ",
        "       |...............||.......*.......|       ",
        "       |...............||.......*.......|       ",
        "       |.......*.......||...............|       ",
        "       |.......*.......||...............|       ",
        "       |...............||.......*.......|       ",
        "       |...............||.......*.......|       ",
        "       |.......*.......||...............|       ",
        "       |.......*.......||...............|       "
      ],
      "palettes": [ "highway_palette" ],
      "flags": [ "ERASE_ALL_BEFORE_PLACING_TERRAIN" ]
    }
  },
  {
    "om_terrain": [ [ "highway_ramp_down_0", "highway_ramp_down_1" ] ],
    "type": "mapgen",
    "object": {
      "fill_ter": "t_open_air",
      "rows": [
        "      '|...............||.......*.......|'      ",
        "      '|...............||.......*.......|'      ",
        "      '|.......*.......||...............|'      ",
        "      '|.......*.......||...............|'      ",
        "      '|...............||.......*.......|'      ",
        "      '|...............||.......*.......|'      ",
        "      '|.......*.......||...............|'      ",
        "      '|.......*.......||...............|'      ",
        "      '|...............||.......*.......|'      ",
        "      '|...............||.......*.......|'      ",
        "      '|‾‾‾‾‾‾‾‾‾‾‾‾‾‾‾||‾‾‾‾‾‾‾‾‾‾‾‾‾‾‾|'      ",
        "      '|>>>>>>>>>>>>>>>||>>>>>>>>>>>>>>>|'      ",
        "      ''''''''''''''''''''''''''''''''''''      ",
        "                                                ",
        "                                                ",
        "                                                ",
        "                                                ",
        "                                                ",
        "                                                ",
        "                                                ",
        "                                                ",
        "                                                ",
        "                                                ",
        "                                                "
      ],
      "palettes": [ "highway_palette" ],
      "flags": [ "ERASE_ALL_BEFORE_PLACING_TERRAIN" ]
    }
  },
  {
    "om_terrain": "hw_three_lane",
    "type": "mapgen",
    "object": {
      "rows": [
        ".......................|",
        ".......................|",
        ".......*.......*.......|",
        ".......*.......*.......|",
        ".......................|",
        ".......................|",
        ".......*.......*.......|",
        ".......*.......*.......|",
        ".......................|",
        ".......................|",
        ".......*.......*.......|",
        ".......*.......*.......|",
        ".......................|",
        ".......................|",
        ".......*.......*.......|",
        ".......*.......*.......|",
        ".......................|",
        ".......................|",
        ".......*.......*.......|",
        ".......*.......*.......|",
        ".......................|",
        ".......................|",
        ".......*.......*.......|",
        ".......*.......*.......|"
      ],
      "palettes": [ "highway_palette" ]
    }
  },
  {
    "om_terrain": [ [ "hw_three_lane_merge_w", "hw_three_lane_merge_e" ] ],
    "type": "mapgen",
    "object": {
      "fallback_predecessor_mapgen": "field",
      "rows": [
        "ggggggg................||.......*.......*ggggggg",
        "gggggg.................||.......*.......*.gggggg",
        "ggggg..*.......*.......||..................ggggg",
        "ggggg..*.......*.......||..................ggggg",
        "gggg...................||.......*.......*...gggg",
        "gggg...................||.......*.......*...gggg",
        "ggg....*.......*.......||....................ggg",
        "ggg....*.......*.......||....................ggg",
        "ggg....................||.......*.......*....ggg",
        "gg.....................||.......*.......*.....gg",
        "gg.....*.......*.......||.....................gg",
        "gg.....*.......*.......||.....................gg",
        "g......................||.......*.......*......g",
        "g......................||.......*.......*......g",
        "g......*.......*.......||......................g",
        "g......*.......*.......||......................g",
        ".......................||.......*.......*.......",
        ".......................||.......*.......*.......",
        ".......*.......*.......||.......................",
        ".......*.......*.......||.......................",
        ".......................||.......*.......*.......",
        ".......................||.......*.......*.......",
        ".......*.......*.......||.......................",
        ".......*.......*.......||......................."
      ],
      "palettes": [ "highway_palette" ],
      "flags": [ "ERASE_ALL_BEFORE_PLACING_TERRAIN" ]
    }
  }
]
