[
  {
    "type": "mapgen",
    "method": "json",
    "om_terrain": "afs_general_store_n1",
    "object": {
      "fill_ter": "t_metal_floor",
      "rows": [
        "                        ",
        "    /////               ",
        "   //nn.!               ",
        "   /l.'.!               ",
        "   /l.../   5           ",
        "  ///!!//=/////=/////   ",
        "  /.......nllll.nâââ//  ",
        "  /..'......'.....'..#  ",
        "  =.......néééé.nííí//  ",
        "  =.......nêêêê.näää/   ",
        "  /jjjjj....'.....'.=   ",
        "  /..'.J./áááá//+//+/   ",
        "  /nííí/+//////'./'./   ",
        "  //////..êé.3/n~/n~/   ",
        "  /.'.+..'êé'4///////   ",
        "  #.s./ä..êé...+'.<//   ",
        "  /2kk/ä......//////    ",
        "  /////ä...433/         ",
        "  °°°°//111////         ",
        "  °°°°°°°°°°°°°         ",
        "  °°°°°°°°°°°°°         ",
        "   °°°°°°°°°°°          ",
        "                        ",
        "                        "
      ],
      "palettes": [ "afs_habitat_structure", "afs_habitat_exterior", "afs_habitat_residential_furnishing", "afs_light_param_palette" ],
      "terrain": { "1": "t_door_metal_locked" },
      "//": "An Electronic safe would be prefered but the gunsafe furniture is hardcoded to say do you want to hack this gunsafe?",
      "furniture": {
        "5": "f_atm",
        "â": "f_bookcase",
        "á": "f_display_fridge",
        "ä": "f_rack",
        "é": "f_rack",
        "ê": "f_rack",
        "ë": "f_rack",
        "í": "f_rack",
        "s": "f_stool",
        "2": "f_e_safe_l",
        "3": "f_intermodal_crate_open",
        "4": "f_sealed_intermodal_crate"
      },
      "items": {
        "á": { "item": "afs_old_beverage_storage", "chance": 60, "repeat": [ 1, 5 ] },
        "â": { "item": "magazines", "chance": 80, "repeat": [ 1, 5 ] },
        "ä": { "item": "softdrugs", "chance": 80, "repeat": [ 1, 4 ] },
        "é": { "item": "consumer_electronics", "chance": 60, "repeat": [ 1, 3 ] },
        "ê": { "item": "afs_old_food_storage", "chance": 60, "repeat": [ 1, 2 ] },
        "ë": { "item": "tools_common_small", "chance": 70, "repeat": [ 1, 3 ] },
        "í": { "item": "afs_tools_structural_repair", "chance": 25, "repeat": [ 1, 2 ] },
        "2": { "item": "afs_cash_safe" },
        "4": { "item": "afs_crate_civ_rand" }
      },
      "place_loot": [ { "group": "afs_register_random", "x": [ 3, 6 ], "y": 10, "repeat": 1 } ],
      "place_monster": [ { "group": "AFS_GROUP_RUIN_MOXIE", "x": [ 0, 23 ], "y": [ 0, 23 ], "pack_size": [ 1, 3 ], "chance": 20 } ],
      "place_nested": [ { "chunks": [ { "param": "lightstatus", "fallback": "null" } ], "x": 0, "y": 0 } ]
    }
  },
  {
    "type": "mapgen",
    "method": "json",
    "om_terrain": "afs_general_store_n2",
    "object": {
      "fill_ter": "t_metal_floor",
      "rows": [
        "                        ",
        "    ££££££              ",
        "   £££££££              ",
        "   £££££££              ",
        "   £££££££              ",
        "  £££££££££££££££££££   ",
        "  ££//=////==///==//££  ",
        "  £//kk/á..h.h..vqq//£  ",
        "  £/S.h/á..yyy.....2/£  ",
        "  £/y'.+...yyy...'.U=   ",
        "  £/S.W/...h.h./Fojj/   ",
        "  £/////ch..'..//////   ",
        "  £/y.W/.11111..+'~/£   ",
        "  £/S'.+.1sss1.l/❹❸/£   ",
        "  £/..h/.11111.//////   ",
        "  £//kk/..eee..+'.>//   ",
        "  ££//=//!//////////    ",
        "  £££££/.'❺❶/££         ",
        "      ££//#//££         ",
        "                        ",
        "                        ",
        "                        ",
        "                        ",
        "                        "
      ],
      "palettes": [
        "parametrized_carpets_palette",
        "afs_habitat_structure",
        "afs_habitat_residential_furnishing",
        "afs_habitat_life_support",
        "afs_habitat_exterior",
        "afs_light_param_palette"
      ],
      "terrain": { " ": "t_open_air", "1": { "param": "carpet_color_type", "fallback": "t_carpet_red" } },
      "furniture": { "2": "f_dishwasher", "á": "f_bookcase" },
      "place_item": [ { "item": "television", "repeat": 1, "x": 11, "y": 15 } ],
      "items": { "á": { "item": "homebooks", "repeat": [ 2, 3 ] }, "q": { "item": "afs_old_food_storage", "chance": 60 } },
      "place_nested": [ { "chunks": [ { "param": "lightstatus", "fallback": "null" } ], "x": 0, "y": 0 } ]
    }
  },
  {
    "type": "mapgen",
    "method": "json",
    "om_terrain": "afs_general_store_n3",
    "object": {
      "fill_ter": "t_flat_roof",
      "rows": [
        "                        ",
        "                        ",
        "                        ",
        "                        ",
        "                        ",
        "                        ",
        "    ................    ",
        "   ...................  ",
        "   ........&&.........  ",
        "   ...................  ",
        "   ...................  ",
        "   ..................   ",
        "   ...A..............   ",
        "   ...A==.......X.....  ",
        "   ...................  ",
        "   ..................   ",
        "    ................    ",
        "        ......          ",
        "        ......          ",
        "                        ",
        "                        ",
        "                        ",
        "                        ",
        "                        "
      ],
      "palettes": [ "roof_palette" ]
    }
  }
]
