[
  {
    "type": "mapgen",
    "method": "json",
    "om_terrain": [ [ "afs_shuttle_pad_a1", "afs_shuttle_pad_a2" ] ],
    "object": {
      "fill_ter": "t_metal_floor",
      "rows": [
        "                                                ",
        " ññññññññññññññññññññññññññññññññññññ////////// ",
        " ñ                                  //E&qq/v.h/ ",
        " ñ   $$$$$ $$$$   $$$$ $$  $$$$$$$$ #..,ö.+.kk/ ",
        " ñ  $$''''''''''''''''''''''''''''$$//&.qq/.,./ ",
        " ñ  $''''''   '''' '   '''''' ' '''$ //+////+// ",
        " ñ  $'''''' '' '''   ''''  '''  '''$ =.,../..l/ ",
        " ñ   '''$$''   ''''$$'''''  ''$$'''  =ccc./,.l/ ",
        " ñ  $'''$''' '''''''' '''''  ''$'''  /===//!/// ",
        " ñ  $'''   ''' ''  ''    ''' ''''''$      /./ ñ ",
        " ñ  $'''' '''''  ''''''''''''''''''$'' '''/!/ ñ ",
        " ñ  $''    '''  '''$$''' '''   ''''$''' '' '' ñ ",
        " ñ  $'    '''    ''$$''   '''  ''''$''  ''''' ñ ",
        " ñ  $'''''''''  ' ''''''''''''  '  $'''''' '  ñ ",
        " ñ   ''''  ''''' ''''''    ''  '''      '' '  ñ ",
        " ñ   '''$'  '  '''''''''  '''''$'''$      ''  ñ ",
        " ñ   '''$$'''''  ''$$''''''' '$$'''$ ''' '''  ñ ",
        " ñ  $''''' ''''' ''' ''  ''' '' '''  '' '' '  ñ ",
        " ñ  $'''''   ''''''  ''    ''   '''$ '''''''  ñ ",
        " ñ  $$''''' ''''' '' ''' '''' ''''$$ '''  ''  ñ ",
        " ñ   $$$$   $$$$$   $$$$$$$ $$$$$$$       ''  ñ ",
        " ñ                                       '''  ñ ",
        " ññññññññññññññññññññññññññññññññññññññññ'''ñññ ",
        "                                                "
      ],
      "palettes": [ "afs_habitat_structure", "afs_habitat_mech_furnishing" ],
      "terrain": { "'": "t_thconc_floor_no_roof", "$": "t_sidewalk", "ñ": "t_chainfence", ",": "t_metal_floor_olight_inactive" },
      "furniture": { "&": "f_sealed_intermodal_crate", "e": "f_intermodal_crate_open" },
      "items": { "&": [ { "item": "afs_crate_civ_rand" } ] },
      "monster": { "ö": { "monster": "mon_skitterbot" } },
      "place_monster": [ { "group": "AFS_GROUP_RUIN_MOXIE", "x": [ 2, 22 ], "y": [ 2, 22 ], "pack_size": [ 1, 2 ], "chance": 50 } ],
      "place_nested": [ { "chunks": [ [ "null", 80 ], [ "afs_map_lights_on", 20 ] ], "x": 24, "y": 0 } ]
    }
  },
  {
    "type": "mapgen",
    "method": "json",
    "om_terrain": [ [ "afs_shuttle_pad_a1_roof", "afs_shuttle_pad_a2_roof" ] ],
    "object": {
      "fill_ter": "t_flat_roof",
      "rows": [
        "                                                ",
        "                                     .......... ",
        "                                    ........X.. ",
        "                                    ....&&..... ",
        "                                    ........... ",
        "                                     ..A....... ",
        "                                     ..A=...... ",
        "                                     .......... ",
        "                                     .......... ",
        "                                          ...   ",
        "                                          ...   ",
        "                                          ...   ",
        "                                                ",
        "                                                ",
        "                                                ",
        "                                                ",
        "                                                ",
        "                                                ",
        "                                                ",
        "                                                ",
        "                                                ",
        "                                                ",
        "                                                ",
        "                                                "
      ],
      "palettes": [ "roof_palette" ]
    }
  }
]
