[
  {
    "type": "mapgen",
    "method": "json",
    "om_terrain": "lake_cabin_boathouse",
    "weight": 25000,
    "object": {
      "fill_ter": "t_region_groundcover",
      "rows": [
        "~~~~~~~--||||||||||...9.",
        "~~~~~~--dddddd|b  |.9...",
        "~~~~~~~~~~~~~d|b r|...9.",
        "~~~~~~~~~~~~~d   r|9....",
        "~~~~~~~~~~~~~d   r|...9.",
        "~~~~~~~~~~~~~d|b  0.....",
        "~-dddddddddddd|b  |...9.",
        "--.......|||||||+||.9...",
        "--.............///......",
        "...............///...9..",
        "...............//.9.....",
        "..............//....9...",
        ".............//...9..9..",
        "............//.9........",
        "...........//...x|***|.9",
        "...........////.t*#t#|..",
        "...........//////...M|..",
        "...........///...*JUU|.9",
        "..........//..9..|***|..",
        ".........//.............",
        "........//.....9..9...9.",
        "........//..9...........",
        ".////..//.9.......9.9...",
        "//..////......9........."
      ],
      "place_vehicles": [
        { "vehicle": "boat_motor_single", "x": 12, "y": 5, "rotation": 180, "chance": 10 },
        { "vehicle": "kayak_racing", "x": 11, "y": 2, "rotation": 180, "chance": 30 },
        { "vehicle": "canoe", "x": 2, "y": 5, "rotation": 180, "chance": 80 }
      ],
      "place_loot": [ { "item": "rope_30", "x": 12, "y": 6, "chance": 50 }, { "item": "stepladder", "x": 17, "y": 1, "chance": 50 } ],
      "terrain": {
        " ": "t_floor",
        "b": "t_floor",
        "r": "t_floor",
        "*": "t_wall_log_half",
        "d": "t_dock",
        "/": "t_region_soil",
        "M": "t_region_soil",
        "U": "t_region_soil",
        "~": "t_water_dp",
        "-": "t_water_sh",
        ".": [ [ "t_region_groundcover", 36 ], "t_region_shrub" ],
        "|": "t_wall_log",
        "0": "t_window_domestic",
        "+": "t_door_c",
        "9": [ [ "t_region_tree", 2 ], [ "t_region_groundcover", 5 ] ]
      },
      "furniture": {
        "r": "f_rack",
        "b": "f_bench",
        "U": "f_bench",
        "#": "f_smoking_rack",
        "t": "f_table",
        "x": "f_metal_butcher_rack",
        "J": "f_kiln_empty"
      },
      "items": {
        "r": { "item": "fishing_items", "chance": 90, "repeat": [ 2, 4 ] },
        "b": { "item": "fishing_items", "chance": 30, "repeat": [ 2, 4 ] },
        "d": { "item": "fishing_items", "chance": 5, "repeat": [ 1, 2 ] },
        "M": { "item": "stash_wood", "chance": 50, "repeat": [ 6, 10 ] }
      },
      "place_monsters": [ { "monster": "GROUP_ZOMBIE", "x": [ 10, 22 ], "y": [ 15, 22 ], "density": 0.1 } ]
    }
  }
]
