[
  {
    "type": "mapgen",
    "method": "json",
    "om_terrain": [ "s_garage" ],
    "weight": 100000,
    "object": {
      "fill_ter": "t_thconc_floor",
      "rows": [
        "     EEEEEE    EEEEEE   ",
        "     EEEEEE    EEEEEE   ",
        "     EEEEEE    EEEEEE   ",
        "     EEEEEE    EEEEEE   ",
        "    eEEEEEE   eEEEEEEEEE",
        " ----======----======--E",
        " |S.eM#MM#M...eM#MM#M.|E",
        " |S..M#MM#M....M#MM#M.|E",
        " |c..M#MM#M....M#MM#M.|E",
        " |c..M#MM#M....M#MM#M.|E",
        " |c..M#MM#M....M#MM#M.|E",
        " |c..M#MM#M....M#MM#M.|E",
        " |K..MMMMMMMMMMMMMMMM.|E",
        " |m...................|E",
        " |---l...........HHHHH|E",
        " |ts|c...........HLLLL|E",
        " |-+|p...........Hbbbb|E",
        "4|...............$....+E",
        " |^W|............Hhbbb|E",
        " |xx|cccccSScccccH6LLL|E",
        " |----::::--::::------|E",
        "                  EU<UEE",
        "                  EUEEEE",
        "                        "
      ],
      "terrain": {
        " ": [ [ "t_region_groundcover_urban", 10 ], "t_region_shrub" ],
        "E": "t_pavement",
        "U": "t_pavement",
        "$": "t_door_glass_c",
        "+": "t_door_c",
        "-": "t_brick_wall",
        ".": "t_thconc_floor",
        ":": "t_window",
        "=": "t_door_metal_locked",
        "A": "t_m_frame",
        "H": "t_wall_glass",
        "e": "t_gates_mech_control",
        "|": "t_brick_wall",
        "W": "t_chainfence",
        "^": "t_chaingate_c",
        "M": "t_metal_floor",
        "#": "t_grate",
        "4": "t_gutter_downspout",
        "<": "t_ladder_up"
      },
      "furniture": {
        "6": "f_console_broken",
        "A": "f_air_conditioner",
        "L": "f_locker",
        "b": "f_bench",
        "c": "f_counter",
        "s": "f_sink",
        "S": "f_utility_shelf",
        "m": "f_manual_tire_changer",
        "p": "f_hydraulic_press",
        "l": "f_heavy_lathe",
        "K": "f_beverly_shear",
        "t": "f_toilet",
        "x": "f_utility_shelf",
        "h": "f_chair",
        "U": [ "f_dumpster", "f_recycle_bin" ]
      },
      "items": {
        "L": { "item": "clothing_work_set", "chance": 25 },
        "c": { "item": "mechanics", "chance": 20 },
        "S": { "item": "mechanics", "chance": 20, "repeat": [ 1, 6 ] },
        "x": { "item": "SUS_welding_gear", "chance": 20, "repeat": [ 1, 2 ] }
      },
      "place_vehicles": [
        { "vehicle": "garage", "x": [ 8, 8 ], "y": [ 9, 10 ], "chance": 25, "rotation": 90 },
        { "vehicle": "garage", "x": [ 18, 18 ], "y": [ 9, 10 ], "chance": 25, "rotation": 90 }
      ],
      "place_monsters": [ { "monster": "GROUP_FERROUS", "x": [ 5, 20 ], "y": [ 7, 15 ], "chance": 10 } ]
    }
  },
  {
    "type": "mapgen",
    "method": "json",
    "om_terrain": [ "s_garage_1" ],
    "weight": 100000,
    "object": {
      "fill_ter": "t_floor",
      "rows": [
        "   ~~~~~~       ~~~~~~  ",
        "    ~~~~~~    * ~~~~~~  ",
        "    ~~~~~~      ~~~~~~  ",
        "    ~~~~~~ *   ~~~~~~  *",
        "  *  ~~~~~~    ~~~~~~   ",
        " WWWW~~~~~~WWWW~~~~~~WW ",
        " Wz  ~~~~~~ *  ~~~~~~ W ",
        " W*  ~~~~~~    ~~~~~~ W ",
        " W  z~~~~~~  * ~~~~~~ W ",
        " W z  ~~~~~~   ~~~~~~ W ",
        " W  * ~~~~~~   ~~~~~~ W ",
        " W    ~~~~~~  ~~~~~~  W ",
        " W J  ~~~~~~  ~~~~~~ *W ",
        " ^______~~~~~~~~~~~ zzW ",
        " wwwwww_~~~~~~~~~w6dwww ",
        " wxxxPw_~~~~~~~~~wdhLLw ",
        " wSx..w_~~~~~~~~_wd..Lw ",
        " wS..xD_~~~~~~~~_+....+ ",
        " wS.x.w_~~~~~~~~_ww+www ",
        " wccccw4________4ws..tw ",
        " wwwwwwUUUUUUUUUUwwwwww ",
        "                        ",
        "                        ",
        "                        "
      ],
      "terrain": {
        " ": "t_region_groundcover",
        "~": [ "t_region_groundcover_barren", [ "t_pavement", 6 ] ],
        "_": [ "t_region_groundcover_barren", [ "t_sidewalk", 6 ] ],
        "*": [ [ "t_region_tree_shade", 3 ], "t_region_shrub" ],
        "J": "t_water_pump",
        "D": "t_door_locked",
        "+": "t_door_c",
        "w": "t_wall_log",
        "U": "t_brick_wall",
        ".": "t_floor",
        ":": "t_window",
        "W": "t_chainfence",
        "^": "t_chaingate_c",
        "z": "t_region_groundcover_barren",
        "4": "t_gutter_downspout"
      },
      "furniture": {
        "6": "f_console_broken",
        "L": "f_locker",
        "c": "f_counter",
        "s": "f_sink",
        "S": "f_utility_shelf",
        "t": "f_toilet",
        "x": "f_crate_c",
        "h": "f_chair",
        "P": "f_hydraulic_press",
        "d": "f_desk",
        "z": [ "f_wreckage", "f_toilet", "f_dumpster", "f_sink" ]
      },
      "items": {
        "L": { "item": "clothing_work_set", "chance": 25 },
        "c": { "item": "mechanics", "chance": 20 },
        "S": { "item": "mechanics", "chance": 20, "repeat": [ 1, 6 ] },
        "x": { "item": "mechanics", "chance": 20, "repeat": [ 1, 3 ] }
      },
      "place_vehicles": [
        { "vehicle": "garage", "x": [ 8, 8 ], "y": [ 9, 10 ], "chance": 25, "rotation": 90 },
        { "vehicle": "garage", "x": [ 18, 18 ], "y": [ 9, 10 ], "chance": 25, "rotation": 90 }
      ]
    }
  },
  {
    "type": "mapgen",
    "method": "json",
    "om_terrain": [ "s_garage_2" ],
    "weight": 100000,
    "object": {
      "fill_ter": "t_thconc_floor",
      "rows": [
        "    EEEEEE      XXX     ",
        "    EEEEEE      XXX     ",
        "    EEEEEE      XXX     ",
        "    EEEEEE      XXX     ",
        "   eEEEEEEXXXXXXXXXXXXXX",
        " ---======-----HHOHH---X",
        " |.eM#MM#M..|y.......y|X",
        " |..M#MM#M..|b........|X",
        " :..M#MM#M..:b..|-ddd-|X",
        " :..M#MM#M..:b..|f.h.y|X",
        " A..M#MM#M..:b..|--.--|X",
        " |..M#MM#M..+...+...hd|X",
        " |..MMMMMM..|-+-|f6ddd|X",
        " |m.........|&.s|-----|X",
        " |---....---|---|LLLLL|X",
        " |..............|bbbbb|X",
        " |WWWW..WWWW|...+.....|X",
        " |c........c|-------+-|X",
        " |c.xx..xx.p|xx.+T|<..OX",
        " |l.xx..xx.c|x..-|----|X",
        " |w.........O..xx|4UUXXX",
        " |ScccccccwS|----|UXXXXX",
        " |----------|WWWWWWWWWWW",
        "                        "
      ],
      "terrain": {
        " ": "t_region_groundcover_urban",
        "E": "t_pavement",
        "X": "t_sidewalk",
        "U": "t_sidewalk",
        "$": "t_door_glass_c",
        "+": "t_door_c",
        "O": "t_door_locked",
        "-": "t_wall_b",
        ".": "t_thconc_floor",
        ":": "t_window",
        "=": "t_door_metal_locked",
        "A": "t_m_frame",
        "H": "t_wall_glass",
        "e": "t_gates_mech_control",
        "|": "t_wall_b",
        "W": "t_chainfence_h",
        "^": "t_chaingate_c",
        "M": "t_metal_floor",
        "#": "t_grate",
        "4": "t_gutter_downspout",
        "<": "t_stairs_up"
      },
      "toilets": { "&": {  } },
      "furniture": {
        "6": "f_console_broken",
        "A": "f_air_conditioner",
        "L": "f_locker",
        "T": "f_rack",
        "b": "f_bench",
        "d": "f_desk",
        "c": "f_counter",
        "p": "f_hydraulic_press",
        "l": "f_heavy_lathe",
        "m": "f_manual_tire_changer",
        "S": "f_utility_shelf",
        "s": "f_sink",
        "t": "f_toilet",
        "w": "f_utility_shelf",
        "x": "f_crate_c",
        "f": "f_filing_cabinet",
        "h": "f_chair",
        "U": [ "f_dumpster", "f_recycle_bin" ],
        "y": [ "f_indoor_plant", "f_indoor_plant_y" ]
      },
      "items": {
        "L": { "item": "clothing_work_set", "chance": 25 },
        "c": { "item": "mechanics", "chance": 20 },
        "S": { "item": "mechanics", "chance": 20, "repeat": [ 1, 6 ] },
        "x": { "item": "mechanics", "chance": 20, "repeat": [ 1, 6 ] },
        "w": { "item": "SUS_welding_gear", "chance": 20, "repeat": [ 1, 2 ] },
        "f": { "item": "office", "chance": 70, "repeat": [ 1, 6 ] },
        "d": { "item": "office", "chance": 70, "repeat": [ 1, 6 ] },
        "T": { "item": "cleaning", "chance": 70, "repeat": [ 1, 6 ] }
      },
      "place_vehicles": [ { "vehicle": "garage", "x": [ 8, 8 ], "y": [ 9, 10 ], "chance": 25, "rotation": 90 } ]
    }
  }
]
