[
  {
    "method": "json",
    "om_terrain": "house_24",
    "//": "normal variant",
    "type": "mapgen",
    "weight": 10000,
    "object": {
      "fill_ter": "t_floor",
      "rows": [
        "...``````..p............",
        "...``````....%.%%.%.%%..",
        "...````````##ooo##ooo##.",
        "..%````````#c  y  hhh #.",
        "...````````*      fff o.",
        "...``````!!# rr   hhhT#.",
        ".%.``````!%#||||+|||||#.",
        "...``````.##23F| |@@sd#.",
        "...``````%#1   | |@@  #.",
        ".%.``````.o5     |E   o.",
        "...``````%#O  7| +  h o.",
        "...``````.#J  4| |yDII#.",
        "..#~~~~~~##|| || |||||#.",
        "..#~~~~~~#TE     | bdy#.",
        "..#~~~~~~#x  H   +    o.",
        "..#~~~~~~#x lH   |    o.",
        "..#~~~~~Y#x  H   |@@ E#.",
        "..#U~~~~Y#     hr|@@ D#.",
        "..#U~~~~~*      r|||||#.",
        ".^#~A~~~~#       +---B#^",
        "..#NNNqq~#RyHHHsR|t8SB#.",
        "..##########ooo########.",
        "...........!!!!!........",
        "........................"
      ],
      "palettes": [ "standard_domestic_palette" ],
      "terrain": {
        "%": [ "t_region_shrub", "t_region_shrub_fruit", "t_region_shrub_decorative" ],
        "[": [ [ "t_region_tree_fruit", 2 ], [ "t_region_tree_nut", 2 ], "t_region_tree_shade" ],
        "!": "t_region_groundcover_urban",
        "`": "t_concrete",
        "#": "t_adobe_brick_wall",
        "-": "t_linoleum_white",
        "Q": "t_linoleum_white",
        "8": "t_linoleum_white",
        "B": "t_linoleum_white",
        "S": "t_linoleum_white",
        "t": "t_linoleum_white",
        "N": "t_thconc_floor",
        "Y": "t_thconc_floor",
        "U": "t_thconc_floor",
        "q": "t_thconc_floor",
        "A": "t_thconc_floor",
        "~": "t_thconc_floor"
      },
      "furniture": { "!": "f_region_flower" },
      "place_item": [ { "item": "stereo", "x": 15, "y": 20, "chance": 50 }, { "item": "television", "x": 10, "y": 15, "chance": 50 } ]
    }
  }
]
