[
  {
    "method": "json",
    "om_terrain": "house_23",
    "//": "normal variant",
    "type": "mapgen",
    "weight": 10000,
    "object": {
      "fill_ter": "t_floor",
      "rows": [
        "......[.......p.........",
        "...........[...`........",
        "````````````````........",
        "`%..!!.jj.!!...`........",
        "`.##oo####oo#$$=$##o##..",
        "`.#T    s   #G  y#123#..",
        "`%#H    H   ###*o#J 4#..",
        "`.oH l  H    E|  |J O#..",
        "`.oH    H    s|  |J fo..",
        "`.#          E|  |J no..",
        "`.#yxxx             7#..",
        "`.#|||| hhh         Y#..",
        "`.#S--+ fff         6#..",
        "`.#98t| hhh Ty RR  Y6#..",
        "`.#####*###|||+||+|||#..",
        "`......``^#db  T|  dD#^.",
        "`````````!o    I|    o..",
        ".........!o@@ hI|   yo..",
        ".........!o@@   |@  Eo..",
        "..........#s  ED|@I T#..",
        "..........##ooo###oo##..",
        "...........%%%...%.%.%..",
        "...............[........",
        "........................"
      ],
      "palettes": [ "standard_domestic_palette" ],
      "terrain": {
        "%": [ "t_region_shrub", "t_region_shrub_fruit", "t_region_shrub_decorative" ],
        "[": [ [ "t_region_tree_fruit", 2 ], [ "t_region_tree_nut", 2 ], "t_region_tree_shade" ],
        "!": "t_region_groundcover_urban",
        "`": "t_concrete",
        "#": "t_rock_wall",
        "-": "t_linoleum_white",
        "Q": "t_linoleum_white",
        "8": "t_linoleum_white",
        "B": "t_linoleum_white",
        "S": "t_linoleum_white",
        "t": "t_linoleum_white",
        "$": "t_screened_porch_wall",
        "=": "t_screen_door_c"
      },
      "furniture": { "!": "f_region_flower" },
      "place_item": [ { "item": "stereo", "x": 4, "y": 10, "chance": 50 }, { "item": "television", "x": 5, "y": 10, "chance": 50 } ],
      "place_nested": [
        {
          "chunks": [
            [ "roof_6x6_garden_4", 15 ],
            [ "roof_6x6_garden_1", 15 ],
            [ "greenhouse_6x6_herbal", 15 ],
            [ "greenhouse_6x6_vegetable", 15 ],
            [ "pond_6x6", 15 ],
            [ "shed_6x6_junk", 15 ],
            [ "shed_6x6_woodworker", 15 ],
            [ "playset_4x4_2", 15 ],
            [ "firepit_5x5_1", 15 ],
            [ "firepit_5x5_2", 15 ],
            [ "playset_4x4_1", 15 ]
          ],
          "x": 1,
          "y": 17
        }
      ]
    }
  }
]
