[
  {
    "type": "mapgen",
    "method": "json",
    "om_terrain": [ [ "lumbermill_0_0", "lumbermill_1_0" ], [ "lumbermill_0_1", "lumbermill_1_1" ] ],
    "weight": 100000,
    "object": {
      "fill_ter": "t_thconc_floor",
      "rows": [
        "vvvvvvvvvvvvvvvvvvv  ______  vvvvvvvvvvvvvvvvvvv",
        "v  *         *      *______ *      2      *    v",
        "v      *       2     ______   7               2v",
        "v                    ______         *   2      v",
        "v*2      7 *    *    ______     *            * v",
        "v *###ww####ww### * ________  *   ##ww#ww##    v",
        "v  #xxxx..x.xxxx#   __________    w.c...c.w   *v",
        "v  #xx,,,,,,..xx#  _______________#ddX.Xdd#*   v",
        "v* wx,=======@.xw  _______________+......i#  * v",
        "v  w.,=,,,T,...xw* _______________#......&#    v",
        "v  #x,=,,......x#   _________ 2 * #ddX.Xdd#7   v",
        "v 2#x,=M,.C....x# * _________     w.c....cw   *v",
        "v *#.,=,,.Cr..xx#   __________*   #########    v",
        "v  #.,=P,.Rr..xx# 2 __________  *     *     *  V",
        "v  #x,=,,.Cr..x6#6 *__________  2############# v",
        "v *#x,=J,.C.....;________________#&.bb.bb.C.f# v",
        "v  #.,=,,.......;________________+..nn.nn.C.f#*v",
        "v* wx,=,,,B,....;________________#..bb.bb.C.D# v",
        "v  wx,=======O..;_____________   #..........F#7v",
        "v  #xx,,,,,,....;_____________  *#....nc###### v",
        "v 7#xx.....x..xx#  __________ *  wbnb.nc#S.+t#*v",
        "#######+#########7 __________   2wbnb...+..### v",
        "#$.$#ll.ll#b.w    *___________   #......#S.+t#*v",
        "#$.$#.....#b.#__________________*###ww######## v",
        "#$..+.bbb.+..+___________________________   *  v",
        "#$.$#.....#b.#______________________________  *v",
        "#$.$#lllll#b.w   _____________________________ v",
        "##############   _____________________________ v",
        "v 2              ______________________________v",
        "v    1111 11111  ______________________________v",
        "v   *          * ______________________________v",
        "v  1111 11111    ______________________________v",
        "v               _______________________________v",
        "v 111111 11111  _______________________________v",
        "v *             ________________________________",
        "v  111111 111  _________________________________",
        "v        2    __________________________________",
        "v vvvvv    *___________________________1 1  ____",
        "v vooov______________________   ____ 121   1   v",
        "v voGoV_____________ #.......#  ____ 1 1*1 1 1 v",
        "v vooov_________     #L.....L#* ____*  1 1 1 2 v",
        "v vvvvv   ______  * *wL.....Lw   ____1 1 1 1  *v",
        "v         1____ 2    #L.....L# * ____1 1*  1   v",
        "v 1111111 1____    7 wx....xxw   ____       *  v",
        "v1         ____*     #xx.x.xx#   ____ *111111  v",
        "v1 1111111____    2  #########*   ____   2   7 v",
        "v1   2    ____      *    2        ____    *   *v",
        "vvvvvvvvvv____vvvvvvvvvvvvvvvvvvvv____vvvvvvvvvv"
      ],
      "palettes": [ "lumberyard" ],
      "gaspumps": { "G": { "fuel": "gasoline", "amount": [ 0, 5000 ] } },
      "place_vehicles": [
        { "vehicle": "flatbed_truck", "x": [ 43, 45 ], "y": 33, "chance": 30, "rotation": 90 },
        { "vehicle": "pickup", "x": [ 35, 37 ], "y": [ 28, 31 ], "chance": 30, "rotation": 90 },
        { "vehicle": "car", "x": [ 29, 31 ], "y": [ 27, 30 ], "chance": 30, "rotation": 90 }
      ]
    }
  }
]
