[
  {
    "type": "mapgen",
    "method": "json",
    "om_terrain": [ "outpost" ],
    "weight": 100,
    "object": {
      "rows": [
        ".L.....................L",
        ".###+###.###+###.###+###",
        ".#@@ @@#.#R  hT#.#@@ @@#",
        ".#t   t#.#R  hT#.#t   t#",
        ".#@@ @@#.#R   Y#.#@@ @@#",
        ".#t   t#.#R  hT#.#t   t#",
        ".#@@ @@#.#R  hT#.#@@ @@#",
        ".#t   t#.#R  hT#.#t   t#",
        ".#@@ @@#.#R  hT#.#@@ @@#",
        ".#t   t#.#R   Y#.#t   t#",
        ".#t@ @@#.#R  hT#.#@@ @@#",
        ".#t   t#.#H  hT#.#t   t#",
        ".#@@ @@#.#H  hT#.#@@ @@#",
        ".#t   t#.#H  hT#.#t   t#",
        ".#@@ @@#.#H   Y#.#@@ @@#",
        ".#t   t#.#H  hT#.#t   t#",
        ".#@@ @@#.#H  hT#.#@@ @@#",
        ".#t   t#.#H  ###.#t   t#",
        ".#@@ @@#.#H  *&#.#@@ @@#",
        ".#t   t#.#H  ###.#t   t#",
        ".#@@ @@#.#H  *&#.#@@ @@#",
        ".###+###.###+###.###+###",
        ".L.....................L",
        "........................"
      ],
      "fill_ter": "t_thconc_floor",
      "terrain": {
        ".": "t_region_groundcover",
        "#": "t_wall_metal_corrugated",
        "L": "t_region_groundcover",
        "+": [ "t_door_metal_corrugated_o", "t_door_metal_corrugated_c" ],
        "*": "t_door_c"
      },
      "furniture": { "t": "f_locker", "R": "f_rack", "r": "f_rack", "@": "f_bunkbed", "h": "f_chair", "T": "f_table", "Y": "f_trashcan" },
      "items": {
        "@": { "item": "army_bed", "chance": 60, "repeat": [ 1, 4 ] },
        "T": { "item": "dining", "chance": 50 },
        "H": { "item": "milspec_arsenal_weapon&ammo_collection", "chance": 40, "repeat": [ 1, 4 ] },
        "R": { "item": "mil_food", "chance": 70, "repeat": [ 1, 4 ] },
        "t": { "item": "mil_armor", "chance": 65, "repeat": [ 1, 2 ] },
        "Y": { "item": "SUS_trash_trashcan", "chance": 50 },
        "&": { "item": "SUS_toilet", "chance": 50 }
      },
      "toilets": { "&": {  } },
      "place_monster": [
        { "monster": "mon_crows_m240", "x": 4, "y": 11 },
        { "monster": "mon_turret_bmg", "x": 4, "y": 12 },
        { "monster": "mon_crows_m240", "x": 20, "y": 11 },
        { "monster": "mon_turret_bmg", "x": 20, "y": 12 },
        { "monster": "mon_crows_m240", "x": 12, "y": 10 },
        { "monster": "mon_turret_bmg", "x": 11, "y": 10 }
      ],
      "monster": {
        "L": { "monster": "mon_turret_searchlight", "chance": 100 },
        ".": [
          { "monster": "mon_zombie_soldier", "chance": 1 },
          { "monster": "mon_zombie_bio_op", "chance": 1 },
          { "monster": "mon_dispatch", "chance": 1 },
          { "monster": "mon_dispatch_military", "chance": 1 },
          { "monster": "mon_secubot", "chance": 5 },
          { "monster": "mon_zombie_flamer", "chance": 1 }
        ],
        " ": { "group": "GROUP_MIL_BASE", "chance": 10 }
      }
    }
  },
  {
    "type": "mapgen",
    "method": "json",
    "om_terrain": "outpost_roof",
    "object": {
      "fill_ter": "t_flat_roof",
      "rows": [
        "                        ",
        " ....... ....... .......",
        " ....... ....... .......",
        " ....... ....... .......",
        " ....... ....... .......",
        " ....... ....... .......",
        " ....... ....... .......",
        " ....... ....... .......",
        " ....... ....... .......",
        " ....... ....... .......",
        " ....... ....... .......",
        " ....... ....... .......",
        " ....... ....... .......",
        " ....... ....... .......",
        " ....... ....... .......",
        " ....... ....... .......",
        " ....... ....... .......",
        " ....... ....... .......",
        " ....... ....... .......",
        " ....... ....... .......",
        " ....... ....... .......",
        " ....... ....... .......",
        "                        ",
        "                        "
      ],
      "palettes": [ "roof_palette" ],
      "terrain": { ".": "t_metal_roof" }
    }
  }
]
