[
  {
    "type": "mapgen",
    "method": "json",
    "om_terrain": [
      [ "sewage_treatment_0_0_-1", "sewage_treatment_1_0_-1", "sewage_treatment_2_0_-1" ],
      [ "sewage_treatment_0_1_-1", "sewage_treatment_1_1_-1", "sewage_treatment_2_1_-1" ]
    ],
    "weight": 25000,
    "object": {
      "fill_ter": "t_dirt",
      "rows": [
        "   ||||||||||||||||||||||||||||||2x~~x2||||||||||||||||||||||||||||||   ",
        "   |~~~~~~~~~~~~~~~~~~~~~~~~~~~~~~#~~#~~~~~~~~~~~~~~~~~~~~~~~~~~~~~~|   ",
        "   |~###########################~~#~~#~~###########################~|   ",
        "   |~#222222222|||b||||||||||||##########|||||||||b|||222222222222#~|   ",
        "   |~#2|||||||22&....U|       ||||||||||||    |U....&22||||||||||2#~|   ",
        "   |~#2|     |||$&$&@&|  |||||||||||||||||||  |&@&$&$|||        |2#~|   ",
        "   |~#2||      ||||||||  |0001[.I|D6[[D61.I|  ||||||||         ||2#~|   ",
        "   |~#22|                |0c....f|.c...c..f|||||L|             |22#~|   ",
        "||||`##2|                |h......+.........+...+.|             |2##`||||",
        "2222! #2|||||  ||||      |0c....f|.c...c..f||..|L|         |||||2#|!2222",
        "xxxx#xx2~~~~|| |L.|      |0001[.I|D6[[D61.I||..|||||||||||||~~~~2xx#xxxx",
        "~~~~~~x2~~~~~| ||+||||||||||||||||||||||||||>..+..&TTT&ww||~~~~~2x~~~~~~",
        "~~~~~~x2~~~~~| |...............................|........w||~~~~~2x~~~~~~",
        "xxxxx#xx~~~~|| |...............................|&...8...&|||~~~~xx#xxxxx",
        "22222~#2|||||  ||+||||+|||..|||||||||||||||||..|$#######$| |||||2#~22222",
        "|||||~#2|      |n..l|n..l|..|  |If6666;f|   |..|@...@...@|     |2#~|||||",
        "    |~#2|      ||+||||+|||..||||........|||||..|#...#...#|     |2#~|    ",
        "    |~#2|      |q..q|q..q|.....+........+......|$&$&@&$&$|     |2#~|    ",
        "    |~#2|      |q..q|q..q|..||||c......c|||||..|||||||||||     |2#~|    ",
        "    |~#2|      |||||||||||..|  |6tttttt6|   |..|               |2#~|    ",
        "    |~#2|                |..| ||--------||  |..|               |2#~|    ",
        "    |~#2|                |..| |#vvvvvvvv2|  |..|               |2#~|    ",
        "    |~#2|                |..| |#a~~~~~~~2|  |..|               |2#~|    ",
        "    |~#2|                |..| |#a~~~~~~~2||||bb||              |2#~|    ",
        "    |~#2|       ||||||||||..|||b|~~~~~~|22222..2||             |2#~|    ",
        "    |~#2|  ||||||ww.............b##~~~|||||||..22|||||||||||||||2#~|    ",
        "    |~#2|  |{{{{Hw...||||||||||||!*!!!||||| |...22222222222222222#`|    ",
        "    |`#2|  |....C...^|      ||~~~`````~~~~|||....................#!|    ",
        "    |!#2|  |{{{{H....|     ||~~~~~~~~~~~~~~|||...............{{||#~|    ",
        "    |~##|||||||||||b||||||||~~~~~~~~~~~~~~~~||b|||||||||||||||||##~|    ",
        "    |~~############x~~~~~~~~~~~~~~~~~~~~~~~~~~x##################~~|    ",
        "    |~~~~~~~~~~~~~~x~~~~~~~~~~~~~~~~~~~~~~~~~~x~~~~~~~~~~~~~~~~~~~~|    ",
        "    ||~~~~~~~~~~~~|b||||||||~~~~~~~~~~~~~~~~||b|~~~~~~~~~~~~~~~~~~||    ",
        "     ||||||||||||||.||||   ||~~~~~~~~~~~~~~|||.||||||||||||||||||||     ",
        "        |GGG.HYYYYY...U|    ||~~~~~~~~~~~~|| |.||2$&$&$&$&$&$&$|        ",
        "        |GGG.C........U|     ||||||~~||||||  |.||2.............|        ",
        "        |GGG.H........U|          |~~|       |.||2..@#@..@#@..@|        ",
        "        ||||||r.......U||||||||||||~~|||||||||.||2..@#@..@#@..@|        ",
        "             |2.2.................####.........................|        ",
        "             |22222222222222222222x!*x222222222222..@#@..@#@..@|        ",
        "             ||||||||||||||||||||2x``x2||||||||||2..@#@..@#@..@|        ",
        "                                |2x~~x2|        |2.............|        ",
        "                                |2x~~x2|        |2..2#2..2#2..2|        ",
        "                                |2x~~x2|        |22222222222222|        ",
        "                      |||||||||||2x~~x2|||||||||||||||||||||||||        ",
        "                      |!~~~~~~~~~~#~~#~~~~~~~~~!|                       ",
        "                      |||||||||||2x~~x2||||||||||                       ",
        "                                |2x~~x2|                                "
      ],
      "palettes": [ "sewage_treatment_sewer_palette" ],
      "furniture": {
        "c": "f_chair",
        "l": "f_locker",
        "L": "f_locker",
        "n": "f_sink",
        "{": "f_utility_shelf",
        "r": "f_rack",
        "f": "f_air_filter",
        ";": "f_server",
        "q": "f_shower",
        "w": "f_workbench",
        "t": "f_table",
        "D": "f_desk",
        "T": "f_counter",
        "0": "f_lab_bench",
        "[": "f_glass_cabinet",
        "I": "f_air_conditioner",
        "h": "f_fume_hood",
        "1": "f_trashcan"
      },
      "items": {
        "q": { "item": "shower", "chance": 40 },
        "l": [ { "item": "clothing_work_set", "chance": 20 }, { "item": "shower", "chance": 50 } ],
        "L": { "item": "cleaning", "chance": 20, "repeat": [ 1, 2 ] },
        "{": [ { "item": "sewage_plant", "chance": 50 }, { "item": "supplies_plumbing", "chance": 30 } ],
        "r": { "item": "tools_electronics", "chance": 20, "repeat": [ 1, 3 ] },
        "w": { "item": "supplies_hardware", "chance": 20 },
        "`": [ { "item": "sewer", "chance": 20 }, { "item": "trash_forest", "chance": 10 }, { "item": "trash", "chance": 10 } ],
        "0": [ { "item": "tools_science", "chance": 20 }, { "item": "sewage_samples", "chance": 20 } ],
        "h": { "item": "chem_home", "chance": 20, "repeat": [ 1, 3 ] },
        "D": { "item": "office_mess", "chance": 40 },
        "t": { "item": "electronics", "chance": 20 },
        "[": [ { "item": "office_mess", "chance": 30 }, { "item": "sewage_samples", "chance": 10 } ],
        "1": { "item": "trash", "chance": 50 }
      },
      "place_loot": [
        { "group": "sewage_plant", "x": [ 17, 20 ], "y": 4, "chance": 70 },
        { "group": "sewage_plant", "x": [ 48, 51 ], "y": 4, "chance": 70 },
        { "group": "treatment_chemicals", "x": [ 49, 55 ], "y": [ 13, 16 ], "chance": 90, "repeat": [ 1, 3 ] },
        { "group": "treatment_chemicals", "x": [ 50, 61 ], "y": [ 35, 42 ], "chance": 50, "repeat": [ 1, 3 ] },
        { "group": "sewage_plant", "x": [ 50, 61 ], "y": [ 35, 42 ], "chance": 70, "repeat": [ 1, 3 ] }
      ],
      "computers": {
        "8": {
          "name": "EnviroCom OS v2.03",
          "security": 1,
          "options": [ { "name": "Download Sewer Maps", "action": "map_sewer" }, { "name": "Divert sample", "action": "sample" } ],
          "failures": [ { "action": "shutdown" }, { "action": "alarm" } ]
        }
      },
      "place_monsters": [
        { "monster": "GROUP_ZOMBIE", "x": [ 26, 36 ], "y": [ 12, 18 ], "density": 0.35 },
        { "monster": "GROUP_ZOMBIE", "x": [ 16, 20 ], "y": [ 36, 38 ], "density": 0.1 },
        { "monster": "GROUP_SEWAGE_TREATMENT", "x": 36, "y": 3, "density": 0.2 },
        { "monster": "GROUP_SEWAGE_TREATMENT", "x": [ 30, 32 ], "y": [ 35, 36 ], "density": 0.2 }
      ]
    }
  }
]
