[
  {
    "method": "json",
    "om_terrain": [ [ "urban_4_3", "urban_4_4" ] ],
    "type": "mapgen",
    "weight": 25000,
    "object": {
      "fill_ter": "t_floor",
      "rows": [
        "................................................",
        "................................................",
        "............[...........```.....................",
        "..................#oooo#```.....................",
        "...################]]]]##*##oo#########o##......",
        "...#R  xxxx   |6|,,]}}],,,F1552O3|,t|QNN'#^.....",
        "...#R         |,+,,,,,,,,,,,,,,,,+,,|Q''U#......",
        "...#          |6|,,,,00,,,,,,,47,|,S|U''U#......",
        "...#    ll   E|||  ||JJJ| |JJ|##*######*##......",
        "...#  H       | +  |      AA y#'''''''''''......",
        "...#  HHHHH   |>|  |   h      #'''''''''''......",
        "...#         R|||  |  hffh   r#'''''''''''......",
        "...#R        R|<|  |  hffh   r#'''''''''''......",
        "...#R         |    |  hffh   r#'''''''''''......",
        "...#R                   h     #'''''''''''......",
        "...#R ET  h Ty|L  y|         y#'''''''''''......",
        "...######rrr###o**o###ycy######''''''''''#......",
        "........#ooo#````````#ooo#......________........",
        ".............````````...........________........",
        ".......[........``..............________........",
        "................``..............________........",
        "................``...[..........________........",
        "................``..............________........",
        "................``..............________.p......"
      ],
      "palettes": [ "standard_domestic_palette" ],
      "terrain": {
        "%": [ "t_region_shrub", "t_region_shrub_fruit", "t_region_shrub_decorative" ],
        "[": [ [ "t_region_tree_fruit", 2 ], [ "t_region_tree_nut", 2 ], "t_region_tree_shade" ],
        "!": "t_region_groundcover_urban",
        "=": "t_door_metal_locked",
        "_": "t_pavement",
        "&": "t_gates_control_brick",
        "#": "t_brick_wall",
        "'": "t_thconc_floor",
        "q": "t_thconc_floor",
        "Q": "t_thconc_floor",
        "N": "t_thconc_floor",
        "U": "t_thconc_floor",
        "`": "t_concrete",
        "}": "t_linoleum_white",
        ",": "t_linoleum_white",
        "O": "t_linoleum_white",
        "F": "t_linoleum_white",
        "1": "t_linoleum_white",
        "2": "t_linoleum_white",
        "3": "t_linoleum_white",
        "4": "t_linoleum_white",
        "5": "t_linoleum_white",
        "6": "t_linoleum_white",
        "7": "t_linoleum_white",
        "8": "t_linoleum_white",
        "n": "t_linoleum_white",
        "J": "t_linoleum_white",
        "Y": "t_linoleum_white",
        "S": "t_linoleum_white",
        "t": "t_linoleum_white",
        "f": "t_linoleum_white",
        "0": "t_linoleum_white",
        "]": "t_linoleum_white"
      },
      "furniture": { "!": "f_region_flower", "0": "f_stool", "]": "f_sofa", "}": "f_table" },
      "place_loot": [ { "item": "television", "x": 8, "y": 5, "chance": 20 }, { "item": "stereo", "x": 9, "y": 5, "chance": 20 } ],
      "place_vehicles": [ { "vehicle": "suburban_home", "x": 36, "y": 12, "chance": 30, "rotation": 270, "status": 1 } ]
    }
  }
]
