[
  {
    "method": "json",
    "om_terrain": [ [ "urban_12_1", "urban_12_2" ] ],
    "type": "mapgen",
    "weight": 10000,
    "object": {
      "fill_ter": "t_floor",
      "rows": [
        "........________..............p.``..............",
        "........________...............%``%.........[...",
        ".....[..________...............````.............",
        "........________.......%..%..##''''##..%..%.....",
        "........________&....###oo#####o**o#####oo###...",
        "......##========##...#      c|      |T xxxx #...",
        "......#'''''''''&#...# hffh       sL|E      o...",
        "......#''''''''''o...# hffh  |    |||       #...",
        "......o''''''''''#%.%# hffh  |<|  |   H ll H#...",
        ".....^#N'''''''''#%%%#       |||      HHHHHH#^..",
        "......#N'''''''''##o##    xxx|w+            o...",
        "......#N'''''''''|U'U|  ||||||||  |     RR  #...",
        "......o''''''''''+'''+     ciic   ###oo######...",
        "......#''''''''''|W'Z|            #'''GKG''$....",
        "......#'''''''qqq##*##|+||,,,,,,,,1''''''''$....",
        "......####o##o####```#,,,|6,,,,,,Y#''''''''ƃ....",
        "...[..............```#t,S|6,,,JJ,no''₸''₸'y$....",
        "................%%```#||||,,,,JJ,5o''''''''$....",
        "................%%```#,,,+,,,,,,,2#''y''y''$....",
        "............[........#666|JJF34O71#$$$ƃ$$$$#....",
        ".....................#####o##o#####.............",
        "................................................",
        ".....[....................................[.....",
        "................................................"
      ],
      "palettes": [
        "standard_domestic_palette",
        "standard_domestic_lino_kitchen",
        "standard_domestic_lino_bathroom",
        "standard_domestic_landscaping_palette"
      ],
      "terrain": {
        ",": "t_linoleum_gray",
        "h": "t_carpet_purple",
        "f": "t_carpet_purple",
        "'": "t_thconc_floor",
        "K": "t_thconc_floor",
        "Z": "t_thconc_floor",
        "₸": "t_thconc_floor",
        "W": "t_thconc_floor",
        "U": "t_thconc_floor",
        "G": "t_thconc_floor",
        "N": "t_thconc_floor",
        "y": "t_thconc_floor",
        "q": "t_thconc_floor",
        "=": "t_door_metal_locked",
        "&": "t_gates_control_brick",
        "#": "t_brick_wall",
        "ƃ": "t_screen_door_c",
        "$": "t_screened_porch_wall",
        "Y": "t_linoleum_gray"
      },
      "place_loot": [ { "item": "television", "x": 40, "y": 5, "chance": 20 }, { "item": "stereo", "x": 41, "y": 5, "chance": 20 } ],
      "place_vehicles": [ { "vehicle": "suburban_home", "x": 11, "y": 9, "chance": 20, "rotation": 270, "status": 1 } ]
    }
  }
]
