[
  {
    "method": "json",
    "om_terrain": [ [ "urban_15_1", "urban_15_2" ] ],
    "type": "mapgen",
    "weight": 10000,
    "object": {
      "fill_ter": "t_floor",
      "rows": [
        "..................................._______.p....",
        ".............[....................._______......",
        "...````````````````````````````````_______......",
        "...`[........!!!!!!!...'''......```_______......",
        "...`...#######o##o#####'''.%%%%%```_______&.....",
        "...`.!.#BB,8| s@@ II|D##*###ooo##*#=======##....",
        "...`.!.o,,,S|  @@ h + |L  1235n4|'''''''''&#....",
        "...`.!.#t,,S|E      |||   ,,,,,7|''''''''''#....",
        "...`.!.#Y,,8|T   dby|U+   ,AJJ,O|''''''''''#....",
        "...`.!.#w|+|||+||||||||R  ,AJJ,J|'''''''''q#....",
        "...`.!.#||          <     ,AJJ,J|'''''''''q#....",
        "...`.!.#D|                ,,,,,F|'''''''''N#^...",
        "...`.!.#+||||+||y               |'''''''''N#....",
        "...`...#  II  T|x  l H    hffh  ||+||||||||#....",
        "$$$ƃ$$$#d h    |x  l H    hffh            g#$ƃ$$",
        "$......#b  @@  |x    H    hffh  |+||+||   0#...$",
        "$.....^#  s@@sy|T HHHH         E|6|t,S|WZ00#...$",
        "$......##o###o####ooo####o#::#o#########oo##...$",
        "$.................!!!....``````................$",
        "$....[...................``````...u............$",
        "$.........X...........................[........$",
        "$..............................................$",
        "$..................[...........................$",
        "$$$$$$$$$$$$$$$$$$$$$$$$$$ƃ$$$$$$$$$$$$$$$$$$$$$"
      ],
      "palettes": [
        "standard_domestic_palette",
        "standard_domestic_lino_kitchen",
        "standard_domestic_lino_bathroom",
        "standard_domestic_landscaping_palette"
      ],
      "terrain": {
        ",": "t_linoleum_gray",
        ":": "t_door_glass_c",
        "'": "t_thconc_floor",
        "N": "t_thconc_floor",
        "q": "t_thconc_floor",
        "=": "t_door_metal_locked",
        "&": "t_gates_control_brick",
        "#": "t_brick_wall",
        "ƃ": "t_privacy_fencegate_c",
        "$": "t_privacy_fence",
        "Y": "t_linoleum_gray",
        "A": "t_linoleum_gray"
      },
      "furniture": { "0": "f_counter" },
      "place_loot": [ { "item": "television", "x": 16, "y": 14, "chance": 20 }, { "item": "stereo", "x": 16, "y": 15, "chance": 20 } ],
      "place_vehicles": [ { "vehicle": "suburban_home_compact", "x": 37, "y": 9, "chance": 20, "rotation": 270, "status": 1 } ]
    }
  }
]
