[
  {
    "method": "json",
    "om_terrain": [ [ "urban_13_2", "urban_13_1" ] ],
    "type": "mapgen",
    "weight": 25000,
    "object": {
      "fill_ter": "t_floor",
      "rows": [
        "%%%%%%%%%%%%%%%%%%%%%%%%%%%%%%%%%%%%%%%%%%%%%%%%",
        "%%%%%%%%%%%%%%%%%%%%%%%%%%%%%%%%%%%%%%%%%%%%%%%%",
        "%%%%%%%%%%%%%%%%%%%%%%%%%%%%%%%%%%%%%%%%%%%%%%%%",
        "%%%%%%%%%%%%%%%%################%%%%%%%%%%%%%%%%",
        "%%%%%%%%%%%%%%%%#R  HH715OF|StB#%%%%%%%%%%%%%%%%",
        "%%%%%%%%%%%%%%%%#x  lH2----+--B#%%%%%%%%%%%%%%%%",
        "%%%%%%%%%%%%%%%%#x   H4JJ-Y||||#################",
        "#################P        6|zDz#N----!|~~~~~~~~#",
        "#~~~~~~~~~~~~~~~#Ty   r||+|||+|#NA---W|~~~~#~~~#",
        "#~~~~~~~~~~~~~~~#||  hr|      T#Q----Z|~~~###~~#",
        "#~~~~~~~~~~~~~~~#U+   y|b     E#-----!|~~~~#~~~#",
        "#~~~##~~~~~##~~~#|||+|||  @@   #+|||+||~~~~~~~~#",
        "#~~~##~~~~~##~~~#<----!|yI@@I d#<|~~~~~~~~~~~~~#",
        "#~~~~~~~~~~~~~~~#||---W||||||||#||~~~~~~~~~~~~~#",
        "#~~~~~~~~~~~~~~~#q+---W|##~~~~~#~~~~~~~~~~~~~~~#",
        "#~~~~~~~~~~~~~~~#||---!|#~~~~~~#~~~#~~~~~~~#~~~#",
        "#~~~##~~~~~##~~~#!----Z|$~~~#~~#~~###~~~~~###~~#",
        "#~~~##~~~~~##~~~#W----Z|$~~###~#~~~#~~~~~~~#~~~#",
        "#~~~~~~~~~~~~~~~#Z----!|~~~~#~~#~~~~~~~~~~~~~~~#",
        "#~~~~~~~~~~~~~~~#!-----+~~~~~~~#~~~~~~~~~~~~~~~#",
        "#~~~~~~~~~~~~~~~################~~~~~~~~~~~~~~~#",
        "#################%%%%%%%%%%%%%%#################",
        "%%%%%%%%%%%%%%%%%%%%%%%%%%%%%%%%%%%%%%%%%%%%%%%%",
        "%%%%%%%%%%%%%%%%%%%%%%%%%%%%%%%%%%%%%%%%%%%%%%%%"
      ],
      "palettes": [ "standard_domestic_palette" ],
      "terrain": {
        "%": "t_soil",
        "~": "t_dirtfloor",
        "$": "t_sai_box",
        "t": "t_linoleum_gray",
        "S": "t_linoleum_gray",
        "J": "t_linoleum_gray",
        "1": "t_linoleum_gray",
        "2": "t_linoleum_gray",
        "4": "t_linoleum_gray",
        "5": "t_linoleum_gray",
        "7": "t_linoleum_gray",
        "8": "t_linoleum_gray",
        "9": "t_linoleum_gray",
        "B": "t_linoleum_gray",
        "F": "t_linoleum_gray",
        "O": "t_linoleum_gray",
        "-": "t_linoleum_gray",
        "Z": "t_linoleum_gray",
        "q": "t_linoleum_gray",
        "W": "t_linoleum_gray",
        "Y": "t_linoleum_gray",
        "A": "t_linoleum_gray",
        "N": "t_linoleum_gray",
        "Q": "t_linoleum_gray",
        "!": "t_linoleum_gray"
      },
      "furniture": { "!": "f_counter" },
      "place_item": [ { "item": "television", "x": 17, "y": 5 } ],
      "items": { "!": [ { "item": "laundry", "chance": 20, "repeat": [ 1, 3 ] }, { "item": "cleaning", "chance": 10 } ] },
      "place_vehicles": [ { "vehicle": "laundry_cart", "x": [ 19, 20 ], "y": [ 13, 18 ], "chance": 20, "repeat": 2 } ]
    }
  },
  {
    "method": "json",
    "om_terrain": [ [ "urban_13_3", "urban_13_4" ] ],
    "type": "mapgen",
    "weight": 25000,
    "object": {
      "fill_ter": "t_floor",
      "rows": [
        "________________________________________________",
        "_______________________________$$$$$$??$$$$$$___",
        ".$$$$$$$?$$$$$$$$```YY.%%.....^$.%...``.....$`[.",
        ".$......`.......##*#o######o####...``````.%.$`..",
        ".$...X..`.[.....#F-J  E xx|    #...`GKG``...$``.",
        ".$......`....[..o1-5      |    #.YY``````...$^``",
        "^$.Y`````.......#O-J  HHHT|    ###o##*##o######`",
        "###o##*#######o##2--      +    #-------152OF|6#`",
        "#F153---|WZ|8S-B#--3  R|+||||||#-/}/--------+-#`",
        "#2------+--|8--B#+||| y|--9|9-t#-/}/-----734|6#`",
        "#4--J)--|!!|t--Q#6|=* L|tS8|8-S#---------|||||#`",
        "#O--J)--|||||+||#||=|||||||||+|#+|||||||      #`",
        "#n--J)--+     +U#>==|T@@ y|F6-1#>|U|S-t|r hfh #`",
        "#6------||||| ||#||=| @@  |3--2#||+||+||y hfh #`",
        "#6-------<|R   r#U+=|    I|O--5#rr        hfh #`",
        "#|| ||| |||R  hr#||=|   EI|4--7#E    RR|      #`",
        "#    M| |y      #<|=|Dbd  |JJ--#HHHH ||| |R  s#`",
        "# hfh | |   E E #===|||||+|AA  #Hll  |<| |R  E#`",
        "# hfh      H   x#===*         H#         |   T#`",
        "# hfh | |  H l x#===|L RR TE lH#     |   |y h #`",
        "#T   y#*#L T   R##*###o####o####yxxxT|L y|Prrr#`",
        "##o#o##`###o#o###```.%%%%%%%%..###o####*####o##`",
        "````````````````````````````````````##```##`````",
        "````````````````````````````````````````````````"
      ],
      "palettes": [ "standard_domestic_palette" ],
      "terrain": {
        "%": [ "t_region_shrub", "t_region_shrub_fruit", "t_region_shrub_decorative" ],
        "[": [ [ "t_region_tree_fruit", 2 ], [ "t_region_tree_nut", 2 ], "t_region_tree_shade" ],
        "=": "t_carpet_green",
        "_": "t_pavement",
        "`": "t_concrete",
        "K": "t_concrete",
        "Y": "t_concrete",
        "G": "t_concrete",
        "$": "t_privacy_fence",
        "?": "t_privacy_fencegate_c",
        "t": "t_linoleum_gray",
        "S": "t_linoleum_gray",
        "J": "t_linoleum_gray",
        "1": "t_linoleum_gray",
        "2": "t_linoleum_gray",
        "3": "t_linoleum_gray",
        "4": "t_linoleum_gray",
        "5": "t_linoleum_gray",
        "6": "t_linoleum_gray",
        "7": "t_linoleum_gray",
        "8": "t_linoleum_gray",
        "9": "t_linoleum_gray",
        "B": "t_linoleum_gray",
        "F": "t_linoleum_gray",
        "O": "t_linoleum_gray",
        "-": "t_linoleum_gray",
        "Z": "t_linoleum_gray",
        "n": "t_linoleum_gray",
        "q": "t_linoleum_gray",
        "W": "t_linoleum_gray",
        "N": "t_linoleum_gray",
        "Q": "t_linoleum_gray",
        "}": "t_linoleum_gray",
        ")": "t_linoleum_gray",
        "/": "t_linoleum_gray",
        "!": "t_linoleum_gray"
      },
      "furniture": { "!": "f_counter", "}": "f_table", ")": "f_stool", "/": "f_chair" },
      "place_item": [
        { "item": "television", "x": 15, "y": 19 },
        { "item": "television", "x": 34, "y": 20 },
        { "item": "television", "x": 24, "y": 4 }
      ],
      "items": { "!": [ { "item": "laundry", "chance": 20, "repeat": [ 1, 3 ] }, { "item": "cleaning", "chance": 10 } ] },
      "place_vehicles": [ { "vehicle": "bikeshop", "x": 25, "y": 1, "rotation": 180, "chance": 20, "status": 1 } ],
      "place_nested": [
        {
          "chunks": [
            [ "null", 1 ],
            [ "bedroom_4x4_adult_2_N", 20 ],
            [ "bedroom_4x4_adult_2_N", 20 ],
            [ "bedroom_4x4_adult_2_E", 20 ],
            [ "bedroom_4x4_adult_3_S", 20 ],
            [ "bedroom_4x4_adult_3_N", 20 ],
            [ "bedroom_4x4_adult_3_E", 20 ],
            [ "bedroom_4x4_adult_3_W", 20 ]
          ],
          "x": 27,
          "y": 4
        }
      ]
    }
  }
]
