[
  {
    "type": "mapgen",
    "method": "json",
    "om_terrain": [ [ "s_gas_0_0", "s_gas_1_0" ], [ "s_gas_0_1", "s_gas_1_1" ] ],
    "object": {
      "fill_ter": "t_linoleum_white",
      "rows": [
        "___________.....................................",
        "_--------__.....................................",
        "_-TT..YY-__.....................................",
        "_-......-__.....................................",
        "_-......-__.....................................",
        "_-......-__.....................................",
        "_-°------__.......___...........___.............",
        "___________......._9_..........._9_.............",
        "___________......._D_..........._D_.............",
        "__................_G_..........._G_.............",
        "__................_P_..........._P_.............",
        "__................___...........___.............",
        "__..À............._c_..........._c_.............",
        "__................_c_..........._c_.............",
        "__,,,,,,,,,.......___...........___.............",
        "__................_P_..........._P_.............",
        "__................_D_..........._D_.............",
        "__................_G_..........._G_.............",
        "__................_9_..........._9_.............",
        "__..À.............___...........___.............",
        "__..............................................",
        "__,,,,,,,,,.....................................",
        "__..............................................",
        "__..............................................",
        "__..............................................",
        "__..............................................",
        "__..............................................",
        "__..À...........................................",
        "__,,,,,,,,,.....................................",
        "__.,..,..,,.....................................",
        "__,..,..,.,.....................................",
        "__..,..,..,.....................................",
        "_________________________________...............",
        "_____________vVVv&&______________...............",
        "_________##########OwwO#oo##oo##_...............",
        "_________#RRRRR|  C     eeeeee #_,,,,,,,,,......",
        "_________#     | hr           Eo_...............",
        "_________# RRR |  C  eeeeeeee Eo_...............",
        "_________# RRR |  C  eeeeeeee E#_...............",
        "_________#     |  C           E#_..À............",
        "_________# RRR +  C  pppppppp Eo_...............",
        "_________#*###+||||  pppppppp Eo_,,,,,,,,,......",
        "_________-___o hfh|           E#_...............",
        "_________-___# hfh|HHH HHHHHHH #_...............",
        "_________°___# hfh||||+|########_...............",
        "_________-_dd#    + t| t#________..À............",
        "_________-_dd#321F| S| S#________...............",
        "_________----############________,,,,,,,,,......"
      ],
      "palettes": [ "parametrized_walls_palette" ],
      "terrain": {
        "°": "t_chaingate_l",
        "-": "t_chainfence",
        "+": "t_door_c",
        "*": "t_door_locked",
        "À": "t_pavement",
        ".": "t_pavement",
        ",": "t_pavement_y",
        "_": "t_sidewalk",
        "c": "t_little_column",
        "v": "t_sidewalk",
        "V": "t_sidewalk",
        "d": "t_sidewalk",
        "9": "t_sidewalk",
        "P": "t_sidewalk",
        "D": "t_sidewalk",
        "G": "t_sidewalk",
        "&": "t_sidewalk",
        "w": "t_door_glass_c",
        "O": "t_wall_glass",
        "o": "t_window"
      },
      "gaspumps": { "G": { "fuel": "gasoline" }, "D": { "fuel": "diesel" } },
      "furniture": {
        "d": "f_dumpster",
        "R": "f_warehouse_shelf",
        "C": "f_counter",
        "r": "f_counter",
        "e": "f_rack",
        "p": "f_rack",
        "E": "f_rack",
        "H": "f_rack",
        "h": "f_chair",
        "f": "f_table",
        "F": "f_fridge",
        "S": "f_sink",
        "1": "f_counter",
        "2": "f_counter",
        "3": "f_counter",
        "9": "f_aut_gas_console",
        "&": "f_atm_off",
        "T": "f_gas_tank",
        "Y": "f_diesel_tank"
      },
      "items": {
        "d": { "item": "SUS_trash_dumpster", "chance": 40 },
        "r": { "item": "cash_register_random", "chance": 100 },
        "e": { "item": "snacks", "chance": 30, "repeat": [ 2, 5 ] },
        "E": { "item": "groce_softdrink", "chance": 30, "repeat": [ 2, 5 ] },
        "p": { "item": "groce_premade", "chance": 30, "repeat": [ 2, 5 ] },
        "H": { "item": "magazines", "chance": 30, "repeat": [ 2, 5 ] },
        "R": [
          { "item": "snacks", "chance": 50, "repeat": [ 2, 5 ] },
          { "item": "groce_softdrink", "chance": 50, "repeat": [ 2, 5 ] },
          { "item": "groce_premade", "chance": 50, "repeat": [ 2, 5 ] },
          { "item": "magazines", "chance": 50, "repeat": [ 2, 5 ] }
        ]
      },
      "signs": { "P": { "signage": "Danger!  Do not smoke!  Risk of explosion!" } },
      "vendingmachines": { "V": { "item_group": "vending_drink", "lootable": true }, "v": { "item_group": "vending_food", "lootable": true } },
      "place_liquids": [
        { "liquid": "gasoline", "x": [ 2, 3 ], "y": 2, "repeat": [ 200, 1075 ] },
        { "liquid": "diesel", "x": [ 6, 7 ], "y": 2, "repeat": [ 200, 1075 ] }
      ],
      "toilets": { "t": {  } },
      "vehicles": { "À": { "vehicle": "suburban_home", "chance": 33, "rotation": 180 } }
    }
  },
  {
    "type": "mapgen",
    "method": "json",
    "om_terrain": [ [ "s_gas_0_0_roof", "s_gas_1_0_roof" ], [ "s_gas_0_1_roof", "s_gas_1_1_roof" ] ],
    "object": {
      "fill_ter": "t_flat_roof",
      "rows": [
        "                                                ",
        "                                                ",
        "                                                ",
        "                                                ",
        "                                                ",
        "                                                ",
        "                  ...           ...             ",
        "                  ...           ...             ",
        "                  ...           ...             ",
        "                  ...           ...             ",
        "                  ...           ...             ",
        "                  ...           ...             ",
        "                  ...           ...             ",
        "                  ...           ...             ",
        "                  ...           ...             ",
        "                  ...           ...             ",
        "                  ...           ...             ",
        "                  ...           ...             ",
        "                  ...           ...             ",
        "                  ...           ...             ",
        "                                                ",
        "                                                ",
        "                                                ",
        "                                                ",
        "                                                ",
        "                                                ",
        "                                                ",
        "                                                ",
        "                                                ",
        "                                                ",
        "                                                ",
        "                                                ",
        "                                                ",
        "                                                ",
        "         -----------------------                ",
        "         -.....................-                ",
        "         -.1...................-                ",
        "         -.....................-                ",
        "         -..................2..-                ",
        "         -.1...................-                ",
        "         -.....................-                ",
        "         -----.................-                ",
        "             -.................-                ",
        "             -.................-                ",
        "             -..........--------                ",
        "             -..........-                       ",
        "             -..........-                       ",
        "             ------------                       "
      ],
      "palettes": [ "roof_palette" ]
    }
  },
  {
    "type": "mapgen",
    "method": "json",
    "om_terrain": [ "s_gas_1" ],
    "object": {
      "fill_ter": "t_thconc_floor",
      "rows": [
        "____]]]____:____]]]____]",
        "____]]]____:____]]]____]",
        "____!#!____:____!#!____]",
        "____]]]____:____]]]____]",
        "____]]]____:____]]]____]",
        "____]]]____:____]]]____]",
        "____!#!____:____!#!____]",
        "____]]]____:____]]]____]",
        "____]]]____:____]]]____]",
        "]]]]]]]]]]]]]]]]]]]]]]]]",
        "]]]]]]]]]]]]]]Á]]]]]]]]]",
        "#xxxxxxxxx///xxxxxxxxx#]",
        "#1.......&...&.......1#]",
        "#r...................{#]",
        "#r..rrrrr.....rrrrr..{#]",
        "#r..rrrrr.....rrrrr..{#]",
        "#r...................{#]",
        "#r...................{#]",
        "#&.AFFD|.CCCCC|rrrrrr1#]",
        "#|+|||||...s..||||||||#]",
        "#S.|...+......+.......~]",
        "#T.|TSl|.rrrrr|HHtcCfl#]",
        "########~##############]",
        " 4      ]]]]]]]]]]]]]]]]"
      ],
      "palettes": [ "parametrized_walls_palette" ],
      "terrain": {
        " ": [ [ "t_region_groundcover", 8 ], "t_region_shrub" ],
        "_": "t_pavement",
        "!": "t_pavement",
        "+": "t_door_c",
        "~": "t_door_locked",
        "/": "t_door_glass_c",
        "x": "t_wall_glass",
        ":": "t_pavement_y",
        "*": "t_tree",
        "Á": "t_concrete",
        "]": "t_concrete",
        ".": "t_thconc_floor",
        "4": "t_gutter_downspout"
      },
      "furniture": {
        "A": "f_atm_off",
        "&": "f_trashcan",
        "{": "f_glass_fridge",
        "1": [ "f_indoor_plant", "f_indoor_plant_y" ],
        "C": "f_counter",
        "H": "f_sofa",
        "c": "f_chair",
        "s": "f_stool",
        "t": "f_table",
        "r": "f_rack",
        "l": "f_locker",
        "f": "f_fridge",
        "o": "f_oven",
        "S": "f_sink",
        "T": "f_toilet",
        "Á": "f_rack"
      },
      "toilets": { "T": {  } },
      "gaspumps": { "!": {  } },
      "vendingmachines": { "D": { "item_group": "vending_drink" }, "F": { "item_group": "vending_food" } },
      "place_signs": [ { "signage": "Wide selection of storage batteries!  Discounts!", "x": 13, "y": 10 } ],
      "items": {
        "T": { "item": "SUS_toilet", "chance": 50 },
        "l": { "item": "SUS_janitors_closet", "chance": 70 },
        "&": { "item": "SUS_trash_floor_light", "chance": 50 }
      },
      "place_loot": [
        { "group": "cash_register_random", "x": [ 9, 13 ], "y": 18, "chance": 100 },
        { "group": "fridgesnacks", "x": 21, "y": [ 13, 17 ], "chance": 80, "repeat": [ 1, 12 ] },
        { "group": "SUS_fridge_breakroom", "x": 20, "y": 21, "chance": 80 },
        { "group": "snacks", "x": [ 14, 18 ], "y": [ 14, 15 ], "chance": 80, "repeat": [ 1, 12 ] },
        { "group": "magazines", "x": [ 4, 8 ], "y": [ 14, 15 ], "chance": 80, "repeat": [ 1, 12 ] },
        { "group": "softdrugs", "x": 1, "y": [ 13, 17 ], "chance": 80, "repeat": [ 1, 4 ] },
        { "group": "behindcounter", "x": [ 9, 13 ], "y": 21, "chance": 80, "repeat": [ 1, 4 ] },
        { "group": "road", "x": [ 7, 15 ], "y": [ 0, 8 ], "chance": 50, "repeat": [ 1, 4 ] },
        { "group": "gas_charging_rack", "x": [ 15, 20 ], "y": 18, "chance": 50, "repeat": [ 1, 2 ] },
        { "group": "gas_charging_rack", "x": 14, "y": 10, "chance": 50 },
        { "group": "dining", "x": 17, "y": 21, "chance": 45 },
        { "group": "bed", "x": [ 15, 16 ], "y": 21, "chance": 70 },
        { "item": "microwave", "x": 19, "y": 21, "chance": 80 },
        { "item": "laptop", "x": 11, "y": 18, "chance": 70 }
      ]
    }
  },
  {
    "type": "mapgen",
    "method": "json",
    "om_terrain": "s_gas_roof_1",
    "object": {
      "fill_ter": "t_flat_roof",
      "rows": [
        "    ...         ...     ",
        "    ...         ...     ",
        "    ...         ...     ",
        "    ...         ...     ",
        "    ...         ...     ",
        "    ...         ...     ",
        "    ...         ...     ",
        "    ...         ...     ",
        "    ...         ...     ",
        "                        ",
        "                        ",
        "----------------------- ",
        "-.....................- ",
        "-...............R.....- ",
        "-.....................- ",
        "-.....................- ",
        "-.....................- ",
        "-.....................- ",
        "-.....................- ",
        "-.....................- ",
        "-...........U.........- ",
        "-.....................- ",
        "--5-------------------- ",
        "                        "
      ],
      "palettes": [ "roof_palette" ],
      "nested": { "U": { "chunks": [ "roof_2x2_infrastructure" ] }, "R": { "chunks": [ "roof_2x2_infrastructure_1" ] } },
      "place_nested": [
        {
          "chunks": [
            [ "null", 20 ],
            [ "roof_2x2_utilities_b", 15 ],
            [ "roof_2x2_utilities_c", 5 ],
            [ "roof_2x2_utilities_d", 40 ],
            [ "roof_2x2_utilities", 50 ]
          ],
          "x": [ 5, 15 ],
          "y": [ 15, 16 ]
        }
      ],
      "place_monster": [ { "group": "GROUP_ZOMBIE_GAS", "x": [ 5, 10 ], "y": [ 6, 10 ], "repeat": [ 1, 2 ], "chance": 25 } ]
    }
  },
  {
    "type": "mapgen",
    "method": "json",
    "om_terrain": [ "s_gas_rural" ],
    "//": "Rural Gas Station",
    "object": {
      "fill_ter": "t_floor",
      "rows": [
        "________________________",
        "________________________",
        "________________________",
        "________________________",
        "________________________",
        "_______G________D_______",
        "________________________",
        "________________________",
        "________________________",
        ".|~~~~~~~|    |~~~~~~~|.",
        ".~                    ~.",
        ".~      ss            ~.",
        ".||||0|||||33|||||0||||.",
        ".|9999  99      >S   9|.",
        ".|      99      >    9|.",
        ".|9999  99      >     |.",
        ".|              >  >>>|.",
        ".|FFFFFFFF            |.",
        ".|||||||||||3|||||||  |.",
        ".|@@  BC|AR|  >ÁUof|3||.",
        ".|@@   C|;'3       |';|.",
        ".|:     ||||  B6B  |''|.",
        "4|:  H  3     B6B =|A'|.",
        ".||00|||||0||||||||||||."
      ],
      "palettes": [ "parametrized_linoleum_palette", "commercial" ],
      "terrain": {
        "A": { "param": "linoleum_color", "fallback": "t_linoleum_gray" },
        "R": { "param": "linoleum_color", "fallback": "t_linoleum_gray" },
        ";": { "param": "linoleum_color", "fallback": "t_linoleum_gray" },
        "'": { "param": "linoleum_color", "fallback": "t_linoleum_gray" },
        "|": "t_wall_log",
        ".": "t_region_groundcover_urban",
        "0": [ "t_curtains", "t_window_domestic" ],
        "3": "t_door_c",
        "=": "t_thconc_floor",
        "~": "t_railing",
        "_": "t_pavement",
        "4": "t_gutter_downspout"
      },
      "furniture": {
        "6": "f_table",
        "9": "f_rack",
        ":": "f_dresser",
        "=": "f_woodstove",
        "o": "f_oven",
        ">": "f_counter",
        "U": "f_cupboard",
        "?": "f_sofa",
        "@": "f_bed",
        "A": "f_sink",
        "Á": "f_sink",
        "B": "f_chair",
        "C": "f_desk",
        "F": { "param": "display_fridge", "fallback": "f_glass_fridge" },
        "f": "f_fridge",
        "H": "f_armchair",
        "S": "f_stool",
        "s": "f_camp_chair",
        "R": "f_shower"
      },
      "toilets": { ";": {  } },
      "gaspumps": { "G": { "fuel": "gasoline" }, "D": { "fuel": "diesel" } },
      "items": {
        "U": [
          { "item": "SUS_silverware", "chance": 100 },
          { "item": "SUS_dishes", "chance": 100 },
          { "item": "SUS_cookware", "chance": 75 },
          { "item": "SUS_appliances_cupboard", "chance": 75 }
        ],
        "Á": { "item": "SUS_kitchen_sink", "chance": 100 },
        "o": { "item": "SUS_oven", "chance": 100 },
        ";": { "item": "SUS_toilet", "chance": 100 },
        "@": { "item": "bed", "chance": 25 },
        "C": { "item": "SUS_office_desk", "chance": 33 },
        "f": { "item": "SUS_fridge", "chance": 100 },
        "F": { "item": "SUS_fridge_breakroom", "chance": 50 },
        ":": [ { "item": "SUS_dresser_mens", "chance": 50 }, { "item": "SUS_dresser_womens", "chance": 50 } ]
      },
      "place_items": [
        { "item": "cash_register_random", "x": 16, "y": [ 13, 16 ], "chance": 100 },
        { "item": "snacks", "x": [ 2, 5 ], "y": 15, "chance": 80, "repeat": [ 1, 12 ] },
        { "item": "behindcounter", "x": [ 21, 21 ], "y": [ 13, 14 ], "chance": 80, "repeat": [ 1, 3 ] },
        { "item": "road", "x": [ 20, 20 ], "y": [ 13, 14 ], "chance": 80, "repeat": [ 1, 4 ] },
        { "item": "camping", "x": [ 9, 9 ], "y": [ 15, 15 ], "chance": 90, "repeat": [ 1, 10 ] },
        { "item": "magazines", "x": [ 9, 9 ], "y": [ 13, 15 ], "chance": 90, "repeat": [ 1, 25 ] },
        { "item": "softdrugs", "x": [ 8, 8 ], "y": [ 13, 15 ], "chance": 80, "repeat": [ 1, 8 ] },
        { "item": "nested_shotgun_s", "x": 3, "y": 20, "chance": 10 }
      ],
      "place_monster": [ { "group": "GROUP_ZOMBIE_GAS", "x": [ 5, 10 ], "y": [ 6, 10 ], "repeat": [ 1, 2 ], "chance": 25 } ]
    }
  },
  {
    "type": "mapgen",
    "method": "json",
    "om_terrain": "s_gas_rural_roof",
    "object": {
      "fill_ter": "t_flat_roof",
      "rows": [
        "                        ",
        "                        ",
        "                        ",
        "                        ",
        "                        ",
        "                        ",
        "                        ",
        "                        ",
        "                        ",
        "                        ",
        " ---------------------- ",
        " -....................- ",
        " -....................- ",
        " -....................- ",
        " -....................- ",
        " -....................- ",
        " -....................- ",
        " -....................- ",
        " -....................- ",
        " -....................- ",
        " -................R...- ",
        " -....U...............- ",
        " 5....................- ",
        " ---------------------- "
      ],
      "palettes": [ "roof_palette" ],
      "nested": { "U": { "chunks": [ "roof_2x2_infrastructure" ] }, "R": { "chunks": [ "roof_2x2_infrastructure_1" ] } },
      "place_nested": [
        {
          "chunks": [
            [ "null", 20 ],
            [ "roof_2x2_utilities_b", 15 ],
            [ "roof_2x2_utilities_c", 5 ],
            [ "roof_2x2_utilities_d", 40 ],
            [ "roof_2x2_utilities", 50 ]
          ],
          "x": [ 5, 15 ],
          "y": [ 12, 17 ]
        }
      ],
      "place_monster": [ { "group": "GROUP_ZOMBIE_GAS", "x": [ 5, 10 ], "y": [ 6, 10 ], "repeat": [ 1, 2 ], "chance": 25 } ]
    }
  }
]
