[
  {
    "type": "palette",
    "id": "string_dimension_small_ziggurat_palette",
    "terrain": {
      " ": "t_string_xyz",
      ".": "t_metal_floor",
      "c": "t_metal_floor",
      "#": "t_wall_metal",
      "-": "t_open_air",
      ">": "t_slope_down",
      "<": "t_slope_up",
      ",": "t_string_xyz",
      "d": "t_stairs_down",
      "u": "t_stairs_up",
      "1": [ [ "t_string_void", 10 ], [ "t_string_xyz", 90 ] ],
      "2": [ [ "t_string_void", 66 ], [ "t_string_xyz", 33 ] ],
      "+": "t_door_metal_c"
    },
    "furniture": { "c": "f_electrical_conduit" }
  },
  {
    "type": "overmap_terrain",
    "id": [ "string_dimension_small_ziggurat_1", "string_dimension_small_ziggurat_0", "string_dimension_small_ziggurat_-1", "string_dimension_small_ziggurat_-2", "string_dimension_small_ziggurat_-3" ],
    "vision_levels": "isolated_tower",
    "name": "inverted ziggurat",
    "sym": "Z",
    "color": "light_gray",
    "see_cost": "all_clear"
  },
  {
    "type": "mapgen",
    "om_terrain": [ "string_dimension_small_ziggurat_1" ],
    "object": {
      "fill_ter": "t_string_xyz",
      "rows": [
        "                        ",
        " ,,,,,,,,,,,,,,,,,,,,,, ",
        " ,...................., ",
        " ,...................., ",
        " ,...................., ",
        " ,...................., ",
        " ,...................., ",
        " ,...................., ",
        " ,...................., ",
        " ,...................., ",
        " ,...................., ",
        " ,...................., ",
        " ,...................., ",
        " ,...................., ",
        " ,...................., ",
        " ,...................., ",
        " ,...................., ",
        " ,...................., ",
        " ,...................., ",
        " ,...................., ",
        " ,...................., ",
        " ,...................., ",
        " ,,,,,,,,,,,,,,,,,,,,,, ",
        "                        "
      ],
      "palettes": [ "string_dimension_small_ziggurat_palette" ]
    }
  },
  {
    "type": "mapgen",
    "om_terrain": [ "string_dimension_small_ziggurat_0" ],
    "object": {
      "rows": [
        "222222222222222222222222",
        "211111111111111111111112",
        "21####################12",
        "21#.-----------------#12",
        "21#.................-#12",
        "21#.#..............#-#12",
        "21#.c..............c-#12",
        "21#.c...@......@...c-#12",
        "21#.#cccccccccccccc#-#12",
        "21#.c..............c-#12",
        "21#.c.#cccccccccc#.c-#12",
        "21#.c.c..........c.c-#12",
        "21#.c.c..........c.c-#12",
        "21#.c.#cccccccccc#.c-#12",
        "21#.c..............c-#12",
        "21#.#..............#-#12",
        "21#.c..............c-#12",
        "21#.c..............c-#12",
        "21#.#..............#-#12",
        "21#.................-#12",
        "21#.................>#12",
        "21#########++#########12",
        "2111111111,,,,1111111112",
        "222222222,,,,,2222222222"
      ],
      "palettes": [ "string_dimension_small_ziggurat_palette" ],
      "monster": { "@": { "monster": "mon_zombie_brute_string_dimension" } },
      "place_loot": [
        { "item": "string_dimension_partigiana_ixwa", "x": 9, "y": 6 },
        { "item": "string_dimension_partigiana_ixwa", "x": 16, "y": 7 }
      ],
      "terrain": { "@": "t_metal_floor" },
      "place_graffiti": [
        { "text": "Six lines of text you cannot understand, each in different character sets.", "x": 10, "y": 21 },
        { "text": "Four simple images: A circle with an alien symbol inside, a human heart, a human face that looks scared, and a human face with a slack jaw and closed eyes.", "x": 13, "y": 21 }
      ]
    }
  },
  {
    "type": "mapgen",
    "om_terrain": [ "string_dimension_small_ziggurat_-1" ],
    "object": {
      "fill_ter": "t_string_xyz",
      "rows": [
        "                        ",
        "                        ",
        "  ####################  ",
        "  ##.................#  ",
        "  ##>---------------.#  ",
        "  ##----------------.#  ",
        "  ##----------------.#  ",
        "  ##----------------.#  ",
        "  ##----------------.#  ",
        "  ##----------------.#  ",
        "  ##----------------.#  ",
        "  ##----------------.#  ",
        "  ##----------------.#  ",
        "  ##----------------.#  ",
        "  ##----------------.#  ",
        "  ##----------------.#  ",
        "  ##----------------.#  ",
        "  ##----------------.#  ",
        "  ##----------------.#  ",
        "  ##----------------.#  ",
        "  ##----------------<#  ",
        "  ####################  ",
        "                        ",
        "                        "
      ],
      "palettes": [ "string_dimension_small_ziggurat_palette" ]
    }
  },
  {
    "type": "mapgen",
    "om_terrain": [ "string_dimension_small_ziggurat_-2" ],
    "object": {
      "fill_ter": "t_string_xyz",
      "rows": [
        "                        ",
        "                        ",
        "                        ",
        "   ##################   ",
        "   #<...............#   ",
        "   #................#   ",
        "   #cccccccccccccccc#   ",
        "   #................#   ",
        "   #................#   ",
        "   #................#   ",
        "   #cccccccccccccccc#   ",
        "   #.....d..........#   ",
        "   #.....d..........#   ",
        "   #cccccccccccccccc#   ",
        "   #................#   ",
        "   #................#   ",
        "   #................#   ",
        "   #cccccccccccccccc#   ",
        "   #................#   ",
        "   #................#   ",
        "   ##################   ",
        "                        ",
        "                        ",
        "                        "
      ],
      "palettes": [ "string_dimension_small_ziggurat_palette" ]
    }
  },
  {
    "type": "mapgen",
    "om_terrain": [ "string_dimension_small_ziggurat_-3"] ,
    "object": {
      "fill_ter": "t_string_xyz",
      "rows": [
        "                        ",
        "                        ",
        "                        ",
        "                        ",
        "                        ",
        "                        ",
        "                        ",
        "                        ",
        "         ######         ",
        "         #....#         ",
        "        ##....#         ",
        "        #u....#         ",
        "        #u....#         ",
        "        ##....#         ",
        "         #....#         ",
        "         ######         ",
        "                        ",
        "                        ",
        "                        ",
        "                        ",
        "                        ",
        "                        ",
        "                        ",
        "                        "
      ],
      "palettes": [ "string_dimension_small_ziggurat_palette" ]
    }
  }
]
