[
  {
    "type": "mapgen",
    "method": "json",
    "weight": 100,
    "om_terrain": [
      [ "hive_edge_00", "hive_edge_10", "hive_edge_20" ],
      [ "hive_edge_01", "hive", "hive_edge_21" ],
      [ "hive_edge_02", "hive_edge_12", "hive_edge_22" ]
    ],
    "object": {
      "fill_ter": "t_region_groundcover",
      "rows": [
        "                                    ############                        ",
        "                               #####################                    ",
        "                             ##########|...|||###########               ",
        "                            #####.....|.....|.....#########             ",
        "                          #####.+.....|.....+.....|...######            ",
        "                        ######..|.....|.....|.....|.....#####           ",
        "                      ######...|||...|||...|||...|+|...|||#####         ",
        "                    ######.||.||.+|.||.+|.||.||.||.||.||.||#####        ",
        "                  ######....|||...|||...|||...|||...|||...|||###        ",
        "                ######.|.....|.....|.....|.....|.....|.....|..###       ",
        "            ########...|.....+.....|.....|.....+.....|.....+...###      ",
        "          ########.....|.....|.....+.....|.....|.....|.....|...####     ",
        "        ######..|||...|||...|||...|||...|||...|||...|+|...|||...###     ",
        "      ######||.||.+|.||.||.||.|+.||.||.||.||.||.||.||.||.||.||.||###    ",
        "     #####...|+|...|||...|||...|||...|||...+||...|||...|||...|||.###    ",
        "    ####|.....|.....|.....|.....|.....|.....|.....|.....+.....|...##    ",
        "   ####.|.....|.....|.....+.....|.....|.....|.....|.....|.....+...###   ",
        "   ###..|.....|.....|.....|.....|.....|.....|.....|.....|.....|...###   ",
        "  ###..|+|...|||...|+|...|||...|||...+||...|||...|||...|||...|||...##   ",
        " ####.||.||.||:||.||:||.||.||.||.||.||.||.||.||.||.|+.||.||.|+.||.|##   ",
        " ###|||...|||:::|||:::|||...|+|...|||...|||...|||...|||...|||...|||##   ",
        " ###.|.....|:::::|:::::|.....|.....+.....|.....|.....|.....|.....|.##   ",
        " ##..|.....|:::::|:::::+.....|.....|.....|.....+.....|.....|.....|.##   ",
        " ##..|.....|:::::+:::::|.....|.....|.....|.....|.....|.....|.....|.##   ",
        "###.|+|...|+|:::|||:::|||...|||...|||...|||...|||...|+|...|||...|+|###  ",
        "###||.||.||:||:+|:||:||.||.|+.||.||.||.+|.|+.||.||.||.||.||.||.||..###  ",
        "##||...|||:::|||:::|||...|||...|||...|||...|||...|||...|||...|||....### ",
        "##|.....|:::::|:::::|.....|.....|.....+.....|.....|.....|.....+.....### ",
        "##|.....+:::::|:::::+.....|.....|.....|.....|.....|.....+.....|.....|###",
        "##|.....|:::::|:::::|.....+.....|.....|.....|.....|.....|.....|.....|###",
        "##||...|||:::|+|:::|||...|||...|||...|||...|||...|+|...|||...|||...|||##",
        "##.||.||.||:||.||:||.||.||.||.|+.||.||.||.||.|+.||.||.||.||.||.||.||.|##",
        "##..|||...|||...|||...|||...|||...|||...|||...|||...|||...|||...|||...##",
        "##...|.....|.....|.....+.....|.....|.....|.....|.....+.....|.....|....##",
        "##...|.....+.....|.....|.....|.....|.....+.....|.....|.....|.....+....##",
        "##...|.....|.....|.....|.....|.....|.....|.....|.....|.....|.....|....##",
        "##..|+|...|||...||+...|||...|+|...|||...|||...|||...|||...|+|...|||...##",
        "###||.||.||.||.||.||.||.||.||.||.||.|+.||.||.||.|+.||.||.||.||.||.||.|##",
        "###|...|||...|||...|||...|||...|||...|||...|||...|||...|||...|||...|+|##",
        " ###....|.....|.....+.....|.....|.....|.....|.....|.....|.....|.....|.##",
        " ####...+.....|.....|.....|.....|.....|.....+.....|.....|.....|.....|###",
        "  ###...|.....|.....|.....|.....|.....|.....|.....|.....|.....|.....|###",
        "   ###.|||...|||...|||...|||...|||...|+|...|||...|||...+||...|||....### ",
        "   ###||.|+.||.||.||.||.||.||.||.||.||.||.||.||.||.|+.||.||.||.||.||### ",
        "   ####...|||...|||...|+|...||+...|||...|||...|||...|||...|||...|+|.##  ",
        "    ###....|.....|.....|.....|.....|.....|.....|.....|.....|.....|.###  ",
        "     ###...|.....+.....|.....|.....+.....|.....|.....|.....|.....|.###  ",
        "     ###...|.....|.....|.....|.....|.....|.....+.....|.....|.....|###   ",
        "      ##..|||...|||...|||...|||...|||...|+|...|||...|||...+++...#####   ",
        "      ##.||.||.||.||.||.||.||.|+.||.||.||.||.||.||.||.||.++.||#####     ",
        "      ##+|...|+|...|||...|||...|||...|||...|||...|||...||+...#####      ",
        "      ##|.....|.....|.....+.....|.....|.....|.....|.....+....###        ",
        "      ###.....|.....|.....|.....+.....|.....|.....+.....+....           ",
        "      ###.....|.....|.....|.....|.....|.....+.....|.....+...            ",
        "      ####...|||...|||...|||...|||...|||...|||...|||...|+..             ",
        "       ###..||.||.|+.||.|+.||.||.||.||.+|.||.||.|+.||.||#.              ",
        "       ####|+...|||...|||...|||...|||...|||...|||...|||###              ",
        "        ###|.....|.....|.....|.....|.....|.....|.....|.###              ",
        "        ####.....|.....|.....|.....+.....|.....+.....|.##               ",
        "         ###.....|.....+.....|.....|.....|.....|.....+###               ",
        "          ###...|||...|||...|+|...|||...||+...|||...||###               ",
        "          ####.||.||.||.||.||.||.||.+|.||.||.||.||.||.##                ",
        "           ####+...|||...|||...|||...|||...|||...|+|..##                ",
        "            ####....|.....+.....|.....|.....|.....|...##                ",
        "             ####...+.....|.....|.....+.....|.....|..###                ",
        "              ####..|.....|.....+.....|.....|.....|..###                ",
        "               #####||...|||...|||...|||...|||...||#####                ",
        "                ######|.||.+|.||.||.||.||.|+.||..######                 ",
        "                 ########...|||...|+|...|||...|#######                  ",
        "                    ###########....|.....##########                     ",
        "                      ############################                      ",
        "                             ##############                             "
      ],
      "terrain": { "|": "t_wax", "#": "t_wax", ".": "t_floor_wax", ":": "t_floor_wax", "+": "t_floor_wax" },
      "place_npcs": [ { "class": "apis", "x": 14, "y": 22 } ],
      "item": { ".": { "item": "honeycomb", "chance": 1 }, ":": { "item": "royal_jelly", "chance": 10, "repeat": [ 1, 3 ] } },
      "monster": { ".": { "group": "GROUP_BEEHIVE", "chance": 3 } }
    }
  },
  {
    "type": "mapgen",
    "method": "json",
    "om_terrain": [
      [ "hive_edge_00_roof", "hive_edge_10_roof", "hive_edge_20_roof" ],
      [ "hive_edge_01_roof", "hive_roof", "hive_edge_21_roof" ],
      [ "hive_edge_02_roof", "hive_edge_12_roof", "hive_edge_22_roof" ]
    ],
    "object": {
      "rows": [
        "                                    ............                        ",
        "                               .....................                    ",
        "                             ............................               ",
        "                            ...............................             ",
        "                          ..................................            ",
        "                        .....................................           ",
        "                      .........................................         ",
        "                    ............................................        ",
        "                  ..............................................        ",
        "                .................................................       ",
        "            ......................................................      ",
        "          .........................................................     ",
        "        ...........................................................     ",
        "      ..............................................................    ",
        "     ...............................................................    ",
        "    ................................................................    ",
        "   ..................................................................   ",
        "   ..................................................................   ",
        "  ...................................................................   ",
        " ....................................................................   ",
        " ....................................................................   ",
        " ....................................................................   ",
        " ....................................................................   ",
        " ....................................................................   ",
        "......................................................................  ",
        "......................................................................  ",
        "....................................................................... ",
        "....................................................................... ",
        "........................................................................",
        "........................................................................",
        "........................................................................",
        "........................................................................",
        "........................................................................",
        "........................................................................",
        "........................................................................",
        "........................................................................",
        "........................................................................",
        "........................................................................",
        "........................................................................",
        " .......................................................................",
        " .......................................................................",
        "  ......................................................................",
        "   .................................................................... ",
        "   .................................................................... ",
        "   ...................................................................  ",
        "    ..................................................................  ",
        "     .................................................................  ",
        "     ................................................................   ",
        "      ...............................................................   ",
        "      .............................................................     ",
        "      ............................................................      ",
        "      ..........................................................        ",
        "      .......................................................           ",
        "      ......................................................            ",
        "      .....................................................             ",
        "       ...................................................              ",
        "       ...................................................              ",
        "        ..................................................              ",
        "        .................................................               ",
        "         ................................................               ",
        "          ...............................................               ",
        "          ..............................................                ",
        "           .............................................                ",
        "            ............................................                ",
        "             ...........................................                ",
        "              ..........................................                ",
        "               .........................................                ",
        "                .......................................                 ",
        "                 .....................................                  ",
        "                    ...............................                     ",
        "                      ............................                      ",
        "                             ..............                             "
      ],
      "terrain": { " ": "t_open_air", ".": "t_floor_wax" }
    }
  }
]
