[
  {
    "type": "mapgen",
    "method": "json",
    "om_terrain": "nest_dermatik",
    "object": {
	  "fill_ter": "t_region_groundcover",
      "rows": [
        "                        ",
        "       t  t   -     t   ",
        "  t   -    ----         ",
        "     ---...-..---       ",
        "    --.--..-...--- -    ",
        "    -..0-.--0..------   ",
        "   ---.--.---..-..---   ",
        " t----....--.---..-- t  ",
        "  ----..---.....-0---   ",
        "  --..---..-....---.-   ",
        "  ---.------....--0.--  ",
        "   --...-.-.....--...-- ",
        "  ---.--.-.......-..--- ",
        " t--------......-.-0--  ",
        "  -...-........---...-  ",
        " --.0.--.........--.--  ",
        "  --.-.........--.---   ",
        " -----.......---.-.0--  ",
        "--.0..-..-.-.-..0-...-  ",
        " --.-----.----......--  ",
        " ------...--..0....--   ",
        "   --<--..0---.-----    ",
        "  t   ---------- -   t  ",
        "       --- --           "
      ],
      "terrain": {
        "t": [ "t_region_tree", "t_region_groundcover" ],
        ",": [ "t_region_tree" ],
        "-": [ "t_wall_dirt" ],
		"#": [ "_wall_paper" ],
        ".": [ "t_mud_underground", "t_floor_paper" ],
		"0": [ "t_pit_shallow" ],
		"<": [ "t_slope_up" ]
      },
     "monster": { "0": { "group": "GROUP_DERMATIK_INCUB", "chance": 50 } },
	 "place_fields": [ 
	 { "field": "fd_blood", "x": [ 3, 19 ], "y": [ 4, 20 ], "repeat": [ 20, 30 ] },
	 { "field": "fd_blood_insect", "x": [ 3, 19 ], "y": [ 4, 20 ], "repeat": [ 20, 30 ] }
	 ],	 
	 "place_monster": [
	   { "monster": "mon_dermatik_larva", "x": [ 3, 22 ], "y": [ 8, 22 ], "repeat": [ 2, 10 ] },
	   { "monster": "mon_dermatik_midwife", "x": [ 10, 12 ], "y": [ 14, 17 ], "repeat": [ 0, 2 ] }
	   ],
      "place_monsters": [ 
	    { "monster": "GROUP_DERMATIK", "x": [ 0, 23 ], "y": [ 0, 23 ], "repeat": [ 0, 3 ], "density": 0.1 } 
		]
     }
	},
    {
    "type": "mapgen",
    "method": "json",
    "om_terrain": "nest_dermatik_roof",
    "object": {
	  "fill_ter": "t_open_air",
      "rows": [
        "                        ",
        "                        ",
        "            ,,          ",
        "      ,,,,,,,,,         ",
        "     ,,,,,,,,,,,,,      ",
        "    ,,,,,,,,,,,,,,,,    ",
        "    ,,,,,,,,,,,,,,,,    ",
        "    ,,,,,,,,,,,,,,,,    ",
        "   ,,,,,,,,,,,,,,,,,    ",
        "   ,,,,,,,,,,,,,,,,,,   ",
        "   ,,,,,,,,,,,,,,,,,,,  ",
        "   ,,,,,,,,,,,,,,,,,,,  ",
        "   ,,,,,,,,,,,,,,,,,,,  ",
        "   ,,,,,,,,,,,,,,,,,,,  ",
        "  ,,,,,,,,,,,,,,,,,,,,  ",
        "  ,,,,,,,,,,,,,,,,,,,,  ",
        "  ,,,,,,,,,,,,,,,,,,,   ",
        " ,,,,,,,,,,,,,,,,,,,,   ",
        " ,,,,,,,,,,,,,,,,,,,,,  ",
        " ,,,,,,,,,,,,,,,,,,,,,  ",
        "   ,,,,,,,,,,,,,,,,,,   ",
        "     > ,,,,,,,,,,,,     ",
        "        ,,,   ,         ",
        "                        "
      ],
      "terrain": {
        ",": [ "t_dirtfloor_no_roof" ],
		">": [ "t_slope_down" ]
    },
      "place_monsters": [ 
	    { "monster": "GROUP_DERMATIK", "x": [ 0, 23 ], "y": [ 0, 23 ], "repeat": [ 0, 3 ], "density": 0.1 } 
	]
   }
  }
]  