[
  {
    "type": "mapgen",
    "method": "json",
    "om_terrain": [ "s_airsoft" ],
    "object": {
      "fill_ter": "t_thconc_floor",
      "rows": [
        "_____=_____--_____=_____",
        "_____=_____--_____=_____",
        "_____=_____--_____=_____",
        "_____=_____--_____=_____",
        "_____=_____--_____=_____",
        "___À_=___À_--___À_=___À_",
        "_____=_____--_____=_____",
        "------------------------",
        "...###oooo#**#oooo###,..",
        "...#R RRRR    RRRR R#,..",
        "...oR              Ro,..",
        "...oR  RRR    RRR  Ro,..",
        "...#R  RRR    RRR  R#,..",
        "...#R              R#,..",
        "...#cccccmcccccccc R#,..",
        "...#                #,..",
        "...#RRRRRRRRRR RRRRR#ɤŦŦ",
        "...#||||||||||+|||||#,,Ŧ",
        "...#tS|F yhTh| sssss#,,Ŧ",
        "...#~~|C  hTh|      *,,Ŧ",
        "...#~~|v     |      #DDŦ",
        "...#~~+      + sssss#DDŦ",
        "...##################ŦŦŦ",
        "....................^..."
      ],
      "palettes": [ "parametrized_linoleum_palette", "parametrized_walls_palette" ],
      "toilets": { "t": {  } },
      "terrain": {
        ".": "t_region_groundcover_urban",
        "À": "t_pavement",
        "_": "t_pavement",
        "=": "t_pavement_y",
        "-": "t_sidewalk",
        ",": "t_thconc_floor",
        "+": [ [ "t_door_o", 1 ], [ "t_door_c", 2 ] ],
        "*": [ [ "t_door_locked_alarm", 3 ], [ "t_door_c", 2 ], [ "t_door_o", 1 ] ],
        "^": "t_gutter_downspout",
        "Ŧ": "t_chainfence",
        "ɤ": "t_chaingate_c",
        "o": "t_window_alarm",
        "S": { "param": "linoleum_color", "fallback": "t_linoleum_gray" },
        "t": { "param": "linoleum_color", "fallback": "t_linoleum_gray" }
      },
      "furniture": {
        "R": "f_rack",
        "C": "f_counter",
        "c": "f_counter",
        "m": "f_counter",
        "h": "f_chair",
        "T": "f_table",
        "F": "f_fridge",
        "y": "f_trashcan",
        "v": "f_sink",
        "S": "f_sink",
        "s": "f_warehouse_shelf",
        "D": "f_dumpster"
      },
      "vehicles": { "É": { "vehicle": "parking_garage", "chance": 40, "rotation": 90 } },
      "items": {
        "R": {
          "item": {
            "subtype": "distribution",
            "entries": [ { "group": "paintball_clothes", "prob": 30 }, { "group": "paintball_items", "prob": 70 } ]
          },
          "repeat": [ 2, 4 ],
          "chance": 60
        },
        "T": { "item": "dishes_dining", "chance": 20 },
        "F": { "item": "SUS_fridge_breakroom", "chance": 75 },
        "y": { "item": "SUS_trash_trashcan", "chance": 100 },
        "S": { "item": "SUS_bathroom_sink", "chance": 100 },
        "v": { "item": "SUS_bathroom_sink", "chance": 100 },
        "C": { "item": "SUS_appliances_cupboard", "chance": 100 },
        "s": {
          "item": {
            "subtype": "distribution",
            "entries": [ { "group": "paintball_clothes", "prob": 30 }, { "group": "paintball_items", "prob": 70 } ]
          },
          "repeat": [ 4, 10 ],
          "chance": 60
        },
        "D": { "item": "SUS_trash_dumpster", "chance": 40 },
        "m": { "item": "cash_register_random", "chance": 100 },
        "t": { "item": "SUS_toilet", "chance": 100 }
      }
    }
  },
  {
    "type": "mapgen",
    "method": "json",
    "om_terrain": [ "s_airsoft_roof" ],
    "object": {
      "fill_ter": "t_flat_roof",
      "rows": [
        "                        ",
        "                        ",
        "                        ",
        "                        ",
        "                        ",
        "                        ",
        "                        ",
        "                        ",
        "   5----------------5   ",
        "   -................-   ",
        "   -................-   ",
        "   -................-   ",
        "   -................-   ",
        "   -................-   ",
        "   -................-   ",
        "   -................-   ",
        "   -................-   ",
        "   -.....1..........-   ",
        "   -................-   ",
        "   -................-   ",
        "   -................-   ",
        "   -................-   ",
        "   5----------------5   ",
        "                        "
      ],
      "palettes": [ "roof_palette" ]
    }
  }
]
