[
  {
    "type": "mapgen",
    "method": "json",
    "om_terrain": [ "s_cardealer" ],
    "object": {
      "fill_ter": "t_pavement",
      "rows": [
        "be     bbbbbbbbbbbbbbbbb",
        "be     a    a    a    ab",
        "be     a    a    a    ab",
        "be     a    a    a    ab",
        "be     a    a    a    ab",
        "be     a    a    a    ab",
        "be     a    a    a    ab",
        "be                     b",
        "be                     b",
        "be                     b",
        "be                     b",
        "be                     b",
        "be                     b",
        "be               aaaaaab",
        "be                     b",
        "be                     b",
        "beeeeeeeee             b",
        "b#fgfffff#             b",
        "b#ndddddk#       aaaaaab",
        "b#dddddlk#;            b",
        "b#kkkkddk####          b",
        "b#mldkddd#ji#          b",
        "b#mddddmdghh#          b",
        "b############    aaaaaab"
      ],
      "palettes": [ "parametrized_linoleum_palette", "parametrized_walls_palette" ],
      "terrain": {
        "a": "t_pavement_y",
        "b": "t_region_groundcover_urban",
        "d": "t_floor",
        "e": "t_sidewalk",
        "f": "t_window",
        "g": "t_door_c",
        "h": { "param": "linoleum_color", "fallback": "t_linoleum_gray" },
        "i": { "param": "linoleum_color", "fallback": "t_linoleum_gray" },
        "j": { "param": "linoleum_color", "fallback": "t_linoleum_gray" },
        "k": "t_floor",
        "l": "t_floor",
        "m": "t_floor",
        "n": "t_floor",
        ";": "t_gutter_downspout"
      },
      "furniture": { "j": "f_sink", "k": "f_table", "l": "f_chair", "m": "f_locker" },
      "vendingmachines": { "n": { "lootable": true } },
      "items": { "i": { "item": "SUS_toilet", "chance": 50 } },
      "toilets": { "i": {  } },
      "place_loot": [
        { "group": "office", "chance": 50, "repeat": [ 5 ], "x": [ 7, 7 ], "y": [ 22, 22 ] },
        { "group": "office", "chance": 50, "repeat": [ 5 ], "x": [ 2, 2 ], "y": [ 21, 22 ] },
        { "group": "SUS_office_mess", "chance": 50, "repeat": [ 10 ], "x": [ 3, 8 ], "y": [ 18, 22 ] },
        { "group": "cleaning", "chance": 50, "repeat": [ 2 ], "x": [ 10, 10 ], "y": [ 21, 21 ] },
        { "group": "vending_drink", "chance": 50, "repeat": [ 1 ], "x": [ 2, 2 ], "y": [ 18, 18 ] },
        { "group": "road", "chance": 50, "repeat": [ 2 ], "x": [ 14, 21 ], "y": [ 16, 22 ] },
        { "group": "road", "chance": 50, "repeat": [ 5 ], "x": [ 2, 21 ], "y": [ 2, 15 ] }
      ],
      "place_vehicles": [
        { "vehicle": "dealership", "x": [ 9, 9 ], "y": [ 3, 3 ], "chance": 50, "rotation": 270 },
        { "vehicle": "dealership", "x": [ 14, 14 ], "y": [ 3, 3 ], "chance": 50, "rotation": 270 },
        { "vehicle": "dealership", "x": [ 19, 19 ], "y": [ 3, 3 ], "chance": 50, "rotation": 270 },
        { "vehicle": "dealership", "x": [ 20, 20 ], "y": [ 15, 15 ], "chance": 50, "rotation": 0 },
        { "vehicle": "dealership", "x": [ 20, 20 ], "y": [ 19, 19 ], "chance": 50, "rotation": 0 }
      ]
    }
  },
  {
    "type": "mapgen",
    "method": "json",
    "om_terrain": [ "s_cardealer_roof" ],
    "object": {
      "fill_ter": "t_flat_roof",
      "rows": [
        "                        ",
        "                        ",
        "                        ",
        "                        ",
        "                        ",
        "                        ",
        "                        ",
        "                        ",
        "                        ",
        "                        ",
        "                        ",
        "                        ",
        "                        ",
        "                        ",
        "                        ",
        "                        ",
        "                        ",
        " ---------              ",
        " -.......-              ",
        " -...A...5              ",
        " -.......----           ",
        " -.........=-           ",
        " -..........-           ",
        " ------------           "
      ],
      "palettes": [ "roof_palette" ]
    }
  }
]
