[
  {
    "type": "mapgen",
    "method": "json",
    "om_terrain": [ "s_hunting" ],
    "weight": 300,
    "object": {
      "fill_ter": "t_floor",
      "rows": [
        ".`''''`''''ss''''`''''`.",
        ".`''''`''''ss''''`''''`.",
        ".`''''`''''ss''''`''''`.",
        ".`''''`''''ss''''`''''`.",
        ".`''''`''''ss''''`''''`.",
        ".--~~~~~~~-**-~~~~~~~--.",
        ".| RRRRRRR^  ^RRRRRRR |.",
        ".|                    |.",
        ".| RRRRRRR    RRRRRRR |.",
        ".| RRRRRRR    RRRRRRR |.",
        ".|                    |.",
        ".|^     mm    RRRRRRR |.",
        ".|####        RRRRRRR |.",
        ".|R  #    ^           |.",
        ".|R c#   B|-----------|.",
        ".|R  #   B|FFFF  LYIII|.",
        ".|R  C    +         c |.",
        ".|RxX#^  Y|f###Y  ^FFF|.",
        ".|-----+--------------|.",
        ".|&,,|,,,,,,,,,|OOOOOO|.",
        ".|,,,+,,,,,,,,,+,,,,,,|.",
        ".|%y,|rrrrrr,,,|oooooo|.",
        ".------------*---------.",
        "........4..............."
      ],
      "palettes": [ "hunting_store_palette" ],
      "place_loot": [
        { "group": "guns_rifle_hunting_display", "x": 2, "y": 13, "chance": 70, "repeat": [ 2, 3 ] },
        { "group": "guns_pistol_hunting_display", "x": 2, "y": 13, "chance": 70, "repeat": [ 2, 3 ] },
        { "group": "guns_shotgun_common_display", "x": 2, "y": 14, "chance": 70, "repeat": [ 1, 2 ] },
        { "group": "SUS_hunting_archery", "x": 2, "y": 15, "chance": 80, "repeat": [ 4, 5 ] },
        { "group": "archery_ammo", "x": 2, "y": 16, "chance": 80, "repeat": [ 4, 6 ] },
        { "group": "archery_loaded_quivers", "x": 2, "y": 16, "chance": 40, "repeat": [ 2, 4 ] },
        { "group": "archery_loaded_quivers", "x": [ 8, 9 ], "y": 11, "chance": 60 },
        { "group": "archery_mods", "x": 2, "y": 17, "chance": 70, "repeat": [ 3, 4 ] },
        { "group": "gun_cases", "x": [ 3, 9 ], "y": 6, "chance": 80, "repeat": [ 6, 7 ] },
        { "group": "archery_quivers", "x": [ 3, 9 ], "y": 6, "chance": 80 },
        { "group": "clothing_hunting", "x": [ 3, 9 ], "y": [ 8, 9 ], "chance": 80, "repeat": [ 12, 14 ] },
        { "group": "tools_hunting", "x": [ 14, 20 ], "y": 6, "chance": 70, "repeat": [ 6, 7 ] },
        { "group": "tools_hunting", "x": [ 14, 20 ], "y": [ 8, 9 ], "chance": 70, "repeat": [ 12, 14 ] },
        { "group": "tools_hunting", "x": [ 14, 20 ], "y": [ 11, 12 ], "chance": 70, "repeat": [ 12, 14 ] },
        { "group": "cash_register_random", "x": 5, "y": [ 13, 15 ] }
      ],
      "place_monsters": [ { "monster": "GROUP_ZOMBIE", "x": [ 2, 21 ], "y": 2, "chance": 2, "repeat": [ 2, 3 ] } ]
    }
  },
  {
    "type": "mapgen",
    "method": "json",
    "om_terrain": "s_hunting_roof",
    "object": {
      "fill_ter": "t_flat_roof",
      "rows": [
        "                        ",
        "                        ",
        "                        ",
        "                        ",
        "                        ",
        " ---------------------- ",
        " -....................- ",
        " -....................- ",
        " -....................- ",
        " -....................- ",
        " -....................- ",
        " -....................- ",
        " -....................- ",
        " -....................- ",
        " -....................- ",
        " -....................- ",
        " -....................- ",
        " -....................- ",
        " -....................- ",
        " -....................- ",
        " -...&.........=......- ",
        " -....................- ",
        " -------5-------------- ",
        "                        "
      ],
      "palettes": [ "roof_palette" ],
      "place_nested": [
        {
          "chunks": [
            [ "null", 20 ],
            [ "roof_2x2_utilities_b", 15 ],
            [ "roof_2x2_utilities_c", 5 ],
            [ "roof_2x2_utilities_d", 40 ],
            [ "roof_2x2_utilities", 50 ]
          ],
          "x": [ 4, 17 ],
          "y": [ 15, 16 ]
        }
      ]
    }
  }
]
