[
  {
    "type": "mapgen",
    "method": "json",
    "om_terrain": [ "gym" ],
    "weight": 1000,
    "object": {
      "fill_ter": "t_floor",
      "rows": [
        "  --ss----------------  ",
        "  --ss--,-----,-----,-  ",
        "  --ss--,-----,-----,-  ",
        "  --ss--,-----,-----,-  ",
        "  --ss--,-----,-----,-  ",
        "  --ss--,-----,-----,-  ",
        "  qq++qqqqgggggqqqggqq  ",
        "  xf................^x4 ",
        "  x........?$$$$$$?.0x  ",
        "  xE.E.....$555555$..x  ",
        "  xE.E.....$555555$.0x  ",
        "  xE.E.....$555555$..x  ",
        "  xE.E.....?$$$$$$?.0x  ",
        "  x..........####....x  ",
        "  x...........CC....Bx  ",
        "  x.0.0.0...........Bx  ",
        "  x^.....^VV^..^BBBB^x  ",
        "  xqqqqqqqqqq''qqqqqqx  ",
        "  xLLLLLLLLLx..xfZZZ^x  ",
        "  xBBBB.BBBBx..x.....p  ",
        "  x.........'..'.C.DCp  ",
        "  x+x+x..qqqxx'x...DDx  ",
        "  xSxSx..'.Tx<.xXXXXXx  ",
        "  qqqqqqqqqqqqqqqqqqqq  "
      ],
      "terrain": {
        " ": "t_grass",
        "#": "t_floor",
        "$": "t_fence_rope",
        "'": "t_door_c",
        "+": "t_door_glass_c",
        ",": "t_pavement_y",
        "-": "t_pavement",
        ".": "t_floor",
        "?": "t_chainfence_posts",
        "g": "t_window",
        "p": "t_window_domestic",
        "q": "t_wall_w",
        "s": "t_sidewalk",
        "4": "t_gutter_downspout",
        "<": "t_stairs_up",
        "x": "t_wall_g"
      },
      "furniture": {
        "#": "f_table",
        "0": "f_floor_canvas",
        "5": "f_canvas_floor",
        "B": "f_bench",
        "C": "f_chair",
        "D": "f_desk",
        "E": "f_exercise",
        "L": "f_locker",
        "S": "f_shower",
        "V": "f_vending_c",
        "X": "f_rack",
        "Z": "f_bookcase",
        "^": "f_indoor_plant",
        "f": "f_trashcan"
      },
      "toilets": { "T": {  } },
      "place_items": [
        { "item": "boxing_clothes", "x": [ 3, 11 ], "y": [ 18, 18 ], "chance": 80, "repeat": [ 3, 5 ] },
        { "item": "boxing_clothes", "x": [ 3, 11 ], "y": [ 18, 18 ], "chance": 40, "repeat": [ 1, 2 ] },
        { "item": "boxing_books", "x": [ 17, 19 ], "y": [ 18, 18 ], "chance": 80, "repeat": [ 1, 3 ] },
        { "item": "boxing_misc", "x": [ 16, 20 ], "y": [ 22, 22 ], "chance": 60, "repeat": [ 1, 4 ] },
        { "item": "vending_drink", "x": [ 10, 11 ], "y": [ 16, 16 ], "chance": 70 }
      ]
    }
  },
  {
    "type": "mapgen",
    "method": "json",
    "om_terrain": "gym_roof",
    "weight": 200,
    "object": {
      "fill_ter": "t_flat_roof",
      "rows": [
        "                        ",
        "                        ",
        "                        ",
        "                        ",
        "                        ",
        "                        ",
        "  |2222222222222222223  ",
        "  |..................5  ",
        "  |..................3  ",
        "  |..................3  ",
        "  |..................3  ",
        "  |..................3  ",
        "  |..................3  ",
        "  |..................3  ",
        "  |...#######+####...3  ",
        "  |...#_0________#...3  ",
        "  |...#______ssst#...3  ",
        "  |...#_0____s___#...3  ",
        "  |...#______s__t#...3  ",
        "  |...#_0______tt#...3  ",
        "  |...#######_####...3  ",
        "  |........#___#4.X..3  ",
        "  |....&.=.#_>_#...:.3  ",
        "  |--------#####-----3  "
      ],
      "terrain": {
        ".": "t_flat_roof",
        " ": "t_open_air",
        "#": "t_wall_g",
        "+": "t_door_locked",
        "2": "t_gutter_north",
        "-": "t_gutter_south",
        "3": "t_gutter_east",
        "|": "t_gutter_west",
        ">": "t_stairs_down",
        "5": "t_gutter_drop",
        "_": "t_floor",
        "s": "t_floor",
        "t": "t_floor",
        "0": "t_floor",
        "4": "t_gutter_downspout"
      },
      "furniture": {
        "&": "f_roof_turbine_vent",
        ":": "f_cellphone_booster",
        "X": "f_small_satelitte_dish",
        "=": "f_vent_pipe",
        "b": "f_bench",
        "s": "f_sofa",
        "t": "f_table",
        "0": "f_floor_canvas"
      },
      "place_loot": [ { "item": "television", "x": 16, "y": 19 } ],
      "place_nested": [
        {
          "chunks": [
            [ "null", 20 ],
            [ "roof_2x2_utilities_b", 15 ],
            [ "roof_2x2_utilities_c", 5 ],
            [ "roof_2x2_utilities_d", 20 ],
            [ "roof_2x2_utilities", 30 ],
            [ "roof_2x2_golf", 20 ],
            [ "roof_3x3_wine", 30 ],
            [ "roof_4x4_utility_1", 30 ],
            [ "roof_4x4_party", 15 ],
            [ "roof_16x16_help", 3 ]
          ],
          "x": 4,
          "y": 8
        },
        { "chunks": [ [ "roof_4x4_survivor", 20 ], [ "null", 80 ] ], "x": 9, "y": 16 }
      ]
    }
  },
  {
    "type": "mapgen",
    "method": "json",
    "om_terrain": "gym_upper_roof",
    "weight": 200,
    "object": {
      "fill_ter": "t_flat_roof",
      "rows": [
        "                        ",
        "                        ",
        "                        ",
        "                        ",
        "                        ",
        "                        ",
        "                        ",
        "                        ",
        "                        ",
        "                        ",
        "                        ",
        "                        ",
        "                        ",
        "                        ",
        "      |22222222223      ",
        "      |..........3      ",
        "      |..........3      ",
        "      |..........3      ",
        "      |..........3      ",
        "      |..........3      ",
        "      |-----...5-3      ",
        "           |...3        ",
        "           |...3        ",
        "           -----        "
      ],
      "terrain": {
        ".": "t_flat_roof",
        " ": "t_open_air",
        "2": "t_gutter_north",
        "-": "t_gutter_south",
        "3": "t_gutter_east",
        "|": "t_gutter_west",
        "5": "t_gutter_drop"
      }
    }
  }
]
