[
  {
    "type": "mapgen",
    "method": "json",
    "om_terrain": [ [ "abandoned_textile_mill_b_0_1", "abandoned_textile_mill_b_0_2" ] ],
    "object": {
      "fill_ter": "t_region_groundcover_barren",
      "rows": [
        "                                                ",
        "                                                ",
        "                                                ",
        "    =========================================   ",
        "    =]*]*]*]*]*]*]*]*]*]]+]]]]*]*]*]*]*]*]*]=   ",
        "    =*-----------------]-----]-------------*=   ",
        "    =]-----------------]-----]-------------]=   ",
        "    =*-----------------]-----]-------------*=   ",
        "    =]-]-]-]-]-]-]-]-]-]-]-]-]-]-]-]-]-]-]-]=   ",
        "    =*-----------------]-----]-------------*=   ",
        "    =]-----------------+-----+-------------]=   ",
        "    =*-----------------]-----]-------------*=   ",
        "    =]-]-]-]-]-]-]-]-]-]-]-]-]-]-]-]-]-]-]-]=   ",
        "    =*-----------------]-----]-------------*=   ",
        "    =]-----------------]-----]-------------]=   ",
        "    =*-----------------]-----]-------------*=   ",
        "    =]-]-]-]-]-]-]-]-]-]-]-]-]-]-]-]-]-]-]-]=   ",
        "    =*-----------------]-----]-------------*=   ",
        "    =]-----------------]-----+-------------]=   ",
        "    =*-----------------]-----]-------------*=   ",
        "    =]*]*]*]*]*]*]*]*]*]]+]]]]*]*]*]*]*]*]*]=   ",
        "                                                ",
        "                                                ",
        "                                                "
      ],
      "palettes": [ "abandoned_textile_mill" ],
      "place_monsters": [
        { "monster": "GROUP_ZOMBIE", "x": [ 0, 23 ], "y": [ 0, 21 ], "density": 0.15 },
        { "monster": "GROUP_ZOMBIE", "x": [ 27, 34 ], "y": [ 9, 21 ], "density": 0.3 }
      ]
    }
  },
  {
    "type": "mapgen",
    "method": "json",
    "om_terrain": [ [ "abandoned_textile_mill_b_1_1", "abandoned_textile_mill_b_1_2" ] ],
    "object": {
      "fill_ter": "t_open_air",
      "rows": [
        "                                                ",
        "                                                ",
        "                                                ",
        "                                                ",
        "     ]*]               ]]+]]]]           ]*]    ",
        "     *                 ]     ]             *    ",
        "     ]                       ]             ]    ",
        "                                                ",
        "                                                ",
        "                                                ",
        "                                                ",
        "                                                ",
        "                                                ",
        "                                                ",
        "                                                ",
        "                                                ",
        "                                                ",
        "                                                ",
        "     ]                 ]                   ]    ",
        "     *                 ]                   *    ",
        "     ]*]               ]]+]]]]           ]*]    ",
        "                                                ",
        "                                                ",
        "                                                "
      ],
      "palettes": [ "abandoned_textile_mill" ]
    }
  }
]
