[
  {
    "type": "mapgen",
    "method": "json",
    "om_terrain": [ [ "aircraft_carrier_1a_3" ], [ "aircraft_carrier_2a_3" ] ],
    "object": {
      "fill_ter": "t_metal_floor",
      "rows": [
        "ππππππππππππππππππππππππ",
        "ππππππππππππππππππππππππ",
        "ππππππππππππππππππππππππ",
        "ππππππππππππππππππππππππ",
        "ππππππππππππππππππππππππ",
        "ππππππππππππππππππππππππ",
        "ππππππππππππππππππππππππ",
        "ππππππππππππππππππππππππ",
        "ππππππππππππππππππππππππ",
        "ππππππππππππππππππππππππ",
        "ππππππππππππππππππππππππ",
        "ππππππππ55555555ππππππππ",
        "πππππππ55MG;;;;55πππππππ",
        "ππππππ55F;;;<<;;5πππππππ",
        "ππππππ5F;;;;;;;;5πππππππ",
        "ππππππ5F;;;;;;;;5πππππππ",
        "ππππππ5F;;;;;;;;5πππππππ",
        "ππππππ555+555;;;5πππππππ",
        "ππππππ5C;;hC5;;;5πππππππ",
        "ππππππ5C;;;;+;;;5πππππππ",
        "ππππππ5Ch;hC5;;;5πππππππ",
        "ππππππ5Ch;;C5;;;5πππππππ",
        "ππππππ5C;;hC5;;;5πππππππ",
        "ππππππ5Ch;hC5;;M5πππππππ",
        "ππππππ5Ch;hC5;;;5πππππππ",
        "ππππππ5Ch;hC5;;;5πππππππ",
        "ππππππ5F;;;C5;;;5πππππππ",
        "ππππππ5F;;hC5;;;5πππππππ",
        "ππππππ5F;;;;+;;;5πππππππ",
        "ππππππ5Ch;;C5;;;5πππππππ",
        "ππππππ555+555;;;5πππππππ",
        "ππππππ5Ch;;F5;;M5πππππππ",
        "ππππππ5Ch;;F5;;;5πππππππ",
        "ππππππ5C;;;;5;;;5πππππππ",
        "πππππ;5ChC5+5;;;5;ππππππ",
        "πππ;;;5CCC5;;;;;5;;;ππππ",
        "πππ;5555555+5555555;ππππ",
        "πππ;+;;;;;;;;;;;;;+;ππππ",
        "ππππλF;;;;;;;;;;;Cλ;ππππ",
        "ππππλF;;;;;;;;;;;Cλπππππ",
        "ππππλF;;Ch;hh;C;;Cλπππππ",
        "ππππλF;;;CCCCC;;;Cλπππππ",
        "ππππλλ;;;;;;;;;;;λλπππππ",
        "πππππλ;;;;;;;;;;;λππππππ",
        "πππππλ;;Chh;;hC;;λππππππ",
        "πππππλλ;;CCCCC;;λλππππππ",
        "ππππππλλ;;;;;;;;λπππππππ",
        "πππππππλλλλλλλλλλπππππππ"
      ],
      "palettes": [ "aircraft_carrier_palette" ],
      "place_monster": [
        { "monster": "mon_turret_rifle", "x": 5, "y": 34},
        { "monster": "mon_turret_rifle", "x": 3, "y": 35},
        { "monster": "mon_turret_rifle", "x": 3, "y": 37}
      ]
    }
  }
]
