[
  {
    "type": "mapgen",
    "om_terrain": [ [ "aircraft_carrier_1a_4" ], [ "aircraft_carrier_2a_4" ] ],
    "object": {
      "fill_ter": "t_metal_roof",
      "rows": [
        "ππππππππππππππππππππππππ",
        "ππππππππππππππππππππππππ",
        "ππππππππππππππππππππππππ",
        "ππππππππππππππππππππππππ",
        "ππππππππππππππππππππππππ",
        "ππππππππππππππππππππππππ",
        "ππππππππππππππππππππππππ",
        "ππππππππππππππππππππππππ",
        "ππππππππππππππππππππππππ",
        "ππππππππππππππππππππππππ",
        "ππππππππππππππππππππππππ",
        "ππππππππööööööööππππππππ",
        "πππππππööööööööööπππππππ",
        "ππππππöööööööööööπππππππ",
        "ππππππöööööööööööπππππππ",
        "ππππππöööööööööööπππππππ",
        "ππππππöööööööööööπππππππ",
        "ππππππöööööoöööööπππππππ",
        "ππππππöööööööööööπππππππ",
        "ππππππöööööööööööπππππππ",
        "ππππππöööööööööööπππππππ",
        "ππππππöööööööööööπππππππ",
        "ππππππöööööööööööπππππππ",
        "ππππππöööööööööööπππππππ",
        "ππππππöööööööööööπππππππ",
        "ππππππöööööööööööπππππππ",
        "ππππππöööööööööööπππππππ",
        "ππππππöööööööööööπππππππ",
        "ππππππöööööööööööπππππππ",
        "ππππππöööööööööööπππππππ",
        "ππππππöööööÄöööööπππππππ",
        "ππππππöööööööööööπππππππ",
        "ππππππöööööööööööπππππππ",
        "ππππππöööööööööööπππππππ",
        "πππππöööööööööööööππππππ",
        "πππöööööööööööööööööππππ",
        "πππöööööööööööööööööππππ",
        "πππöööööööööööööööööππππ",
        "ππππöööööööoööööööööππππ",
        "ππππöööööööööööööööπππππ",
        "ππππöööööööööööööööπππππ",
        "ππππöööööööööööööööπππππ",
        "ππππöööööööööööööööπππππ",
        "πππππöööööööööööööππππππ",
        "πππππöööööööööööööππππππ",
        "πππππöööööööööööööππππππ",
        "ππππππööÖÖÖÖÖÖÖööπππππππ",
        "πππππππööööööööööπππππππ"
      ],
      "palettes": [ "aircraft_carrier_palette" ]
    }
  }
]
