[
  {
    "type": "mapgen",
    "method": "json",
    "om_terrain": [
      [ "aircraft_carrier_1a_2", "aircraft_carrier_1b_2", "aircraft_carrier_1c_2" ],
      [ "aircraft_carrier_2a_2", "aircraft_carrier_2b_2", "aircraft_carrier_2c_2" ],
      [ "aircraft_carrier_3a_2", "aircraft_carrier_3b_2", "aircraft_carrier_3c_2" ],
      [ "aircraft_carrier_4a_2", "aircraft_carrier_4b_2", "aircraft_carrier_4c_2" ],
      [ "aircraft_carrier_5a_2", "aircraft_carrier_5b_2", "aircraft_carrier_5c_2" ],
      [ "aircraft_carrier_6a_2", "aircraft_carrier_6b_2", "aircraft_carrier_6c_2" ],
      [ "aircraft_carrier_7a_2", "aircraft_carrier_7b_2", "aircraft_carrier_7c_2" ],
      [ "aircraft_carrier_8a_2", "aircraft_carrier_8b_2", "aircraft_carrier_8c_2" ],
      [ "aircraft_carrier_9a_2", "aircraft_carrier_9b_2", "aircraft_carrier_9c_2" ],
      [ "aircraft_carrier_10a_2", "aircraft_carrier_10b_2", "aircraft_carrier_10c_2" ],
      [ "aircraft_carrier_11a_2", "aircraft_carrier_11b_2", "aircraft_carrier_11c_2" ],
      [ "aircraft_carrier_12a_2", "aircraft_carrier_12b_2", "aircraft_carrier_12c_2" ],
      [ "aircraft_carrier_13a_2", "aircraft_carrier_13b_2", "aircraft_carrier_13c_2" ]
    ],
    "object": {
      "fill_ter": "t_metal_floor",
      "rows": [
        "ππππππππππππππππ-11111ππππππππππππππππππππππππππππππππππππππππππππππππππ",
        "ππππππππππππππππ-11111111113811111ππππππππππππππππππππππππππππππππππππππ",
        "ππππππππππππππππ-1111111111381111111811111111183ππππππππππππππππππππππππ",
        "ππππππππππππππππ-1111111111381111111811111111183111111-πππππππππππππππππ",
        "ππππππππππππππππ-1111111111381111111211111111183111111-πππππππππππππππππ",
        "ππππππππππππππππ-1111111111381111111211111111183111111-πππππππππππππππππ",
        "ππππππππππππππππ-1111111111381111111811111111183111111-πππππππππππππππππ",
        "ππππππππππππππππ-1111111111381111111811111111183111111-πππππππππππππππππ",
        "ππππππππππππππππ-1111111113811111112111111111183111111-πππππππππππππππππ",
        "ππππππππππππππππ-1111111113811111112111111111183111111-πππππππππππππππππ",
        "ππππππππππππππππ-1111111113811111118111111111831111111-πππππππππππππππππ",
        "ππππππππππππππππ-1111111113811111118111111111831111111-πππππππππππππππππ",
        "ππππππππππππππππ-1111111113811111112111111111831111111-πππππππππππππππππ",
        "ππππππππππππππππ-1111111113811111112111111111831111111-πππππππππππππππππ",
        "ππππππππππππππππ-1111111113811111118111111111831111111-πππππππππππππππππ",
        "ππππππππππππππππ-1111111138111111181111111111831111111-πππππππππππππππππ",
        "ππππππππππππππππ-1111111138111111121111111111831111111-πππππππππππππππππ",
        "ππππππππππππππππ-1111111138111111121111111118311111111-πππππππππππππππππ",
        "ππππππππππππππππ-1111111138111111181111111118311111111-πππππππππππππππππ",
        "ππππππππππππππππ-1111111138111111181111111118311111111-πππππππππππππππππ",
        "ππππππππππππππππ-1111111138111111121111111118311111111-πππππππππππππππππ",
        "ππππππππππππππππ-1111111138111111121111111118311111111-πππππππππππππππππ",
        "πππππππππππππππ--1111111381111111811111111118311111111-πππππππππππππππππ",
        "πππππππππππππππ-<1111111381111111811111111118311111111-πππππππππππππππππ",
        "πππππππππππππππ-<1111111381111111211111111183111111111-πππππππππππππππππ",
        "πππππππππππππππ-11111111381111111211111111183111111111-πππππππππππππππππ",
        "πππππππππππππππ-11111111381111111811111111183111111111-πππππππππππππππππ",
        "πππππππππππππππ-11111111381111111811111111183111111111-πππππππππππππππππ",
        "πππππππππππππππ-11111113811111112111111111183111111111-πππππππππππππππππ",
        "πππππππππππππππ-11111113811111112111111111183111111111-πππππππππππππππππ",
        "πππππππππππππππ-11111113811111118111111111831111111111-πππππππππππππππππ",
        "πππππππππππππππ-11111113811111118111111111831111111111-πππππππππππππππππ",
        "πππππππππππππππ-11111113811111112111111111831111111111-πππππππππππππππππ",
        "πππππππππππππππ-11111113811111112111111111831111111111---πππππππππππππππ",
        "πππππππππππππππ-111111138111111181111111118311111111111<-πππππππππππππππ",
        "πππππππππππππππ-111111381111111811111111118311111111111<-πππππππππππππππ",
        "πππππππππππππππ-11111138111111121111111111831111111111---πππππππππππππππ",
        "πππππππππππππππ-11111138111111121111111118311111111111-πππππππππππππππππ",
        "πππππππππππππππ-11111138111111181111111118311111111111-πππππππππππππππππ",
        "ππππππππππππππ--11111138111111181111111118311111111111-πππππππππππππππππ",
        "ππππππππππππππ-111111138111111121111111118311111111111-πππππππππππππππππ",
        "ππππππππππππππ-111111138111111121111111118311111111111-πππππππππππππππππ",
        "πππππππππππππ--111111381111111811111111118311111111111-πππππππππππππππππ",
        "ππππππππππππ--1111111381111111811111111118311111111111-πππππππππππππππππ",
        "ππππππππππππ-11111111381111111211111111183111111111111-πππππππππππππππππ",
        "ππππππππππππ-11111111381111111211111111183111111111111-πππππππππππππππππ",
        "ππππππππππππ-11111111381111111811111111183111111111111-πππππππππππππππππ",
        "ππππππππππππ-11111111381111111811111111183111111111111-πππππππππππππππππ",
        "ππππππππππππ-11111113811111112111111111183111111111111-πππππππππππππππππ",
        "ππππππππππππ-11111113811111112111111111183111111111111-πππππππππππππππππ",
        "πππππππππππ--11111113811111118111111111183111111111111-πππππππππππππππππ",
        "ππππππππππ--111111113811111118111111111831111111111111-πππππππππππππππππ",
        "ππππππππ---1111111113811111112111111111831111111111111-πππππππππππππππππ",
        "ππππππππ-111111111113811111112111111111831111111111111-πππππππππππππππππ",
        "πππππππ--111111111113811111118111111111831111111111111-πππππππππππππππππ",
        "ππππππ--1111111111138111111181111111111831111111111111-πππππππππππππππππ",
        "ππππππ-11111111111138111111121111111111831111111111111--ππππππππππππππππ",
        "ππππππ-111111111111381111111211111111183111111111111111-ππππππππππππππππ",
        "πππππ--111111111111381111111811111111183111111111111111-ππππππππππππππππ",
        "πππππ-1111111111111381111111811111111183111111111111111-ππππππππππππππππ",
        "ππππ--1111111111111381111111211111111183111111111111222222222πππππππππππ",
        "ππππ-1111111111111138111111121111111118311111111111124(44444444444444444",
        "πππ--1111111111111381111111811111111118311111111111124444444444444444444",
        "πππ-<1111111111111381111111811111111118311111111111124444444444444444444",
        "πππ-<1111111111111381111111211111111183111111111111124444444444444444444",
        "πππ-11111111111111381111111211111111183111111111111124444444444444444444",
        "ππ--11111111111111381111111811111111183111111111111124444444444444444444",
        "π--111111111111111381111111811111111183111111111111124444444444444444444",
        "π-1111111111111111381111111211111111183111111111111124444444444444444444",
        "π-1111111111111113811111112111111111183111111111111124444444444444444444",
        "π-1111111111111113811111118111111111183111111111111124444444444444444444",
        "--1111111111111113811111118111111111831111111111111124444444444444444444",
        "-11111111111111113811111112111111111831111111111111124444444444444444444",
        "-11111111111111113811111112111111111831111111111111124444444444444444444",
        "-11111111111111113811111118111111111831111111111111124444444444444444444",
        "-11111111111111138111111118111111111831111111111111124444444444444444444",
        "-11111111111111138111111121111111111831111111111111124444444444444444444",
        "-11111111111111138111111121111111118311111111111111124444444444444444444",
        "-11111111111111138111111181111111118311111111111111124444444444444444444",
        "-11111111111111138111111181111111118311111111111111124444444444444444444",
        "-1111111111111113811111112111111111831111111111111112222222222222222222-",
        "-1111111111111113811111112111111111831111111111111111111111111111111111-",
        "-1111111111111138111111181111111111831111111111111111111111111111111111-",
        "-1111111111111138111111181111111111831111111111111111111111111111111111-",
        "-1111111111111138111111121111111118311111111111111111111111111111111111-",
        "-1111111111111138111111121111111118311111111111111111111111111111111111-",
        "-1111111111111138111111181111111118311111111111111111111111111111111111-",
        "-1111111111111138111111181111111118311111111111111111111111111111111111-",
        "-1111111111111138111111121111111118311111111111111111111111111111111111-",
        "-1111111111111381111111211111111118311111111111111111111111111111111111-",
        "-1111111111111381111111811111111118311111111111111111111111111111111111-",
        "-1111111111111381111111811111111183111111111111111111111111111111111111-",
        "-1111111111111381111111211111111183111111111111111111111111111111111111-",
        "-1111111111111381111111211111111183111111111111111111111111111111111111-",
        "-1111111111111381111111811111111183111111111111111111111111111111111111-",
        "-1111111111113811111111811111111183111111111111111111111111111111111111-",
        "-1111111111113811111112111111111183111111111111111111111111111111111111-",
        "-1111111111113811111112111111111831111111111111111111111111111111111111-",
        "-1111111111113811111118111111111831111111111111111111111111111111111111-",
        "-1111111111113811111118111111111831111111111111111111111111111111111111-",
        "-1111111111113811111112111111111831111111111111111111111111111111111111-",
        "-1111111111113811111112111111111831111111111111111111111111111111111111-",
        "-1111111111138111111181111111111831111111111111111111111111111111111111-",
        "-1111111111138111111181111111111831111111111111111112222222222222222222-",
        "-11111111111381111111211111111183111111111111111111124(44444444444444444",
        "-11111111111381111111211111111183111111111111111111124444444444444444444",
        "-11111111111381111111811111111183111111111111111111124444444444444444444",
        "-11111111111381111111811111111183111111111111111111124444444444444444444",
        "-11111111111381111111211111111831111111111111111111124444444444444444444",
        "-11111111113811111112111111111831111111111111111111124444444444444444444",
        "-11111111113811111118111111111831111111111111111111124444444444444444444",
        "-11111111113811111118111111111831111111111111111111124444444444444444444",
        "-11111111113811111112111111111831111111111111111111124444444444444444444",
        "-11111111113811111112111111111831111111111111111111124444444444444444444",
        "-11111111113811111118111111111831111111111111111111124444444444444444444",
        "-11111111113811111118111111111831111111111111111111124444444444444444444",
        "-11111111138111111121111111111831111111111111111111124444444444444444444",
        "-11111111138111111121111111118311111111111111111111124444444444444444444",
        "-11111111138111111181111111118311111111111111111111124444444444444444444",
        "-11111111138111111121111111118311111111111111111111124444444444444444444",
        "-11111111138111111121111111118311111111111111111111124444444444444444444",
        "-11111111138111111181111111118311111111111111111111124444444444444444444",
        "-11111111381111111181111111118311111111111111111111124444444444444444444",
        "-1111111138111111121111111111831111111111111111111112222222222222222222-",
        "-1111111138111111121111111118311111111111111111111111111111111111111111-",
        "-1111111138111111181111111118311111111111111111111111111111111111111111-",
        "-1111111138111111181111111118311111111111111111111111111111111111111111-",
        "-1111111138111111121111111118311111111111111111111111111111111111111111-",
        "-1111111138111111121111111118311111111111111111111111111111111111111111-",
        "-1111111381111111181111111118311111111111111111111111111111111111111111-",
        "-1111111381111111811111111118311111111111111111111111111111111111111111-",
        "-1111111381111111211111111183111111111111111111111111111111555555111111-",
        "-11111113811111112111111111831111111111111111111111111111115<<;;5111111-",
        "-11111113811111118111111111831111111111111111111111111111155>>;;5111111-",
        "-1111111381111111811111111183111111111111111111111111111115;;;;;5111111-",
        "-111111138111111121111111118311111111111111111111111111111+;;;;;5111111-",
        "-1111113811111112111111111831111111111111111111111111111115;;;ht5111111-",
        "-1111113811111118111111111831111111111111111111111111111115M;;;t5111111-",
        "-1111113811111118111111111831111111111111111111111111111115F;;ht5111111-",
        "-1111113811111112111111111831111111111111111111111111111115F;;;t5111111-",
        "-1111113811111112111111111831111111111111111111111111111155F;;ht5111111-",
        "-111111381111111811111111183111111111111111111111111111115th;;;t5111111-",
        "-111113811111111811111111183111111111111111111111111111115th;;ht5111111-",
        "-111113811111112111111111183111111111111111111111111111115t;;;;t5111111-",
        "-111113811111112111111111831111111111111111111111111111115t;;;ht5111111-",
        "-111113811111118111111111831111111111111111111111111111115th;;;t5111111-",
        "-111113811111118111111111831111111111111111111111111111115th;;ht5111111-",
        "-111113811111112111111111831111111111111111111111111111115thh;;t5111111-",
        "-111113811111112111111111831111111111111111111111111111115ttt;tt5111111-",
        "-111138111111118111111111831111111111111111111111111111155555+555111111-",
        "-11113811111118111111111831111111111111111111111111111115tttt;tt5111111-",
        "-11113811111112111111111831111111111111111111111111111115t;h;;ht5111111-",
        "-11113811111112111111111831111111111111111111111111111115th;;;;t5111111-",
        "-11113811111118111111111831111111111111111111111111111115t;;;;ht5111111-",
        "-11113811111118111111111831111111111111111111111111111115th;{;;t5111111-",
        "-11113811111112111111111831111111111111111111111111111115t;;{;ht5111111-",
        "-11138111111112111111111831111111111111111111111111111115th;{;;t5111111-",
        "-11138111111181111111118311111111111111111111111111111115t;;{;ht5111111-",
        "-11138111111181111111118311111111111111111111111111111115th;;;;t5111111-",
        "-11138111111121111111118311111111111111111111111111111115t;;;;ht5111111-",
        "-11138111111121111111118311111111111111111111111111111115th;;;;t5111111-",
        "-11138111111181111111118311111111111111111111111111111115ttt;;ht5111111-",
        "-11138111111181111111118311111111111111111111111111115555555;;;t5111111-",
        "-11381111111211111111118311111111111111111111111111115Dfffd5;;ht5111111-",
        "-1138111111121111111118311111111111111111111111111111+;;;;;+;;;t5111111-",
        "-1138111111181111111118311111111111111111111111111111555+5+5{h{55111111-",
        "-1138111111181111111118311111111111111111111111111111155&5&5{CC55111111-",
        "-1138111111121111111118311111111111111111111111111111115555555551111111-",
        "-1138111111121111111118311111111111111111111111111111111111111111111111-",
        "-1138111111181111111118311111111111111111111111111111111111111111111111-",
        "-1381111111811111111118311111111111111111111111111111111111111111111111-",
        "-1381111111211111111183111111111111111111111111111111111111111111111111-",
        "-1381111111211111111183111111111111111111111111111111111111111111111111-",
        "-1381111111811111111183111111111111111111111111111111111111111111111111-",
        "-1381111111811111111183111111111111111111111111111111111111111111111111-",
        "-1381111111211111111183111111111111111111111111111111111111111111111111-",
        "-13811111112111111111831111111111111111111111111111114(44444444444444444",
        "-38111111181111111118311111111111111111111111111111114444444444444444444",
        "-38111111181111111118311111111111111111111111111111114444444444444444444",
        "-38111111121111111118311111111111111111111111111111114444444444444444444",
        "-38111111121111111118311111111111111111111111111111114444444444444444444",
        "-38111111181111111118311111111111111111111111111111114444444444444444444",
        "-38111111181111111118311111111111111111111111111111114444444444444444444",
        "-38111111121111111118311111111111111111111111111111114444444444444444444",
        "381111111211111111183111111111111111111111111111111114444444444444444444",
        "381111111811111111183111111111111111111111111111111114444444444444444444",
        "381111111811111111183111111111111111111111111111111114444444444444444444",
        "381111111811111111183111111111111111111111111111111114444444444444444444",
        "444444444444444444411111111111111111111111111111111114444444444444444444",
        "444444444444444444411111111111111111111111111111111114444444444444444444",
        "444444444444444444411111111111111111111111111111111114444444444444444444",
        "444444444444444444411111111111111111111111111111111114444444444444444444",
        "444444444444444444411111111111111111111111111111111114444444444444444444",
        "444444444444444444411111111111111111111111111111111114444444444444444444",
        "444444444444444444411111111111111111111111111111111114444444444444444444",
        "44444444444444444441111111111111111111111111111111111111111111111111111-",
        "44444444444444444441111111111111111111111111111111111111111111111111111-",
        "44444444444444444441111111111111111111111111111111111111111111111111111-",
        "44444444444444444441111111111111111111111111111111111111111111111111111-",
        "44444444444444444441111111111111111111111111111111111111111111111111111-",
        "44444444444444444441111111111111111111111111111111111111111111111111111-",
        "44444444444444444441111111111111111111111111111111111111111111111111111-",
        "44444444444444444441111111111111111111111111111111111111111111111111111-",
        "4444444444444444444111111111111111111111111111111111111111111111111111--",
        "444444444444444444411111111111111111111111111111111111111111111111111--π",
        "44444444444444444441111111111111111111111111111111111111111111111111--ππ",
        "444444444444444444(111111111111111111111111111111111111111111111111--πππ",
        "πππππππππππππ-1111111111111111111111111111111111111111111111111111--ππππ",
        "πππππππππππππ-111111111111111111111111111111111111111111111111111--πππππ",
        "πππππππππππππ-11111111111111111111111111111111111111111111111111--ππππππ",
        "πππππππππππππ-1111111111111111111111111111111111111111111111111--πππππππ",
        "πππππππππππππ-111111111111111111111111111111111111111111111111--ππππππππ",
        "πππππππππππππ-11111111111111111111111111111111111111111111111--πππππππππ",
        "πππππππππππππ--111111111111111111111111111111111111111111111--ππππππππππ",
        "ππππππππππππππ-11111111111111111111111111111111111111111111--πππππππππππ",
        "ππππππππππππππ-1111111111111111111111111111111111111111111--ππππππππππππ",
        "ππππππππππππππ-111111111111111111111111111111111111111111--πππππππππππππ",
        "ππππππππππππππ-<1111111111111111111111111111111111111111--ππππππππππππππ",
        "ππππππππππππππ-<111111111111111111111111111111111111111--πππππππππππππππ",
        "ππππππππππππππ--111111111111111111111111111111111111111-ππππππππππππππππ",
        "πππππππππππππππ-111111111111111111111111111111111111111-ππππππππππππππππ",
        "πππππππππππππππ-111111111111111111111111111111111111111-ππππππππππππππππ",
        "πππππππππππππππ-111111111111111111111111111111111111111-ππππππππππππππππ",
        "πππππππππππππππ-111111111111111131113111111111111111111-ππππππππππππππππ",
        "πππππππππππππππ-111111111111111131118111111111111111111-ππππππππππππππππ",
        "πππππππππππππππ-111111111111111181118111111111111111111-ππππππππππππππππ",
        "πππππππππππππππ-111111111111111181113111111111111111111-ππππππππππππππππ",
        "πππππππππππππππ-111111111111111131113111111111111111111--πππππππππππππππ",
        "πππππππππππππππ-111111111111111131118111111111111111111<-πππππππππππππππ",
        "πππππππππππππππ-111111111111111181118111111111111111111<-πππππππππππππππ",
        "πππππππππππππππ-111111111111111181113111111111111111111--πππππππππππππππ",
        "πππππππππππππππ-111111111111111131113111111111111111111-ππππππππππππππππ",
        "πππππππππππππππ-111111111111111131118111111111111111111-ππππππππππππππππ",
        "πππππππππππππππ-11111111111111181111811111111111111111--ππππππππππππππππ",
        "πππππππππππππππ-11111111111111181111311111111111111111-πππππππππππππππππ",
        "πππππππππππππππ-11111111111111131111311111111111111111-πππππππππππππππππ",
        "πππππππππππππππ-11111111111111131111811111111111111111-πππππππππππππππππ",
        "πππππππππππππππ-11111111111111181111811111111111111111-πππππππππππππππππ",
        "πππππππππππππππ--1111111111111181111311111111111111111-πππππππππππππππππ",
        "ππππππππππππππππ-1111111111111131111311111111111111111-πππππππππππππππππ",
        "ππππππππππππππππ-1111111111111131111811111111111111111-πππππππππππππππππ",
        "ππππππππππππππππ-111111111111118111181111111111111111--πππππππππππππππππ",
        "ππππππππππππππππ-111111111111118111131111111111111111-ππππππππππππππππππ",
        "ππππππππππππππππ-111111111111113111131111111111111111-ππππππππππππππππππ",
        "ππππππππππππππππ-111111111111113111181111111111111111-ππππππππππππππππππ",
        "ππππππππππππππππ-111111111111118111181111111111111111-ππππππππππππππππππ",
        "ππππππππππππππππ-11111111111111811113111111111111111--ππππππππππππππππππ",
        "ππππππππππππππππ-11111111111111311113111111111111111-πππππππππππππππππππ",
        "ππππππππππππππππ-11111111111111311118111111111111111-πππππππππππππππππππ",
        "ππππππππππππππππ-11111111111111811118111111111111111-πππππππππππππππππππ",
        "ππππππππππππππππ-11111111111111811113111111111111111-πππππππππππππππππππ",
        "ππππππππππππππππ-11111111111111311113111111111111111-πππππππππππππππππππ",
        "ππππππππππππππππ-11111111111113111118111111111111111-πππππππππππππππππππ",
        "ππππππππππππππππ-11111111111118111118111111111111111-πππππππππππππππππππ",
        "ππππππππππππππππ-11111111111118111113111111111111111-πππππππππππππππππππ",
        "ππππππππππππππππ--1111111111113111113111111111111111-πππππππππππππππππππ",
        "πππππππππππππππππ-1111111111113111118111111111111111-πππππππππππππππππππ",
        "πππππππππππππππππ-1111111111118111118111111111111111-πππππππππππππππππππ",
        "πππππππππππππππππ-1111111111118111111311111111111111-πππππππππππππππππππ",
        "πππππππππππππππππ-1111111111113111111311111111111111-πππππππππππππππππππ",
        "πππππππππππππππππ-1111111111113111111811111111111111-πππππππππππππππππππ",
        "πππππππππππππππππ-1111111111118111111811111111111111-πππππππππππππππππππ",
        "πππππππππππππππππ-1111111111118111111311111111111111-πππππππππππππππππππ",
        "πππππππππππππππππ-1111111111113111111311111111111111-πππππππππππππππππππ",
        "πππππππππππππππππ-1111111111113111111811111111111111-πππππππππππππππππππ",
        "πππππππππππππππππ-1111111111118111111811111111111111-πππππππππππππππππππ",
        "πππππππππππππππππ-1111111111118111111311111111111111-πππππππππππππππππππ",
        "πππππππππππππππππ-1111111111113111111311111111111111-πππππππππππππππππππ",
        "πππππππππππππππππ-1111111111113111111811111111111111-πππππππππππππππππππ",
        "πππππππππππππππππ-111111111111811111181111111111111--πππππππππππππππππππ",
        "πππππππππππππππππ-111111111118111111131111111111111-ππππππππππππππππππππ",
        "πππππππππππππππππ-111111111113111111131111111111111-ππππππππππππππππππππ",
        "πππππππππππππππππ-111111111113111111181111111111111-ππππππππππππππππππππ",
        "πππππππππππππππππ-11111111111811111118111111111111--ππππππππππππππππππππ",
        "πππππππππππππππππ-11111111111811111113111111111111-πππππππππππππππππππππ",
        "πππππππππππππππππ--111111111131111111311111111111--πππππππππππππππππππππ",
        "ππππππππππππππππππ-111111111131111111811111111111-ππππππππππππππππππππππ",
        "ππππππππππππππππππ-11111111118111111181111111111--ππππππππππππππππππππππ",
        "ππππππππππππππππππ-11111111118111111131111111111-πππππππππππππππππππππππ",
        "ππππππππππππππππππ-11111111113111111131111111111-πππππππππππππππππππππππ",
        "ππππππππππππππππππ-11111111113111111181111111111-πππππππππππππππππππππππ",
        "ππππππππππππππππππ-11111111118111111181111111111-πππππππππππππππππππππππ",
        "ππππππππππππππππππ-11111111118111111131111111111-πππππππππππππππππππππππ",
        "ππππππππππππππππππ-11111111113111111131111111111-πππππππππππππππππππππππ",
        "ππππππππππππππππππ-11111111113111111181111111111-πππππππππππππππππππππππ",
        "ππππππππππππππππππ-11111111118111111181111111111-πππππππππππππππππππππππ",
        "ππππππππππππππππππ-11111111118111111131111111111-πππππππππππππππππππππππ",
        "ππππππππππππππππππ-11111188888881111138811111111-πππππππππππππππππππππππ",
        "ππππππππππππππππππ-11111881113188111188811111111-πππππππππππππππππππππππ",
        "ππππππππππππππππππ-11111881118188111188811111111-πππππππππππππππππππππππ",
        "ππππππππππππππππππ-11111881118188111138811111111-πππππππππππππππππππππππ",
        "ππππππππππππππππππ-11111881113111111138811111111-πππππππππππππππππππππππ",
        "ππππππππππππππππππ-11111881113111111188811111111-πππππππππππππππππππππππ",
        "ππππππππππππππππππ-1111188111811111118881111111--πππππππππππππππππππππππ",
        "ππππππππππππππππππ-111118811181111111388111111--ππππππππππππππππππππππππ",
        "ππππππππππππππππππ-111118811131111111388111111-πππππππππππππππππππππππππ",
        "ππππππππππππππππππ-111118888888811111881111111-πππππππππππππππππππππππππ",
        "ππππππππππππππππππ--11118811181881111881111111-πππππππππππππππππππππππππ",
        "πππππππππππππππππππ-11118811181881111381111111-πππππππππππππππππππππππππ",
        "πππππππππππππππππππ-11118811131881118311111111-πππππππππππππππππππππππππ",
        "πππππππππππππππππππ-11118811131881118811111111-πππππππππππππππππππππππππ",
        "πππππππππππππππππππ-11118811181881188811111111-πππππππππππππππππππππππππ",
        "πππππππππππππππππππ-11118811181881881311881111-πππππππππππππππππππππππππ",
        "πππππππππππππππππππ-11118811131881881311881111-πππππππππππππππππππππππππ",
        "πππππππππππππππππππ-11118811131881881811881111-πππππππππππππππππππππππππ",
        "πππππππππππππππππππ-11111888888811888888881111-πππππππππππππππππππππππππ",
        "πππππππππππππππππππ-11111111111111111111111111-πππππππππππππππππππππππππ",
        "πππππππππππππππππππ-11111111111111111111111111-πππππππππππππππππππππππππ",
        "πππππππππππππππππππ--111111111111111111111111--πππππππππππππππππππππππππ",
        "ππππππππππππππππππππ-111111111111111111111111-ππππππππππππππππππππππππππ",
        "πππππππππππππππππππππ111111111111111111111111πππππππππππππππππππππππππππ",
        "ππππππππππππππππππππππππππππππππππππππππππππππππππππππππππππππππππππππππ"
      ],
      "palettes": [ "aircraft_carrier_palette" ],
      "gaspumps": {  },
      "signs": {  },
      "place_vehicles": [
        { "vehicle": "helicopter_apache_1a", "x": 64, "y": 66, "chance": 20, "rotation": 90, "status": 1 },
        { "vehicle": "helicopter_apache_1b", "x": 64, "y": 113, "chance": 20, "rotation": 270, "status": 1 },
        { "vehicle": "helicopter_apache_1c", "x": 19, "y": 84, "chance": 20, "status": 1 },
        { "vehicle": "helicopter_apache_1b", "x": 19, "y": 108, "chance": 20, "status": 1 },
        { "vehicle": "helicopter_apache_1b", "x": 19, "y": 132, "chance": 20, "status": 1 },
        { "vehicle": "helicopter_osprey_2c", "x": 19, "y": 156, "chance": 50, "status": 1 },
        { "vehicle": "helicopter_osprey_2b", "x": 19, "y": 180, "chance": 50, "status": 1 },
        { "vehicle": "inflatable_boat", "x": 14, "y": 61, "rotation": 270 },
        { "vehicle": "inflatable_boat", "x": 25, "y": 250, "rotation": 90 },
        { "vehicle": "engine_crane", "x": 66, "y": 91, "rotation": 0 },
        { "vehicle": "welding_cart", "x": [ 56, 65 ], "y": [ 31, 47 ] },
        { "vehicle": "engine_crane", "x": [ 25, 33 ], "y": [ 31, 47 ] },
        { "vehicle": "handjack", "x": [ 25, 33 ], "y": [ 49, 71 ] },
        { "vehicle": "inflatable_boat", "x": [ 25, 33 ], "y": [ 73, 94 ], "rotation": 90 },
        { "vehicle": "engine_crane", "x": [ 25, 33 ], "y": [ 97, 119 ] },
        { "vehicle": "welding_cart", "x": [ 25, 33 ], "y": [ 121, 143 ] },
        { "vehicle": "welding_cart", "x": [ 25, 33 ], "y": [ 145, 167 ] },
        { "vehicle": "welding_cart", "x": [ 25, 33 ], "y": [ 169, 191 ] },
        { "vehicle": "engine_crane", "x": [ 25, 33 ], "y": [ 193, 215 ] },
        { "vehicle": "handjack", "x": [ 25, 33 ], "y": [ 217, 236 ] }
      ]
    }
  }
]
