[
  {
    "type": "mapgen",
    "om_terrain":
      [
        [ "robofac_strip_mall_x0y0", "robofac_strip_mall_x1y0", "robofac_strip_mall_x2y0", "robofac_strip_mall_x3y0", "robofac_strip_mall_x4y0" ],
        [ "robofac_strip_mall_x0y1", "robofac_strip_mall_x1y1", "robofac_strip_mall_x2y1", "robofac_strip_mall_x3y1", "robofac_strip_mall_x4y1" ]
      ],
    "object": {
      "fill_ter": "t_floor",
      "rows": [
        "Я1......................sssssssssssssssssssssssss2......................s3......................ssssssssssssssssssssssss", 
        "#.......................#########################.......................#.......................#sLpppppppppppppyyyyyyy;",
        "#.......................#Su#Su#cdcdlf #km  m 8  #.......................#.......................#sspppppppppppppyyyyDDy;",
        "#.......................#  #  #dcfl  R#  7    7k#.......................#.......................#sspppppppppppppyyyyDDy;",
        "#.......................##-##-#fll    | 7  k  m #.......................#.......................#sspppppppppppppyyyyyyy;",
        "#.......................#             ###########.......................#.......................#sspppppppppppppyyyyyyy;",
        "#.......................########-##   #eeSe  x%P#.......................#.......................#sspppppppppppppyyyyyyy;",
        "#.......................#dcdffff  #   #e   E   5#.......................#.......................#sspppppppppppppyyyyyyy;",
        "#.......................#fclcdclll#   |     c  k#.......................#.......................#ssyyyyyyyppppppyyyyyyy;",
        "#.......................###########   ###########.......................#.......................#sspppppppppppppppppppp;",
        "#.......................#ffff#m   |   -    c dc #.......................#.......................#sspppppppppppppppppppp;",
        "#.......................#Pctt#    #   #    c ad #.......................#.......................#sspppppppppppppppppppp;",
        "#.......................#fccf# Z k#   #P       f#.......................#.......................#sspppppppppppppppppppp;",
        "#.......................##+########   ###########.......................#.......................#sspppppppppppppppppppp;",
        "#.......................#f ffe          rrr P   #.......................#.......................#sspppppppppppppppppppp;",
        "#.......................#    e                  #.......................#.......................#sspppppppppppppppppppp;",
        "#.......................#P cee          c      c#.......................#.......................#sLyyyyyyyppppppppppppp;",
        "#.......................#  ee        c T c     c#.......................#.......................#sspppppppppppppppppppp;",
        "#.......................#eee         c t c     c#.......................#.......................#sspppppppppppppppppppp;",
        "#.......................#                      c#.......................#.......................#sspppppppppppppppppppp;",
        "#.......................#P         P   c       c#.......................#.......................#sspppppppppppppppppppp;",
        "#.......................#XXX++XXXXXXXXXXXXXXXXXX#.......................#.......................#Яspppppppppppppppppppp;",
        "Я..............?........sssssssssssssssssssssssss.??....................s.......................ssspppppppppppppppppppp;",
        "sssssssssssssss?ssssssbb!bbsssssssssssssssssssbb!??sssssssssssssssssssbb!bbsssssssssssssssssssssss0pppppppppppppppppppp;",
        "ypppppppypppppp*ypppppppypppppppypppppppyppppppp**ppppppypppppppyppppppp4pppppppypppppppypppppppypppppppppppppppppppppp;",
        "ypppppppypppppp*ypppp^ppypppppppypppppppypG&ppp**pppppppypppppppypppppppypppppppypppppppypppppppypppppppppppppppppppppp;",
        "ypppppppypppppp*yp^pppppypppppppyppp^pp^yppppp**ypppppppypppppppypppppppypppppppypppppppypppppppypppppppppppppppppppppp;",
        "ypppppppypppppp**pppFpp^ypppppppypppppppypppp**pypppppppypppppppypppppppypppppppypppppppypppppppypppppppppppppppppppppp;",
        "ypppppppyppppppp**^pppppypppppppypp^pFp^yppp**ppypppppppypppppppypppppppypppppppypppppppypppppppypppppppppppppppppppppp;",
        "ypppppppypppppppy**p^pppypppppppypppppppypp**pppypppppppypppppppypppppppypppppppypppppppypppppppypppppppppppppppppppppp;",
        "ypppppppypppppppyp**ppppypppppppypppp^ppyp**ppppypppppppypppppppypppppppypppppppypppppppypppppppypppppppppppppppppppppp;",
        "ppppppppppppppppppp************************pppppppppppppppppppppppppppppppppppppppppppppppppppppppppppppppppppppppppppp;",
        "ppppppppppppppppppppppppppppppppppppppppppppppppppppppppppppppppppppppppppppppppppppppppppppppppppppppppppppppppppppppp;",
        "ppppppppppppppppppppppppppppppppppppppppppppppppppppppppppppppppppppppppppppppppppppppppppppppppppppppppppppppppppppppp;",
        "ppppppppppppppppppppppppppppppppppppppppppppppppppppppppppppppppppppppppppppppppppppppppppppppppppppppppppppppppppppppp;",
        "ppppppppppppppppppppppppppppppppppppppppppppppppppppppppppppppppppppppppppppppppppppppppppppppppppppppppppppppppppppppp;",
        "ppppppppppppppppppppppppppppppppppppppppppppppppppppppppppppppppppppppppppppppppppppppppppppppppppppppppppppppppppppppp;",
        "ppppppppppppppppppppppppppppppppppppppppppppppppppppppppppppppppppppppppppppppppppppppppppppppppppppppppppppppppppppppp;",
        "ppppppppppppppppppppppppppppppppppppppppppppppppppppppppppppppppppppppppppppppppppppppppppppppppppppppppppppppppppppppp;",
        "ppppppppppppppppppppppppppppppppppppppppppppppppppppppppppppppppppppppppppppppppppppppppppppppppppppppppppppppppppppppp;",
        "ypppppppypppppppypppppppypppppppypppppppypppppppypppppppypppppppypppppppypppppppypppppppypppppppypppppppppppppppppppppp;",
        "ypppppppypppppppypppppppypppppppypppppppypppppppypppppppypppppppypppppppypppppppypppppppypppppppypppppppppppppppppppppp;",
        "ypppppppypppppppypppppppypppppppypppppppypppppppypppppppypppppppypppppppypppppppypppppppypppppppypppppppppppppppppppppp;",
        "ypppppppypppppppypppppppypppppppypppppppypppppppypppppppypppppppypppppppypppppppypppppppypppppppypppppppppppppppppppppp;",
        "ypppppppypppppppypppppppypppppppypppppppypppppppypppppppypppppppypppppppypppppppypppppppypppppppypppppppppppppppppppppp;",
        "ypppppppypppppppypppppppypppppppypppppppypppppppypppppppypppppppypppppppypppppppypppppppypppppppypppppppppppppppppppppp;",
        "ypppppppypppppppypppppppypppppppypppppppypppppppypppppppypppppppypppppppypppppppypppppppypppppppypppppppppppppppppppppp;",
        ";;;;;;;;;;;;;;;;;;;;;;;;;;;;;;;;;;;;;;;;;;;;;;;;;;;;;;;;;;;;;;;;;;;;;;;;;;;;;;;;;;;;;;;;;;;;;;;pppppppppppppppppppppppp;"
      ],
      "palettes": [ "parametrized_walls_palette" ],
      "place_fields": [
        { "field": "fd_blood", "x": [ 39, 47 ], "y": [ 2, 4 ], "intensity": [ 1, 3 ], "repeat": [ 20, 50 ] },
        { "field": "fd_blood", "x": 37, "y": [ 4, 8 ], "intensity": [ 1, 3 ], "repeat": [ 10, 20 ] },
        { "field": "fd_blood", "x": [ 40, 45 ], "y": [ 6, 8 ], "intensity": [ 1, 3 ], "repeat": [ 3, 10 ] }
      ],
      "terrain": {
        ";": "t_rock_wall_half",
        "!": "t_region_tree_shade",
        "b": "t_sidewalk",
        "?": "t_sidewalk",
        "p": "t_pavement",
        "*": "t_pavement",
        "^": "t_pavement",
        "F": "t_pavement",
        "G": "t_pavement",
        "&": "t_pavement",
        "4": "t_pavement",
        "H": "t_pavement",
        "y": "t_pavement_y",
        " ": "t_linoleum_white",
        "S": "t_linoleum_white",
        "u": "t_linoleum_white",
        "v": "t_linoleum_white",
        "c": "t_linoleum_white",
        "C": "t_linoleum_white",
        "t": "t_linoleum_white",
        "T": "t_linoleum_white",
        "d": "t_linoleum_white",
        "a": "t_linoleum_white",
        "l": "t_linoleum_white",
        "x": "t_linoleum_white",
        "R": "t_linoleum_white",
        "5": "t_linoleum_white",
        "e": "t_linoleum_white",
        "r": "t_linoleum_white",
        "8": "t_linoleum_white",
        "7": "t_linoleum_white",
        "-": "t_door_c",
        "|": "t_door_locked_interior",
        "D": "t_door_c",
        "Z": "t_linoleum_white",
        "A": "t_linoleum_white",
        "E": "t_linoleum_white",
        "f": "t_linoleum_white",
        "k": "t_linoleum_white",
        "P": "t_linoleum_white",
        "m": "t_linoleum_white",
        "s": "t_sidewalk",
        "L": "t_sidewalk",
        "Я": "t_gutter_downspout",
        "X": "t_window_boarded",
        "+": "t_door_glass_frosted_c",
        ",": "t_region_groundcover",
        "_": "t_region_groundcover"
      },
      "furniture": {
        "L": "f_street_light",
        "b": "f_bench",
        "D": "f_dumpster",
        "S": "f_sink",
        "d": "f_desk",
        "a": "f_desk",
        "f": "f_filing_cabinet",
        "c": "f_chair",
        "P": [ "f_indoor_plant", "f_indoor_plant_y" ],
        "E": "f_exam_chair",
        "x": "f_dental_xray",
        "F": "f_55gal_firebarrel",
        "*": "f_sandbag_half",
        "?": "f_sandbag_half",
        "l": "f_locker",
        "t": "f_coffee_table",
        "T": "f_coffee_table",
        "e": "f_counter",
        "R": "f_rack",
        "r": "f_rack",
        "^": [ [ "f_deckchair", 25 ], [ "f_camp_chair", 25 ], [ "f_armchair", 25 ], [ "f_tourist_table", 25 ] ],
        "G": "f_active_backup_generator",
        "m": "f_floor_mattress",
        "%": "f_console_broken"
      },
      "nested": {
        "0": { "chunks": [ [ "strip_mall_sign", 100 ] ] },
        "1": { "chunks": [ [ "strip_mall_shop_a", 100 ] ] },
        "2": { "chunks": [ [ "strip_mall_shop_b", 100 ] ] },
        "3": { "chunks": [ [ "strip_mall_shop_c", 100 ] ] },
        "4": { "chunks": [ [ "mx_exodii_crash_big_1_chop_shop", 100 ] ] }
      },
      "items": {
        "D": { "item": "SUS_trash_dumpster", "chance": 75 },
        "f": { "item": "SUS_office_filing_cabinet", "chance": 70, "repeat": [ 1, 3 ] },
        "d": { "item": "SUS_office_desk", "chance": 40 },
        "l": { "item": "dentist_supplies", "chance": 95 },
        "r": { "item": "SUS_shelf_commercial_magazines", "chance": 70 }
      },
      "item": {
        "E": [ { "item": "bot_prototype_cyborg" } ],
        "R": [ { "item": "tazer" } ],
        "k": [ { "item": "bucket_5gal" } ]
      },
      "place_loot": [
        { "item": "hacksaw", "x": 39, "y": 6 },
        { "item": "hammer_sledge_short", "x": 39, "y": 7 },
        { "item": "screwdriver_set", "x": 40, "y": 6 },
        { "item": "scalpel", "x": 40, "y": 6 },
        { "group": "tools_workshop", "x": 42, "y": 6 },
        { "item": "oil_lamp_on", "x": 45, "y": 10 }
      ],
      "toilets": { "u": {  } },
      "place_vehicles": [
        { "chance": 75, "rotation": 180, "vehicle": "parking_garage", "x": 102, "y": 6 },
        { "chance": 75, "rotation": 180, "vehicle": "parking_garage", "x": 102, "y": 13 },
        { "chance": 75, "rotation": 180, "vehicle": "parking_garage", "x": 102, "y": 20 }
      ],
      "monster": {
        "&": { "monster": "mon_turret_searchlight" },
        "Z": { "monster": "mon_prototype_cyborg" },
        "8": { "monster": "mon_civilian_parent_robofac_chop_shop" },
        "7": { "monster": "mon_civilian_stationary_robofac_chop_shop" }
      },
    "place_npcs": [
      { "class": "robofac_chop_shop_merc_1", "x": 33, "y": 28 },
      { "class": "robofac_chop_shop_merc_2", "x": 35, "y": 29 },
      { "class": "robofac_chop_shop_merc_3", "x": 19, "y": 24 },
      { "class": "robofac_chop_shop_merc_4", "x": 38, "y": 23 },
      { "class": "robofac_chop_shop_merc_5", "x": 24, "y": 23 },
      { "class": "robofac_chop_shop_merc_6", "x": 40, "y": 30 },
      { "class": "robofac_chop_shop_scientist_1", "x": 46, "y": 10 }
    ],
    "faction_owner": [
      { "id": "robofac_auxiliaries_chop_shop", "x": [ 0, 23 ], "y": [ 0, 23 ] },
      { "id": "robofac_auxiliaries_chop_shop", "x": [ 0, 23 ], "y": [ 24, 47 ] },
      { "id": "robofac_auxiliaries_chop_shop", "x": [ 24, 47 ], "y": [ 0, 23 ] },
      { "id": "robofac_auxiliaries_chop_shop", "x": [ 24, 47 ], "y": [ 24, 47 ] },
      { "id": "robofac_auxiliaries_chop_shop", "x": [ 48, 71 ], "y": [ 0, 23 ] },
      { "id": "robofac_auxiliaries_chop_shop", "x": [ 48, 71 ], "y": [ 24, 47 ] },
      { "id": "robofac_auxiliaries_chop_shop", "x": [ 72, 95 ], "y": [ 0, 23 ] },
      { "id": "robofac_auxiliaries_chop_shop", "x": [ 72, 95 ], "y": [ 24, 47 ] },
      { "id": "robofac_auxiliaries_chop_shop", "x": [ 96, 119 ], "y": [ 0, 23 ] },
      { "id": "robofac_auxiliaries_chop_shop", "x": [ 96, 119 ], "y": [ 24, 47 ] }

    ]
    }
  },
  {
    "type": "mapgen",
    "om_terrain": [ [ "robofac_strip_mall_roof_1", "robofac_strip_mall_roof_2", "robofac_strip_mall_roof_3", "robofac_strip_mall_roof_4", "robofac_strip_mall_roof_5" ] ],
    "object": {
      "fill_ter": "t_flat_roof",
      "rows": [
        "                                                                                                                        ",
        "5------------------------------------------------------------------------------------------------                       ",
        "-...............................................................................................-                       ",
        "-........................o..o....................A...=..&.......................................-                       ",
        "-...............................................................................................-                       ",
        "-.A.......................A......................0.......................A......................-                       ",
        "-...............................................................................................-                       ",
        "-....=.&..................=.&................................................=.&................-                       ",
        "-...............................................................................................-                       ",
        "-.............................1.................................................................-                       ",
        "-...............................................................................................-                       ",
        "-...............................................................................................-                       ",
        "-...............................................................................................-                       ",
        "-...............................................................................................-                       ",
        "-...............................................................................................-                       ",
        "-...............................................................................................-                       ",
        "-...............................................................................................-                       ",
        "-...............................................................................................-                       ",
        "-...............................................................................................-                       ",
        "-...............................................................................................-                       ",
        "-...............................................................................................-                       ",
        "5-----------------------------------------------------------------------------------------------5                       ",
        "                                                                                                                        ",
        "                                                                                                                        "
      ],
      "palettes": [ "roof_palette" ],
      "terrain": { "o": "t_glass_roof" },
      "nested": {
        "1": { "chunks": [ [ "roof_4x4_holdout", 15 ], [ "roof_4x4_party", 15 ], [ "roof_4x4_survivor", 15 ], [ "null", 55 ] ] },
        "0": { "chunks": [ [ "roof_16x16_help", 50 ], [ "null", 50 ] ] }
      }
    }
  },
  {
    "type": "mapgen",
    "nested_mapgen_id": "strip_mall_sign",
    "object": {
      "mapgensize": [ 1, 1 ],
      "rotation": [ 0, 3 ],
      "rows": [ "." ],
      "terrain": { ".": "t_sidewalk" },
      "furniture": { ".": "f_sign" },
      "place_signs": [
        { "signage": "<city> Crossing", "x": 0, "y": 0 },
        { "signage": "Kevin's Crossing", "x": 0, "y": 0 },
        { "signage": "Meghan's Megamart", "x": 0, "y": 0 },
        { "signage": "<city> Bazaar", "x": 0, "y": 0 },
        { "signage": "<family_name> Bazaar", "x": 0, "y": 0 },
        { "signage": "<city> Marketplace", "x": 0, "y": 0 },
        { "signage": "<family_name> Marketplace", "x": 0, "y": 0 },
        { "signage": "<family_name> Plaza", "x": 0, "y": 0 },
        { "signage": "<city> Plaza", "x": 0, "y": 0 },
        { "signage": "<city> Shopping Center", "x": 0, "y": 0 },
        { "signage": "<city> Business Village", "x": 0, "y": 0 },
        { "signage": "<city> Business Mall", "x": 0, "y": 0 },
        { "signage": "Ye Olde <city> Shoppes", "x": 0, "y": 0 },
        { "signage": "Slappin' Jimmy's <city> Strip Mall", "x": 0, "y": 0 },
        { "signage": "<city> Discount Shops", "x": 0, "y": 0 },
        { "signage": "<family_name>'s Discount Shops", "x": 0, "y": 0 },
        { "signage": "The <family_name> Strip", "x": 0, "y": 0 },
        { "signage": "The <city> Strip", "x": 0, "y": 0 }
      ]
    }
  },
  {
    "type": "mapgen",
    "nested_mapgen_id": "mx_exodii_crash_big_1_chop_shop",
    "object": {
      "mapgensize": [ 24, 24 ],
      "rows": [
        "        .........       ",
        "     ...............    ",
        "   .......,,,,,.......  ",
        "  .....,,,,,,,,,,.....  ",
        "  ...,,,,,,,,,,,,,,.... ",
        " ....,,,;;;;;;;,,,,.... ",
        " ...,,,;;;;;;;;;,,,,... ",
        "....,,;;;;;;;;;;,,,,....",
        "...,,,,;;;||||;;,,,,,...",
        "...,;,;;|||||;;;;,,,,...",
        "...,,;;;;||||||;;,,,,...",
        "...,;,;|||||||;;;,,,,...",
        "...,,,,;;||||||;,,,,,...",
        "...,;,,;;|||||;;,,,,,...",
        "...,,,;;|||||||;;,,,,...",
        "...,,,,,;;||;;;;,,,,,...",
        "....,,;,;;;;;;;,,,,,....",
        " ...,,,,,,;;;;;;;,,,... ",
        " ....,,,,,;;;;;,,,,.... ",
        " ....,,,,,,,,,,,,,,.... ",
        "  .......,,,,,,.......  ",
        "  ....................  ",
        "    ................    ",
        "       ..........       "
      ],
      "flags": [ "ERASE_ALL_BEFORE_PLACING_TERRAIN" ],
      "palettes": [ "exodii_crash_ground_palette" ],
      "place_nested": [
        {
          "chunks": [
            [ "nest_exodii_crash_building_big_1", 30 ],
            [ "nest_exodii_crash_building_big_2", 10 ],
            [ "nest_exodii_crash_building_small_1", 40 ],
            [ "nest_exodii_crash_building_smashed", 20 ]
          ],
          "x": [ 6, 10 ],
          "y": [ 6, 10 ]
        }
      ]
    }
  },
  {
    "type": "overmap_terrain",
    "id": [ "robofac_strip_mall_x0y0", "robofac_strip_mall_x1y0", "robofac_strip_mall_x2y0", "robofac_strip_mall_x3y0" ],
    "name": "strip mall",
    "sym": "v",
    "color": "light_red",
    "mondensity": 1,
    "copy-from": "generic_city_building",
    "flags": [ "SIDEWALK" ]
  },
  {
    "type": "overmap_terrain",
    "id": [ "robofac_strip_mall_x4y0", "robofac_strip_mall_x0y1", "robofac_strip_mall_x1y1", "robofac_strip_mall_x2y1", "robofac_strip_mall_x3y1", "robofac_strip_mall_x4y1" ],
    "name": "parking lot",
    "sym": "O",
    "color": "dark_gray",
    "mondensity": 1,
    "flags": [ "SIDEWALK" ],
    "copy-from": "generic_city_building"
  },
  {
    "type": "overmap_terrain",
    "id": [ "robofac_strip_mall_roof_1", "robofac_strip_mall_roof_2", "robofac_strip_mall_roof_3", "robofac_strip_mall_roof_4" ],
    "name": "strip mall roof",
    "sym": "v",
    "color": "light_red",
    "copy-from": "generic_city_building_roof"
  },
  {
    "type": "overmap_terrain",
    "id": "robofac_strip_mall_roof_5",
    "name": "open air",
    "copy-from": "generic_city_building_roof",
    "sym": ".",
    "color": "blue"
  },
  {
    "type": "overmap_special",
    "id": "robofac_strip_mall",
    "overmaps": [
      { "point": [ 0, 0, 0 ], "overmap": "robofac_strip_mall_x0y0_north" },
      { "point": [ 1, 0, 0 ], "overmap": "robofac_strip_mall_x1y0_north" },
      { "point": [ 2, 0, 0 ], "overmap": "robofac_strip_mall_x2y0_north" },
      { "point": [ 3, 0, 0 ], "overmap": "robofac_strip_mall_x3y0_north" },
      { "point": [ 4, 0, 0 ], "overmap": "robofac_strip_mall_x4y0_north" },
      { "point": [ 0, 1, 0 ], "overmap": "robofac_strip_mall_x0y1_north" },
      { "point": [ 1, 1, 0 ], "overmap": "robofac_strip_mall_x1y1_north" },
      { "point": [ 2, 1, 0 ], "overmap": "robofac_strip_mall_x2y1_north" },
      { "point": [ 3, 1, 0 ], "overmap": "robofac_strip_mall_x3y1_north" },
      { "point": [ 4, 1, 0 ], "overmap": "robofac_strip_mall_x4y1_north" },
      { "point": [ 0, 0, 1 ], "overmap": "robofac_strip_mall_roof_1_north" },
      { "point": [ 1, 0, 1 ], "overmap": "robofac_strip_mall_roof_2_north" },
      { "point": [ 2, 0, 1 ], "overmap": "robofac_strip_mall_roof_3_north" },
      { "point": [ 3, 0, 1 ], "overmap": "robofac_strip_mall_roof_4_north" },
      { "point": [ 4, 0, 1 ], "overmap": "robofac_strip_mall_roof_5_north" }
    ],
    "locations": [ "wilderness" ],
    "connections": [
      { "point": [ 4, 2, 0 ], "terrain": "road", "connection": "local_road", "from": [ 0, 0, 0 ], "existing": true }
    ],
    "city_distance": [ 1, 10 ],
    "city_sizes": [ 5, -1 ],
    "occurrences": [ 30, 100 ],
    "priority": 1,
    "flags": [ "MAN_MADE", "GLOBALLY_UNIQUE" ]
  },
  {
    "id": "mon_civilian_panic_robofac_chop_shop",
    "type": "MONSTER",
    "name": { "str": "panicked person" },
    "description": "This hysterical individual has a faint, yet fading, glint of intelligence in their bloodshot eyes.  They sometimes scream in fear and behave clearly irrationally.  This will quite likely cause their demise at the hands of the undead horde rather quickly.",
    "looks_like": "mon_dementia",
    "default_faction": "human",
    "bodytype": "human",
    "species": [ "HUMAN" ],
    "material": [ "hflesh" ],
    "weakpoint_sets": [ "wps_humanoid_body" ],
    "chat_topics": [ "TALK_CIVILIAN_PANIC" ],
    "volume": "62500 ml",
    "weight": "81500 g",
    "hp": 75,
    "speed": 90,
    "symbol": "@",
    "color": "white",
    "diff": 2,
    "aggression": -50,
    "morale": -50,
    "vision_day": 10,
    "melee_dice": 1,
    "melee_dice_sides": 2,
    "melee_damage": [ { "damage_type": "cut", "amount": 3 } ],
    "families": [ "prof_gross_anatomy", "prof_intro_biology", "prof_physiology" ],
    "special_attacks": [ [ "PARROT_AT_DANGER", 0 ] ],
    "//": "They are human after all",
    "harvest": "human",
    "dissect": "dissect_human_sample_single",
    "//COMMENT": "There is intentionally no death function here, GUILT_HUMAN is special-cased to apply the same penalties as murdering a NPC.",
    "death_function": {  },
    "path_settings": { "max_dist": 30, "allow_open_doors": false, "avoid_traps": false, "avoid_sharp": false },
    "dodge": 1,
    "death_drops": "default_zombie_death_drops",
    "zombify_into": "mon_zombie",
    "flags": [ "SEES", "HEARS", "WARM", "HUMAN", "CAN_OPEN_DOORS", "PATH_AVOID_DANGER", "CONVERSATION", "GUILT_HUMAN" ]
  },
  {
    "id": "mon_civilian_stationary_robofac_chop_shop",
    "type": "MONSTER",
    "name": { "str": "petrified person" },
    "description": "They just stand there, staring into the void, covered in filth and with a vacant expression on their face.",
    "speed": 20,
    "diff": 0,
    "copy-from": "mon_civilian_panic_robofac_chop_shop"
  },
  {
    "id": "mon_civilian_parent_robofac_chop_shop",
    "type": "MONSTER",
    "name": { "str": "terrified parent" },
    "special_attacks": [ [ "PARROT", 0 ] ],
    "description": "Obsessed with finding their offspring, they scour the environment for certain death.",
    "chat_topics": [ "TALK_CIVILIAN_PARENT" ],
    "copy-from": "mon_civilian_panic_robofac_chop_shop"
  }
]
