[
    {
      "type": "item_group",
      "id": "slaughter_raw_meat",
      "items": [
        { "item": "meat", "prob": 8, "charges": [ 1, 10 ] },
        { "item": "lung", "prob": 1, "charges": [ 1, 20 ] },
        { "item": "kidney", "prob": 1, "charges": [ 1, 20 ] },
        { "item": "liver", "prob": 1, "charges": [ 1, 10 ] },
        { "item": "brain", "prob": 1, "charges": [ 1, 10 ] },
        { "item": "sweetbread", "prob": 2, "charges": [ 1, 10 ] },
        { "item": "fat", "prob": 2, "charges": [ 5, 30 ] }
      ]
    },
    {
      "type": "item_group",
      "id": "slaughter_tools",
      "items": [
        [ "knife_butcher", 30 ],
        [ "tongs", 10 ],
        [ "hacksaw", 10 ]
      ]
    },
    {
      "type": "item_group",
      "id": "slaughter_clothes",
      "items": [
        [ "apron_leather", 30 ],
        [ "jumpsuit", 30 ],
        [ "gloves_rubber", 10 ],
        [ "boots_rubber", 10 ],
        [ "gloves_cut_resistant", 10 ]
      ]
    },
    {
      "id": "f_hanging_meathook",
      "type": "furniture",
      "name": "hanging meathook",
      "symbol": "g",
      "required_str": -1,
      "move_cost_mod": 2,
      "color": "light_gray",
      "deconstruct": { "items": [ { "item": "grip_hook", "count": 1 }, { "item": "chain", "count": 1 } ] },
      "flags": [ "TRANSPARENT" ]
    },
    {
      "type": "mapgen",
      "method": "json",
      "om_terrain": [ "slaughterhouse_1_roof" ],
      "weight": 500,
      "object": {
        "fill_ter": "t_open_air",
        "rows": [
          "                        ",
          "   -------------------- ",
          "   |..................3 ",
          "   |..................3 ",
          "   |..................3 ",
          " |-|..................3 ",
          " |....................3 ",
          " |....................3 ",
          " |....................3 ",
          " |....................3 ",
          " |........&...........3 ",
          " |....................3 ",
          " |....................3 ",
          " |....................3 ",
          " |....................3 ",
          " |....................3 ",
          " |....................3 ",
          " |....................3 ",
          " |....................3 ",
          " ________~~~~~~~~~~~~~3 ",
          "        |~~~~~~~~~~~~~3 ",
          "        4~~~~~~~~~~~~~3 ",
          "        ______________3 ",
          "                        " 
        ],
        "terrain": {
        " ": "t_open_air",
        ".": "t_flat_roof",
        "3": "t_gutter_east",
        "_": "t_gutter_south",
        "-": "t_gutter_north",
        "|": "t_gutter_west",
        "4": "t_gutter_drop",
        "&": "t_flat_roof",
        "~": "t_metal_floor"
        },
        "furniture": { "&": "f_roof_turbine_vent" },
        "place_items": [ { "item": "roof_trash", "x": [ 2, 22 ], "y": [ 5, 18 ], "chance": 50, "repeat": [ 1, 3 ] } ]
      }
    },
    {
      "type": "mapgen",
      "method": "json",
      "om_terrain": [ "slaughterhouse_1" ],
      "weight": 500,
      "object": {
        "rows": [
          "~~~~~~~~~~~~~~~~~~~~~~~~",
          "~~~--------------------~",
          "~~~7        GGGGGGG|&D|~",
          "~~~7               |  |~",
          "~~~7               |-2|~",
          "~~~|8   MMMMMMMMMMMMMM|~",
          "~|9-    F.M.M.FEA.M.M3|~",
          "~|      F.M.M.FEA.M.M.|~",
          "~|      F.M.M.FEA.M.M.|~",
          "~|      F.M.g.MMM.g.M.|~",
          "~|      F.M.M.FEA.M.M.|~",
          "~|      F.M.M.FEA.M.M.|~",
          "~|      F.M.M.FEA.M.M.|~",
          "~|      F.M.g.MMM.g.M.|~",
          "~|      F.M.M.FEA.8---|~",
          "~|      F.M.M.FEA.M7~~~~",
          "~|      F.M.M.FEA.M7~~~~",
          "~|      F.M.M.MMM.M7~~~~",
          "~|      +++++++66++++++~",
          "~---9---1gMMMMMMMMMMMI1~",
          "~4~~~~HH1gMMMMMMMMMMMg1~",
          "~4~~~~~B1gMMgggMggggMg1~",
          "~44444441+++++++++++++1~",
          "~~~~~~~~~~~~~~~~~~~~~~~~"
        ],
        "terrain": {
          " ": "t_floor",
          "~": "t_pavement",
          "+": "t_wall_metal_h",
          "-": "t_wall_h",
          ".": "t_grate",
          "1": "t_wall_metal_v",
          "2": "t_door_c",
          "3": "t_stairs_down",
          "4": "t_chainfence",
          "6": "t_door_metal_c",
          "7": "t_door_metal_locked",
          "8": "t_gates_mech_control",
          "9": "t_door_locked",
          "A": "t_metal_floor",
          "B": "t_gutter_downspout",
          "C": "t_floor",
          "D": "t_floor",
          "E": "t_metal_floor",
          "F": "t_metal_floor",
          "G": "t_floor",
          "H": "t_floor",
          "I": "t_metal_floor",
          "J": "t_chaingate_l",
          "M": "t_metal_floor",
          "&": "t_floor",
          "|": "t_wall_v",
          "g": "t_metal_floor"
        },
        "furniture": {
          "A": "f_rack",
          "&": "f_toilet",
          "C": "f_counter",
          "D": "f_sink",
          "E": "f_metal_butcher_rack",
          "F": "f_counter",
          "G": "f_locker",
          "H": "f_dumpster",
          "I": "f_air_conditioner",
          "g": "f_hanging_meathook"
        },
        "place_fields": [
          { "x": [ 6, 21 ], "y": [ 3, 17 ], "field": "fd_blood", "density": 1, "repeat": [ 10, 30 ], "age": 3 },
          { "x": [ 8, 21 ], "y": [ 5, 17 ], "field": "fd_blood", "density": 2, "repeat": [ 10, 30 ], "age": 3 }
        ],
        "toilets": { "&": {  } },
        "place_loot": [
          { "group": "trash", "chance": 100, "repeat": [ 1, 2 ], "x": [ 6, 7 ], "y": [ 20, 20 ] },
          { "group": "slaughter_clothes", "chance": 100, "repeat": [ 1, 7 ], "x": [ 12, 18 ], "y": [ 1, 1 ] },
          { "group": "slaughter_tools", "chance": 10, "repeat": [ 1, 3 ], "x": [ 16, 16 ], "y": [ 6, 8 ] },
          { "group": "slaughter_tools", "chance": 10, "repeat": [ 1, 3 ], "x": [ 16, 16 ], "y": [ 10, 12 ] },
          { "group": "slaughter_tools", "chance": 10, "repeat": [ 1, 3 ], "x": [ 16, 16 ], "y": [ 14, 16 ] },
          { "group": "slaughter_raw_meat", "chance": 10, "repeat": [ 1, 3 ], "x": [ 14, 14 ], "y": [ 6, 8 ] },
          { "group": "slaughter_raw_meat", "chance": 10, "repeat": [ 1, 3 ], "x": [ 14, 14 ], "y": [ 10, 12 ] },
          { "group": "slaughter_raw_meat", "chance": 10, "repeat": [ 1, 3 ], "x": [ 14, 14 ], "y": [ 14, 16 ] },
          { "group": "slaughter_raw_meat", "chance": 10, "repeat": [ 1, 11 ], "x": [ 8, 8 ], "y": [ 6, 17 ] }
        ],
        "place_monsters": [
          { "monster": "GROUP_ROACH", "x": 11, "y": 11, "chance": 10, "density": 0.5 },
          { "monster": "GROUP_ZOMBIE", "x": 11, "y": 11, "chance": 10, "density": 0.25 }
        ]
      }
    },
    {
      "type": "mapgen",
      "method": "json",
      "om_terrain": [ "slaughterhouse_1_basement" ],
      "weight": 500,
      "object": {
        "fill_ter": "t_thconc_floor",
        "rows": [
          "                        ",
          "                        ",
          "                        ",
          "                        ",
          "                        ",
          "        --------------- ",
          "        |............3| ",
          "        |.............| ",
          "        |.............| ",
          "        |.............| ",
          "        |.............| ",
          "        |.............| ",
          "        |.............| ",
          "        |.............| ",
          "        |.........----| ",
          "        |.........|     ",
          "        |.........|     ",
          "        |.........|     ",
          "        -----------     ",
          "                        ",
          "                        ",
          "                        ",
          "                        ",
          "                        "
        ],
        "terrain": {
          " ": "t_thconc_floor",
          "-": "t_wall_h",
          "|": "t_wall_v",
          ".": "t_metal_floor",
          "3": "t_stairs_up"
        },
        "place_fields": [
          { "x": [ 9, 22 ], "y": [ 5, 18 ], "field": "fd_blood", "density": 3, "repeat": [ 100, 300 ], "age": 3 }
        ],
        "place_monsters": [
          { "monster": "GROUP_ROACH", "x": 11, "y": 11, "chance": 1, "density": 1 }
        ]
      }
    }
  ]
  