[
  {
    "type": "mapgen",
    "method": "json",
    "om_terrain": [ [ "ierde_genius_loci_NW", "ierde_genius_loci_NE" ], [ "ierde_genius_loci_SW", "ierde_genius_loci_SE" ] ],
    "object": {
      "fill_ter": "t_region_groundcover_urban",
      "rows": [
        "                                                ",
        "                                                ",
        "                                                ",
        "                     2 2                        ",
        " ||||||||||||||||||||| ||||||||||||||||||||||   ",
        " |     |          |         |     |     |   |   ",
        " | ||| |  ||| ||| | ||||||| | ||| | ||| ||| |   ",
        " | |   |  |   |   | |     |   |   | |       |   ",
        " | |||||||| ||| ||| | ||||||||| | ||| | | |||   ",
        " |   | |    |   |   |       | | |     | |   |   ",
        " ||| | |  ||||||||| ||||||| | ||||||||| ||| |   ",
        " |   | |      |     |     | | |   |     |   |   ",
        " | | | |||||| ||||| | ||||| | | | | |||||||||   ",
        " | |      |   |     | |     |   | |     |   |   ",
        " |||||||| | ||| ||||| | ||| ||||| | ||| | | |   ",
        " |        |     |   |     |     |     |   | |   ",
        " | |||||||| ||||| | ||||| ||||| ||||| ||||| |   ",
        " |          |     |     |     | |     |     |   ",
        " |||||||||| | ||||||||||||||| | | ||||||| |||   ",
        " | |      | |   |           | |   |     |   |   ",
        " | | |||| | ||| | ######### | ||||| ||| | | |   ",
        " | |    |   |   | #4.....4# | |     | | | | |   ",
        " | |--------- | | #...X...# | ||||||| | ||| |2  ",
        " | |  |   |   | | #.......# |   |     |         ",
        " | |||-----   | | #.4...4.# ||| ||| ||||||||    ",
        " | |    |     | | #.......# | |   |   |         ",
        " | | |-----|||||| #bb...bb# | ||| ||| ||||| |2  ",
        " | |        |   | #### #### |   |         | |   ",
        " | |||||| ||| | |   31 13   ||| ||| ||||| | |   ",
        " |      | |   | |2         2|   | | |   | | |   ",
        " |||||| | | ||| |||||| |||||| ||| | | | | | |   ",
        " |    | | |   | |         |   |     | | |   |   ",
        "2|  | | | ||| | ||| ||||--------||||||| ||| |   ",
        "    |   | |   |   |     | ----- |         | |   ",
        "  ||| ||| | ||||| |||||----------|| ||||| |||   ",
        "      |   | |           | |       | |       |   ",
        "2| |||| | | ||||||||||||| ||||| | ||| ||||| |   ",
        " |      | |   |     | |   | |   |   | |   | |   ",
        " ||| ||-----| ||| | | | | | | ||||| | | ||| |   ",
        " | |    ----      |   | |   |   |     |   | |   ",
        " | ||||------|||||||||| ||||||| |-----  | | |   ",
        " |  | |   |           |     | --------- |   |   ",
        " | || | | ||||| | ||| ||||| | ----------||| |   ",
        " |  |   |       | |   |   |      | |    |   |   ",
        " || | ||||||||||| | ||| | ||| || | |||| | |||   ",
        " |    |           |     |     |    |    |   |   ",
        " |||||||||||||||||||||  |||||||||||||||||||||   ",
        "                     2  2                       "
      ],
      "terrain": {
        " ": "t_region_groundcover_urban",
        ".": "t_rock_floor",
        "X": "t_rock_floor",
        "b": "t_rock_floor",
        "1": "t_rock_floor",
        "-": [ [ "t_region_groundcover_urban", 5 ], "t_region_tree_shade", 2 ],
        "#": "t_rock_wall"
      },
      "furniture": {
        "|": "f_hedge_tall",
        "b": "f_bench",
        "h": "f_bench",
        "X": "f_elemental_altar",
        "1": "f_brazier",
        "2": "f_topiary_animal",
        "3": "f_topiary_abstract",
        "4": "f_topiary_dragon"
      }
    }
  },
  {
    "type": "mapgen",
    "method": "json",
    "om_terrain": [ [ "undine_genius_loci_NW", "undine_genius_loci_NE" ], [ "undine_genius_loci_SW", "undine_genius_loci_SE" ] ],
    "object": {
      "fill_ter": "t_region_groundcover_urban",
      "rows": [
        "                                                ",
        "                                                ",
        "                                                ",
        "                     2 2                        ",
        " ||||||||||||||||||||| ||||||||||||||||||||||   ",
        " |     |          |         |     |     |   |   ",
        " | ||| |  ||| ||| | ||||||| | ||| | ||| ||| |   ",
        " | |   |  |   |   | |     |   |   | |       |   ",
        " | |||||||| ||| ||| | ||||||||| | ||| | | |||   ",
        " |   | |    |   |   |       | | |     | |   |   ",
        " ||| | |  ||||||||| ||||||| | ||||||||| ||| |   ",
        " |   | |      |     |     | | |   |     |   |   ",
        " | | | |||||| ||||| | ||||| | | | | |||||||||   ",
        " | |      |   |     | |     |   | |     |   |   ",
        " |||||||| | ||| ||||| | ||| ||||| | ||| | | |   ",
        " |        |     |   |     |     |     |   | |   ",
        " | |||||||| ||||| | ||||| ||||| ||||| ||||| |   ",
        " |          |     |     |     | |     |     |   ",
        " |||||||||| | ||||||||||||||| | | ||||||| |||   ",
        " | |      | |   |           | |   |     |   |   ",
        " | | |||| | ||| | ######### | ||||| ||| | | |   ",
        " | |    |   |   | #4.....4# | |     | | | | |   ",
        " | |--------- | | #...X...# | ||||||| | ||| |2  ",
        " | |  |   |   | | #.......# |   |     |         ",
        " | |||-----   | | #.4...4.# ||| ||| ||||||||    ",
        " | |    |     | | #.......# | |   |   |         ",
        " | | |-----|||||| #bb...bb# | ||| ||| ||||| |2  ",
        " | |        |   | #### #### |   |         | |   ",
        " | |||||| ||| | |   31 13   ||| ||| ||||| | |   ",
        " |      | |   | |2         2|   | | |   | | |   ",
        " |||||| | | ||| |||||| |||||| ||| | | | | | |   ",
        " |    | | |   | |         |   |     | | |   |   ",
        "2|  | | | ||| | ||| ||||--------||||||| ||| |   ",
        "    |   | |   |   |     | ----- |         | |   ",
        "  ||| ||| | ||||| |||||----------|| ||||| |||   ",
        "      |   | |           | |       | |       |   ",
        "2| |||| | | ||||||||||||| ||||| | ||| ||||| |   ",
        " |      | |   |     | |   | |   |   | |   | |   ",
        " ||| ||-----| ||| | | | | | | ||||| | | ||| |   ",
        " | |    ----      |   | |   |   |     |   | |   ",
        " | ||||------|||||||||| ||||||| |-----  | | |   ",
        " |  | |   |           |     | --------- |   |   ",
        " | || | | ||||| | ||| ||||| | ----------||| |   ",
        " |  |   |       | |   |   |      | |    |   |   ",
        " || | ||||||||||| | ||| | ||| || | |||| | |||   ",
        " |    |           |     |     |    |    |   |   ",
        " |||||||||||||||||||||  |||||||||||||||||||||   ",
        "                     2  2                       "
      ],
      "terrain": {
        " ": "t_region_groundcover_urban",
        ".": "t_rock_floor",
        "X": "t_rock_floor",
        "b": "t_rock_floor",
        "1": "t_rock_floor",
        "-": [ [ "t_region_groundcover_urban", 5 ], "t_region_tree_shade", 2 ],
        "#": "t_rock_wall"
      },
      "furniture": {
        "|": "f_hedge_tall",
        "b": "f_bench",
        "h": "f_bench",
        "X": "f_elemental_altar",
        "1": "f_brazier",
        "2": "f_topiary_animal",
        "3": "f_topiary_abstract",
        "4": "f_topiary_dragon"
      }
    }
  },
  {
    "type": "mapgen",
    "method": "json",
    "om_terrain": [ [ "arvore_genius_loci_NW", "arvore_genius_loci_NE" ], [ "arvore_genius_loci_SW", "arvore_genius_loci_SE" ] ],
    "object": {
      "fill_ter": "t_region_groundcover_urban",
      "rows": [
        "                                                ",
        "                                                ",
        "                                                ",
        "                     2 2                        ",
        " ||||||||||||||||||||| ||||||||||||||||||||||   ",
        " |     |          |         |     |     |   |   ",
        " | ||| |  ||| ||| | ||||||| | ||| | ||| ||| |   ",
        " | |   |  |   |   | |     |   |   | |       |   ",
        " | |||||||| ||| ||| | ||||||||| | ||| | | |||   ",
        " |   | |    |   |   |       | | |     | |   |   ",
        " ||| | |  ||||||||| ||||||| | ||||||||| ||| |   ",
        " |   | |      |     |     | | |   |     |   |   ",
        " | | | |||||| ||||| | ||||| | | | | |||||||||   ",
        " | |      |   |     | |     |   | |     |   |   ",
        " |||||||| | ||| ||||| | ||| ||||| | ||| | | |   ",
        " |        |     |   |     |     |     |   | |   ",
        " | |||||||| ||||| | ||||| ||||| ||||| ||||| |   ",
        " |          |     |     |     | |     |     |   ",
        " |||||||||| | ||||||||||||||| | | ||||||| |||   ",
        " | |      | |   |           | |   |     |   |   ",
        " | | |||| | ||| | ######### | ||||| ||| | | |   ",
        " | |    |   |   | #4.....4# | |     | | | | |   ",
        " | |--------- | | #...X...# | ||||||| | ||| |2  ",
        " | |  |   |   | | #.......# |   |     |         ",
        " | |||-----   | | #.4...4.# ||| ||| ||||||||    ",
        " | |    |     | | #.......# | |   |   |         ",
        " | | |-----|||||| #bb...bb# | ||| ||| ||||| |2  ",
        " | |        |   | #### #### |   |         | |   ",
        " | |||||| ||| | |   31 13   ||| ||| ||||| | |   ",
        " |      | |   | |2         2|   | | |   | | |   ",
        " |||||| | | ||| |||||| |||||| ||| | | | | | |   ",
        " |    | | |   | |         |   |     | | |   |   ",
        "2|  | | | ||| | ||| ||||--------||||||| ||| |   ",
        "    |   | |   |   |     | ----- |         | |   ",
        "  ||| ||| | ||||| |||||----------|| ||||| |||   ",
        "      |   | |           | |       | |       |   ",
        "2| |||| | | ||||||||||||| ||||| | ||| ||||| |   ",
        " |      | |   |     | |   | |   |   | |   | |   ",
        " ||| ||-----| ||| | | | | | | ||||| | | ||| |   ",
        " | |    ----      |   | |   |   |     |   | |   ",
        " | ||||------|||||||||| ||||||| |-----  | | |   ",
        " |  | |   |           |     | --------- |   |   ",
        " | || | | ||||| | ||| ||||| | ----------||| |   ",
        " |  |   |       | |   |   |      | |    |   |   ",
        " || | ||||||||||| | ||| | ||| || | |||| | |||   ",
        " |    |           |     |     |    |    |   |   ",
        " |||||||||||||||||||||  |||||||||||||||||||||   ",
        "                     2  2                       "
      ],
      "terrain": {
        " ": "t_region_groundcover_urban",
        ".": "t_rock_floor",
        "X": "t_rock_floor",
        "b": "t_rock_floor",
        "1": "t_rock_floor",
        "-": [ [ "t_region_groundcover_urban", 5 ], "t_region_tree_shade", 2 ],
        "#": "t_rock_wall"
      },
      "furniture": {
        "|": "f_hedge_tall",
        "b": "f_bench",
        "h": "f_bench",
        "X": "f_elemental_altar",
        "1": "f_brazier",
        "2": "f_topiary_animal",
        "3": "f_topiary_abstract",
        "4": "f_topiary_dragon"
      }
    }
  },
  {
    "type": "mapgen",
    "method": "json",
    "om_terrain": [
      [ "salamander_genius_loci_NW", "salamander_genius_loci_NE" ],
      [ "salamander_genius_loci_SW", "salamander_genius_loci_SE" ]
    ],
    "object": {
      "fill_ter": "t_region_groundcover_urban",
      "rows": [
        "                                                ",
        "                                                ",
        "                                                ",
        "                     2 2                        ",
        " ||||||||||||||||||||| ||||||||||||||||||||||   ",
        " |     |          |         |     |     |   |   ",
        " | ||| |  ||| ||| | ||||||| | ||| | ||| ||| |   ",
        " | |   |  |   |   | |     |   |   | |       |   ",
        " | |||||||| ||| ||| | ||||||||| | ||| | | |||   ",
        " |   | |    |   |   |       | | |     | |   |   ",
        " ||| | |  ||||||||| ||||||| | ||||||||| ||| |   ",
        " |   | |      |     |     | | |   |     |   |   ",
        " | | | |||||| ||||| | ||||| | | | | |||||||||   ",
        " | |      |   |     | |     |   | |     |   |   ",
        " |||||||| | ||| ||||| | ||| ||||| | ||| | | |   ",
        " |        |     |   |     |     |     |   | |   ",
        " | |||||||| ||||| | ||||| ||||| ||||| ||||| |   ",
        " |          |     |     |     | |     |     |   ",
        " |||||||||| | ||||||||||||||| | | ||||||| |||   ",
        " | |      | |   |           | |   |     |   |   ",
        " | | |||| | ||| | ######### | ||||| ||| | | |   ",
        " | |    |   |   | #4.....4# | |     | | | | |   ",
        " | |--------- | | #...X...# | ||||||| | ||| |2  ",
        " | |  |   |   | | #.......# |   |     |         ",
        " | |||-----   | | #.4...4.# ||| ||| ||||||||    ",
        " | |    |     | | #.......# | |   |   |         ",
        " | | |-----|||||| #bb...bb# | ||| ||| ||||| |2  ",
        " | |        |   | #### #### |   |         | |   ",
        " | |||||| ||| | |   31 13   ||| ||| ||||| | |   ",
        " |      | |   | |2         2|   | | |   | | |   ",
        " |||||| | | ||| |||||| |||||| ||| | | | | | |   ",
        " |    | | |   | |         |   |     | | |   |   ",
        "2|  | | | ||| | ||| ||||--------||||||| ||| |   ",
        "    |   | |   |   |     | ----- |         | |   ",
        "  ||| ||| | ||||| |||||----------|| ||||| |||   ",
        "      |   | |           | |       | |       |   ",
        "2| |||| | | ||||||||||||| ||||| | ||| ||||| |   ",
        " |      | |   |     | |   | |   |   | |   | |   ",
        " ||| ||-----| ||| | | | | | | ||||| | | ||| |   ",
        " | |    ----      |   | |   |   |     |   | |   ",
        " | ||||------|||||||||| ||||||| |-----  | | |   ",
        " |  | |   |           |     | --------- |   |   ",
        " | || | | ||||| | ||| ||||| | ----------||| |   ",
        " |  |   |       | |   |   |      | |    |   |   ",
        " || | ||||||||||| | ||| | ||| || | |||| | |||   ",
        " |    |           |     |     |    |    |   |   ",
        " |||||||||||||||||||||  |||||||||||||||||||||   ",
        "                     2  2                       "
      ],
      "terrain": {
        " ": "t_region_groundcover_urban",
        ".": "t_rock_floor",
        "X": "t_rock_floor",
        "b": "t_rock_floor",
        "1": "t_rock_floor",
        "-": [ [ "t_region_groundcover_urban", 5 ], "t_region_tree_shade", 2 ],
        "#": "t_rock_wall"
      },
      "furniture": {
        "|": "f_hedge_tall",
        "b": "f_bench",
        "h": "f_bench",
        "X": "f_elemental_altar",
        "1": "f_brazier",
        "2": "f_topiary_animal",
        "3": "f_topiary_abstract",
        "4": "f_topiary_dragon"
      }
    }
  },
  {
    "type": "mapgen",
    "method": "json",
    "om_terrain": [ [ "sylph_genius_loci_NW", "sylph_genius_loci_NE" ], [ "sylph_genius_loci_SW", "sylph_genius_loci_SE" ] ],
    "object": {
      "fill_ter": "t_region_groundcover_urban",
      "rows": [
        "                                                ",
        "                                                ",
        "                                                ",
        "                     2 2                        ",
        " ||||||||||||||||||||| ||||||||||||||||||||||   ",
        " |     |          |         |     |     |   |   ",
        " | ||| |  ||| ||| | ||||||| | ||| | ||| ||| |   ",
        " | |   |  |   |   | |     |   |   | |       |   ",
        " | |||||||| ||| ||| | ||||||||| | ||| | | |||   ",
        " |   | |    |   |   |       | | |     | |   |   ",
        " ||| | |  ||||||||| ||||||| | ||||||||| ||| |   ",
        " |   | |      |     |     | | |   |     |   |   ",
        " | | | |||||| ||||| | ||||| | | | | |||||||||   ",
        " | |      |   |     | |     |   | |     |   |   ",
        " |||||||| | ||| ||||| | ||| ||||| | ||| | | |   ",
        " |        |     |   |     |     |     |   | |   ",
        " | |||||||| ||||| | ||||| ||||| ||||| ||||| |   ",
        " |          |     |     |     | |     |     |   ",
        " |||||||||| | ||||||||||||||| | | ||||||| |||   ",
        " | |      | |   |           | |   |     |   |   ",
        " | | |||| | ||| | ######### | ||||| ||| | | |   ",
        " | |    |   |   | #4.....4# | |     | | | | |   ",
        " | |--------- | | #...X...# | ||||||| | ||| |2  ",
        " | |  |   |   | | #.......# |   |     |         ",
        " | |||-----   | | #.4...4.# ||| ||| ||||||||    ",
        " | |    |     | | #.......# | |   |   |         ",
        " | | |-----|||||| #bb...bb# | ||| ||| ||||| |2  ",
        " | |        |   | #### #### |   |         | |   ",
        " | |||||| ||| | |   31 13   ||| ||| ||||| | |   ",
        " |      | |   | |2         2|   | | |   | | |   ",
        " |||||| | | ||| |||||| |||||| ||| | | | | | |   ",
        " |    | | |   | |         |   |     | | |   |   ",
        "2|  | | | ||| | ||| ||||--------||||||| ||| |   ",
        "    |   | |   |   |     | ----- |         | |   ",
        "  ||| ||| | ||||| |||||----------|| ||||| |||   ",
        "      |   | |           | |       | |       |   ",
        "2| |||| | | ||||||||||||| ||||| | ||| ||||| |   ",
        " |      | |   |     | |   | |   |   | |   | |   ",
        " ||| ||-----| ||| | | | | | | ||||| | | ||| |   ",
        " | |    ----      |   | |   |   |     |   | |   ",
        " | ||||------|||||||||| ||||||| |-----  | | |   ",
        " |  | |   |           |     | --------- |   |   ",
        " | || | | ||||| | ||| ||||| | ----------||| |   ",
        " |  |   |       | |   |   |      | |    |   |   ",
        " || | ||||||||||| | ||| | ||| || | |||| | |||   ",
        " |    |           |     |     |    |    |   |   ",
        " |||||||||||||||||||||  |||||||||||||||||||||   ",
        "                     2  2                       "
      ],
      "terrain": {
        " ": "t_region_groundcover_urban",
        ".": "t_rock_floor",
        "X": "t_rock_floor",
        "b": "t_rock_floor",
        "1": "t_rock_floor",
        "-": [ [ "t_region_groundcover_urban", 5 ], "t_region_tree_shade", 2 ],
        "#": "t_rock_wall"
      },
      "furniture": {
        "|": "f_hedge_tall",
        "b": "f_bench",
        "h": "f_bench",
        "X": "f_elemental_altar",
        "1": "f_brazier",
        "2": "f_topiary_animal",
        "3": "f_topiary_abstract",
        "4": "f_topiary_dragon"
      }
    }
  },
  {
    "type": "mapgen",
    "method": "json",
    "om_terrain": [ [ "homullus_genius_loci_NW", "homullus_genius_loci_NE" ], [ "homullus_genius_loci_SW", "homullus_genius_loci_SE" ] ],
    "object": {
      "fill_ter": "t_region_groundcover_urban",
      "rows": [
        "                                                ",
        "                                                ",
        "                                                ",
        "                     2 2                        ",
        " ||||||||||||||||||||| ||||||||||||||||||||||   ",
        " |     |          |         |     |     |   |   ",
        " | ||| |  ||| ||| | ||||||| | ||| | ||| ||| |   ",
        " | |   |  |   |   | |     |   |   | |       |   ",
        " | |||||||| ||| ||| | ||||||||| | ||| | | |||   ",
        " |   | |    |   |   |       | | |     | |   |   ",
        " ||| | |  ||||||||| ||||||| | ||||||||| ||| |   ",
        " |   | |      |     |     | | |   |     |   |   ",
        " | | | |||||| ||||| | ||||| | | | | |||||||||   ",
        " | |      |   |     | |     |   | |     |   |   ",
        " |||||||| | ||| ||||| | ||| ||||| | ||| | | |   ",
        " |        |     |   |     |     |     |   | |   ",
        " | |||||||| ||||| | ||||| ||||| ||||| ||||| |   ",
        " |          |     |     |     | |     |     |   ",
        " |||||||||| | ||||||||||||||| | | ||||||| |||   ",
        " | |      | |   |           | |   |     |   |   ",
        " | | |||| | ||| | ######### | ||||| ||| | | |   ",
        " | |    |   |   | #4.....4# | |     | | | | |   ",
        " | |--------- | | #...X...# | ||||||| | ||| |2  ",
        " | |  |   |   | | #.......# |   |     |         ",
        " | |||-----   | | #.4...4.# ||| ||| ||||||||    ",
        " | |    |     | | #.......# | |   |   |         ",
        " | | |-----|||||| #bb...bb# | ||| ||| ||||| |2  ",
        " | |        |   | #### #### |   |         | |   ",
        " | |||||| ||| | |   31 13   ||| ||| ||||| | |   ",
        " |      | |   | |2         2|   | | |   | | |   ",
        " |||||| | | ||| |||||| |||||| ||| | | | | | |   ",
        " |    | | |   | |         |   |     | | |   |   ",
        "2|  | | | ||| | ||| ||||--------||||||| ||| |   ",
        "    |   | |   |   |     | ----- |         | |   ",
        "  ||| ||| | ||||| |||||----------|| ||||| |||   ",
        "      |   | |           | |       | |       |   ",
        "2| |||| | | ||||||||||||| ||||| | ||| ||||| |   ",
        " |      | |   |     | |   | |   |   | |   | |   ",
        " ||| ||-----| ||| | | | | | | ||||| | | ||| |   ",
        " | |    ----      |   | |   |   |     |   | |   ",
        " | ||||------|||||||||| ||||||| |-----  | | |   ",
        " |  | |   |           |     | --------- |   |   ",
        " | || | | ||||| | ||| ||||| | ----------||| |   ",
        " |  |   |       | |   |   |      | |    |   |   ",
        " || | ||||||||||| | ||| | ||| || | |||| | |||   ",
        " |    |           |     |     |    |    |   |   ",
        " |||||||||||||||||||||  |||||||||||||||||||||   ",
        "                     2  2                       "
      ],
      "terrain": {
        " ": "t_region_groundcover_urban",
        ".": "t_rock_floor",
        "X": "t_rock_floor",
        "b": "t_rock_floor",
        "1": "t_rock_floor",
        "-": [ [ "t_region_groundcover_urban", 5 ], "t_region_tree_shade", 2 ],
        "#": "t_rock_wall"
      },
      "furniture": {
        "|": "f_hedge_tall",
        "b": "f_bench",
        "h": "f_bench",
        "X": "f_elemental_altar",
        "1": "f_brazier",
        "2": "f_topiary_animal",
        "3": "f_topiary_abstract",
        "4": "f_topiary_dragon"
      }
    }
  },
  {
    "type": "mapgen",
    "method": "json",
    "om_terrain": [ [ "genius_loci_NW_roof", "genius_loci_NE_roof" ], [ "genius_loci_SW_roof", "genius_loci_SE_roof" ] ],
    "object": {
      "fill_ter": "t_shingle_flat_roof",
      "rows": [
        "                                                ",
        "                                                ",
        "                                                ",
        "                                                ",
        "                                                ",
        "                                                ",
        "                                                ",
        "                                                ",
        "                                                ",
        "                                                ",
        "                                                ",
        "                                                ",
        "                                                ",
        "                                                ",
        "                                                ",
        "                                                ",
        "                                                ",
        "                                                ",
        "                                                ",
        "                                                ",
        "                 .........                      ",
        "                 .........                      ",
        "                 ...ooo...                      ",
        "                 ...ooo...                      ",
        "                 ...ooo...                      ",
        "                 .........                      ",
        "                 .........                      ",
        "                 .........                      ",
        "                                                ",
        "                                                ",
        "                                                ",
        "                                                ",
        "                                                ",
        "                                                ",
        "                                                ",
        "                                                ",
        "                                                ",
        "                                                ",
        "                                                ",
        "                                                ",
        "                                                ",
        "                                                ",
        "                                                ",
        "                                                ",
        "                                                ",
        "                                                ",
        "                                                ",
        "                                                "
      ],
      "palettes": [ "roof_palette" ],
      "terrain": { ".": "t_shingle_flat_roof" }
    }
  }
]
