[
  {
    "type": "mapgen",
    "method": "json",
    "om_terrain": [ [ "lodgev_ground1", "lodgev_ground2" ] ],
    "object": {
      "fill_ter": "t_floor",
      "rows": [
        ".%##W###W###W###W###+##W#################%......",
        ".*#c B#c B#B c#B c#  #h s#a            >#*......",
        ".*Wd B#d B#B d#B d#  #h T#^   a ZZZ OC  W*......",
        ".*##=###=###=###=##  ##=##a   a ZZZ OC  #*......",
        ".*#                           a ZZZ OC  #*......",
        ".*W                                     W*......",
        ".*#    YY   YY  AAAAAAAA  ata ^        >#*......",
        ".%########+########################   ###*......",
        "ooooooooooGGGGGGG~~~~~~~~~~~~~~~~~#   #%**......",
        "ooooooooooooooooG~~~~~%############   #*........",
        "ooooooooooooooooG~~~~~*w              #*........",
        "ooooooooooooooooG~~~~~*#Y   c c c     w*........",
        "ooooooooooooooooGGGGGGG+    ttttt    bw*........",
        "ooooooooooooooooGGGGGGG+    ttttt    bw*........",
        "oooooooooooooooo~~~~~G*#Y   c c c     w*........",
        "oooooooooooooooo~~~~~G*w              w*........",
        "oooooooooooooooo~~~~~G*#####   ########*........",
        "oooooooooooooooo~~~~~G***#<#   #********........",
        "oooooooooooooooo%~~~~GGGG+ #   #%****...........",
        "......*###-###-###-#########   #####*...........",
        ".....0*#UU URU URU URU #12C     5 é#*...........",
        ".....0*#R              z      C   uW*...........",
        ".....0*#UU URU URU URU #3CC&  4CVuF#*...........",
        "......%###-###-###-##########+######%..........."
      ],
      "palettes": [ "lodge_palette" ],
      "place_monsters": [ { "monster": "GROUP_VAMPIRES_MIXED", "x": [ 0, 23 ], "y": [ 0, 23 ], "density": 0.3 } ],
      "place_zones": [ { "type": "ZONE_START_POINT", "faction": "your_followers", "x": [ 16, 17 ], "y": [ 2, 3 ] } ],
      "place_nested": [
        {
          "chunks": [ [ "lodge_pantry_15x15", 80 ], [ "lodge_cannibal_15x15", 20 ], [ "lodge_hunting_15x15", 50 ] ],
          "x": 8,
          "y": 9
        }
      ]
    }
  },
  {
    "type": "mapgen",
    "method": "json",
    "om_terrain": [ [ "lodgev_2ndfloor1", "lodgev_2ndfloor2" ] ],
    "object": {
      "fill_ter": "t_open_air",
      "rows": [
        " %##W###W###W###W###w##W#################%      ",
        "  #hh_________DD____/__________________<#       ",
        "  Whh__///_________/_/____OOOOO_ZZZ_____W       ",
        "  #____/_/________/___/___O_____ZZZ_///D#       ",
        "  #__O_///O________/___/________ZZZ_/_/D#       ",
        "  W__OOOOOO_________/_/____hhh______///_W       ",
        "  #_________éFF______/_____hhh_________<#       ",
        " %########w#######wwww#############www###       ",
        "                                  -...%         ",
        "                       5-----------...-         ",
        "                       -..............-         ",
        "                       -..............-         ",
        "                       -..............-         ",
        "                       -..............-         ",
        "                       -..............-         ",
        "                       -..............-         ",
        "                       ---.....--------         ",
        "                         -.....-                ",
        "                         -.....-                ",
        "       ---------5---------.....5----            ",
        "       -...........................-            ",
        "       -...........................-            ",
        "       -........................=..-            ",
        "       5---------------------------5            "
      ],
      "palettes": [ "lodge_2ndfloor_palette" ],
      "place_items": [
        { "item": "SUS_trash_roof", "x": [ 35, 37 ], "y": [ 8, 9 ], "chance": 50, "repeat": [ 1, 3 ] },
        { "item": "SUS_trash_roof", "x": [ 24, 37 ], "y": [ 10, 15 ], "chance": 50, "repeat": [ 1, 3 ] },
        { "item": "SUS_trash_roof", "x": [ 26, 30 ], "y": [ 16, 19 ], "chance": 50, "repeat": [ 1, 3 ] },
        { "item": "SUS_trash_roof", "x": [ 8, 23 ], "y": [ 20, 22 ], "chance": 50, "repeat": [ 1, 3 ] },
        { "item": "SUS_trash_roof", "x": [ 24, 34 ], "y": [ 20, 22 ], "chance": 50, "repeat": [ 1, 3 ] }
      ],
      "place_monsters": [ { "monster": "GROUP_VAMPIRES_MIXED", "x": [ 0, 23 ], "y": [ 0, 23 ], "density": 0.5 } ],
      "place_nested": [
        {
          "chunks": [
            [ "null", 150 ],
            [ "roof_2x2_golf", 25 ],
            [ "roof_3x3_wine", 25 ],
            [ "roof_4x4_party", 25 ],
            [ "roof_4x4_survivor", 25 ]
          ],
          "x": [ 24, 34 ],
          "y": [ 10, 12 ]
        }
      ]
    }
  },
  {
    "type": "mapgen",
    "method": "json",
    "om_terrain": [ [ "lodgev_roof1", "lodgev_roof2" ] ],
    "object": {
      "fill_ter": "t_flat_roof",
      "rows": [
        "  5-------------------------------------5       ",
        "  -.....................................-       ",
        "  -.............................~~~.....-       ",
        "  -.............................~~~.....-       ",
        "  -V............................~~~.....-       ",
        "  -.....................................-       ",
        "  -.....................................-       ",
        "  5-----------------------------------5--       ",
        "                                                ",
        "                                                ",
        "                                                ",
        "                                                ",
        "                                                ",
        "                                                ",
        "                                                ",
        "                                                ",
        "                                                ",
        "                                                ",
        "                                                ",
        "                                                ",
        "                                                ",
        "                                                ",
        "                                                ",
        "                                                "
      ],
      "palettes": [ "roof_palette" ],
      "furniture": { "V": "f_wind_vane" },
      "place_items": [
        { "item": "SUS_trash_roof", "x": [ 3, 23 ], "y": [ 1, 6 ], "chance": 20, "repeat": [ 1, 3 ] },
        { "item": "SUS_trash_roof", "x": [ 24, 39 ], "y": [ 1, 6 ], "chance": 20, "repeat": [ 1, 3 ] }
      ]
    }
  },
  {
    "type": "mapgen",
    "method": "json",
    "om_terrain": [ [ "lodgev_basement_residential1", "lodgev_basement_residential2" ] ],
    "object": {
      "fill_ter": "t_soil",
      "rows": [
        " ########################################       ",
        " #_//________//____//______//____//_____#       ",
        " #___//______//______//____//______//___#       ",
        " #___//________//____//______//____//___#       ",
        " #_____//______//______//____//______//_#       ",
        " #_____//________//____//______//____//_#       ",
        " #_______//______//______//____//______/#       ",
        " ####################################_###       ",
        "                                    #_#         ",
        "                         ############_#         ",
        "                         #__________BB#         ",
        "                         #____________#         ",
        "                         #____________#         ",
        "                         #____________#         ",
        "                         #____________#         ",
        "                         #____________#         ",
        "                         ###______#####         ",
        "                         #<#______#             ",
        "                         #_+______#             ",
        "                         ##########             ",
        "                                                ",
        "                                                ",
        "                                                ",
        "                                                "
      ],
      "palettes": [ "standard_domestic_basement_palette" ],
      "terrain": { "/": "t_carpet_yellow", "_": "t_carpet_green", "R": "t_carpet_green" },
      "place_monsters": [ { "monster": "GROUP_STRIGOI", "x": 7, "y": 4 } ],
      "place_nested": [
        { "chunks": [ [ "lodge_game_6x6", 80 ], [ "lodge_dungeon_6x6", 20 ], [ "lodge_drug_6x6", 50 ] ], "x": 2, "y": 1 },
        {
          "chunks": [ [ "5x5_corpse_pile_W", 30 ], [ "5x5_messy_nest_W", 10 ], [ "5x5_vamp_nest_W", 60 ] ],
          "x": 24,
          "y": 1
        },
        {
          "chunks": [ [ "room_6x6_woodworker", 5 ], [ "room_6x6_bike", 15 ], [ "room_6x6_office_E", 5 ] ],
          "x": 26,
          "y": 10
        }
      ]
    }
  }
]
