[
  {
    "type": "mapgen",
    "method": "json",
    "om_terrain": [ "cave_underground" ],
    "weight": 800,
    "object": {
      "fill_ter": "t_dirt_underground",
      "rotation": [ 0, 3 ],
      "rows": [
        "........................",
        "..........         .....",
        "...    ... .......  ....",
        "... ..  ..  ..   ..  ...",
        "... ...  ..       ..  ..",
        "... ....  ...  M   .. ..",
        "...  ....  ..      .. ..",
        "....  ....  ..    ..  ..",
        ".....  ....  ......  ...",
        "......  ....        ....",
        ".......  ...............",
        ".......           ......",
        "....     ........  .....",
        ".... .............  ....",
        ".... ..............  ...",
        "..    .............. ...",
        ".. ..  ............. ...",
        ".. ...        ...... ...",
        ".. ..........  ....  ...",
        "..  ..........      ....",
        "...  ........  .........",
        "....          ..........",
        "............ ...........",
        "............>..........."
      ],
      "terrain": { ".": "t_soil", " ": "t_dirt_underground", ">": "t_slope_up" },
      "furniture": {  },
      "monster": { "M": { "monster": "mon_fona" }, " ": { "monster": "mon_fona", "chance": 2 } },
      "place_item": [
        { "item": "egg_fona", "x": 10, "y": 10, "amount": [ 3, 15 ] },
        { "item": "egg_fona", "x": 14, "y": 9, "amount": [ 3, 15 ] },
        { "item": "egg_fona", "x": 10, "y": 12, "amount": [ 3, 15 ] },
        { "item": "egg_fona", "x": 15, "y": 12, "amount": [ 3, 15 ] },
        { "item": "egg_fona", "x": 12, "y": 13, "amount": [ 3, 15 ] },
        { "item": "feather", "x": [ 0, 23 ], "y": [ 0, 23 ], "amount": [ 10, 20 ], "repeat": [ 1, 24 ], "chance": 20 },
        {
          "item": "straw_pile",
          "x": [ 0, 23 ],
          "y": [ 0, 23 ],
          "amount": [ 10, 20 ],
          "repeat": [ 1, 24 ],
          "chance": 20
        }
      ],
      "place_items": [ { "item": "SUS_trash_forest_no_manmade", "x": [ 4, 17 ], "y": [ 6, 15 ], "repeat": [ 1, 3 ], "chance": 40 } ]
    }
  },
  {
    "type": "mapgen",
    "method": "json",
    "om_terrain": [ "cave_underground" ],
    "weight": 800,
    "object": {
      "fill_ter": "t_dirt_underground",
      "rotation": [ 0, 3 ],
      "rows": [
        "........................",
        "..........         .....",
        "...    ... .......  ....",
        "... ..  ..  ..   ..  ...",
        "... ...  ..       ..  ..",
        "... ....  ...  M   .. ..",
        "...  ....  ..      .. ..",
        "....  ....  ..    ..  ..",
        ".....  ....  ......  ...",
        "......  ....        ....",
        ".......  ...............",
        ".......           ......",
        "....     ........  .....",
        ".... .............  ....",
        ".... ..............  ...",
        "..    .............. ...",
        ".. ..  ............. ...",
        ".. ...        ...... ...",
        ".. ..........  ....  ...",
        "..  ..........      ....",
        "...  ........  .........",
        "....          ..........",
        "............ ...........",
        "............>..........."
      ],
      "terrain": { ".": "t_soil", " ": "t_dirt_underground", ">": "t_slope_up" },
      "furniture": {  },
      "monster": { "M": { "monster": "mon_oryctodromeus" }, " ": { "monster": "mon_oryctodromeus", "chance": 2 } },
      "place_item": [
        { "item": "egg_oryctodromeus", "x": 10, "y": 10, "amount": [ 3, 15 ] },
        { "item": "egg_oryctodromeus", "x": 14, "y": 9, "amount": [ 3, 15 ] },
        { "item": "egg_oryctodromeus", "x": 10, "y": 12, "amount": [ 3, 15 ] },
        { "item": "egg_oryctodromeus", "x": 15, "y": 12, "amount": [ 3, 15 ] },
        { "item": "egg_oryctodromeus", "x": 12, "y": 13, "amount": [ 3, 15 ] },
        { "item": "feather", "x": [ 0, 23 ], "y": [ 0, 23 ], "amount": [ 10, 20 ], "repeat": [ 1, 24 ], "chance": 20 },
        {
          "item": "straw_pile",
          "x": [ 0, 23 ],
          "y": [ 0, 23 ],
          "amount": [ 10, 20 ],
          "repeat": [ 1, 24 ],
          "chance": 20
        }
      ],
      "place_items": [ { "item": "SUS_trash_forest_no_manmade", "x": [ 4, 17 ], "y": [ 6, 15 ], "repeat": [ 1, 3 ], "chance": 40 } ]
    }
  },
  {
    "type": "mapgen",
    "method": "json",
    "om_terrain": [ "cave_underground" ],
    "weight": 800,
    "object": {
      "fill_ter": "t_dirt_underground",
      "rotation": [ 0, 3 ],
      "rows": [
        "........................",
        "..........         .....",
        "...    ... .......  ....",
        "... ..  ..  ..   ..  ...",
        "... ...  ..       ..  ..",
        "... ....  ...  M   .. ..",
        "...  ....  ..      .. ..",
        "....  ....  ..    ..  ..",
        ".....  ....  ......  ...",
        "......  ....        ....",
        ".......  ...............",
        ".......           ......",
        "....     ........  .....",
        ".... .............  ....",
        ".... ..............  ...",
        "..    .............. ...",
        ".. ..  ............. ...",
        ".. ...        ...... ...",
        ".. ..........  ....  ...",
        "..  ..........      ....",
        "...  ........  .........",
        "....          ..........",
        "............ ...........",
        "............>..........."
      ],
      "terrain": { ".": "t_soil", " ": "t_dirt_underground", ">": "t_slope_up" },
      "furniture": {  },
      "monster": { "M": { "monster": "mon_leptoceratops" }, " ": { "monster": "mon_leptoceratops", "chance": 2 } },
      "place_item": [
        { "item": "egg_leptoceratops", "x": 10, "y": 10, "amount": [ 3, 15 ] },
        { "item": "egg_leptoceratops", "x": 14, "y": 9, "amount": [ 3, 15 ] },
        { "item": "egg_leptoceratops", "x": 10, "y": 12, "amount": [ 3, 15 ] },
        { "item": "egg_leptoceratops", "x": 15, "y": 12, "amount": [ 3, 15 ] },
        { "item": "egg_leptoceratops", "x": 12, "y": 13, "amount": [ 3, 15 ] },
        { "item": "feather", "x": [ 0, 23 ], "y": [ 0, 23 ], "amount": [ 10, 20 ], "repeat": [ 1, 24 ], "chance": 20 },
        {
          "item": "straw_pile",
          "x": [ 0, 23 ],
          "y": [ 0, 23 ],
          "amount": [ 10, 20 ],
          "repeat": [ 1, 24 ],
          "chance": 20
        }
      ],
      "place_items": [ { "item": "SUS_trash_forest_no_manmade", "x": [ 4, 17 ], "y": [ 6, 15 ], "repeat": [ 1, 3 ], "chance": 40 } ]
    }
  }
]
