[
  {
    "type": "mapgen",
    "method": "json",
    "om_terrain": [
      [ "steel_mill_0_1_3", "steel_mill_0_2_3", "steel_mill_0_3_3", "steel_mill_0_4_3" ],
      [ "steel_mill_1_1_3", "steel_mill_1_2_3", "steel_mill_1_3_3", "steel_mill_1_4_3" ],
      [ "steel_mill_2_1_3", "steel_mill_2_2_3", "steel_mill_2_3_3", "steel_mill_2_4_3" ],
      [ "steel_mill_3_1_3", "steel_mill_3_2_3", "steel_mill_3_3_3", "steel_mill_rail_1_3" ],
      [ "steel_mill_4_1_3", "steel_mill_4_2_3", "steel_mill_4_3_3", "steel_mill_rail_2_3" ]
    ],
    "object": {
      "fill_ter": "t_thconc_floor",
      "rows": [
        "::::::::::::::::::::::::::::::::::::::::::::::::::::::::::::::::::::::::::::::::::::::::::::::::",
        "::::::::::::::::::::::::::::::::::::::::::::::::::::::::::::::::::::::::::::::::::::::::::::::::",
        "::::::::::::::::::::::::::::::::::::::::::::::::::::::::::::::::::::::::::::::::::::::::::::::::",
        ":::::rrrrrrrrrrrrrrrrrrrrrrrrrrrr:::::::::::::::::::::::::::::::::::::::::::::::::::::::::::::::",
        ":::::rrrrrrrrrrrrrrrrrrrrrrrrrrrr:::::::::::::::::::::::::::::::::::::::::::::::::::::::::::::::",
        ":::::rrrrrrrrrrrrrrrrrrrrrrrrrrrr:::::::::::::::::::::::::::::::::::::::::::::::::::::::::::::::",
        ":::::rrrrrrrrrrrrrrrrrrrrrrrrrrrr:::::::::::::::::::::::::::::::::::::::::::::::::::::::::::::::",
        ":::::rrrrrrrrrrrrrrrrrrrrrrrrrrrr:::::::::::::::::::::::::::::::::::::::::::::::::::::::::::::::",
        ":::::rrrrrrrrrrrrrrrrrrrrrrrrrrrr:::::::::::::::::::::::::::::::::::::::::::::::::::::::::::::::",
        ":::::rrrrrrrrrrrrrrrrrrrrrrrrrrrr:::::::::::::::::::::::::::::::::::::::::::::::::::::::::::::::",
        ":::::rrrrrrrrrrrrrrrrrrrrrrrrrrrr:::::::::::::::::::::::::::::::::::::::::::::::::::::::::::::::",
        ":::::rrrrrrrrrrrrrrrrrrrrrrrrrrrr:::::::::::::::::::::::::::::::::::::::::::::::::::::::::::::::",
        ":::::rrrrrrrrrrrrrrrrrrrrrrrrrrrr:::::::::::::::::::::::::::::::::::::::::::::::::::::::::::::::",
        ":::::rrrrrrrrrrrrrrrrrrrrrrrrrrrr:::::::::::::::::::::::::::::::::::::::::::::::::::::::::::::::",
        ":::::rrrrrrrrrrrrrrrrrrrrrrrrrrrr:::::::::::::::::::::::::::::::::::::::::::::::::::::::::::::::",
        ":::::rrrrrrrrrrrrrrrrrrrrrrrrrrrr:::::::::::::::::::::::::::::::::::::::::::::::::::::::::::::::",
        ":::::rrrrrrrrrrrrrrrrrrrrrrrrrrrr:::::::::::::::::::::::::::::::::::::::::::::::::::::::::::::::",
        ":::::rrrrrrrrrrrrrrrrrrrrrrrrrrrr:::::::::::::::::::::::::::::::::::::::::::::::::::::::::::::::",
        ":::::rrrrrrrrrrrrrrrrrrrrrrrrrrrr:::::::::::::::::::::::::::::::::::::::::::::::::::::::::::::::",
        ":::::rrrrrrrrrrrrrrrrrrrrrrrrrrrr:::::::::::::::::::::::::::::::::::::::::::::::::::::::::::::::",
        "::::::::::::::::::::::::::::::::::::::::::::::::::::::::::::::::::::::::::::::::::::::::::::::::",
        "::::::::::::::::::::::::::::::::::::::::::::::::::::::::::::::::::::::::::::::::::::::::::::::::",
        ":::::rrrrrrrrrrrrrrr::::::::::::::::::::::::::::::::::::::::::::::::::::::::::::::::::::::::::::",
        ":::::rrrrrrrrrrrr>rr::::::::::::::::::::::::::::::::::::::::::::::::::::::::::::::::::::::::::::",
        ":::::rrrrrrrrrrrrrrr::::::::::::::::::::::::::::::::::::::::::::::::::::::::::::::::::::::::::::",
        ":::::rrrrrrrrrrrrrrr::::::::::::::::::::::::::::::::::::::::::::::::::::::::::::::::::::::::::::",
        ":::::rrrrrrrrrrrrrrr::::::::::::::::::::::::::::::::::::::::::::::::::::::::::::::::::::::::::::",
        ":::::rrrrrrrrrrrrrrrrrrrrrrrrr::::::::::::::::::::::::::::::::::::::::::::::::::::::::::::::::::",
        ":::::rrrrrrrrrrrrrrrrrrrrrrrrr::::::::::::::::::::::::::::::::::::::::::::::::::::::::::::::::::",
        ":::::rrrrrrrrrrrrrrrrrrrrrrrrr::::::::::::::::::::::::::::::::::::::::::::::::::::::::::::::::::",
        ":::::rrrrrrrrrrrrrrrrrrrrrrrrr::::::::::::::::::::::::::::::::::::::::::::::::::::::::::::::::::",
        ":::::rrrrrrrrrrrrrrrrrrrrrrrrr::::::::::::::::::::::::::::::::::::::::::::::::::::::::::::::::::",
        ":::::rrrrrrrrrrrrrrrrrrrrrrrrr::::::::::::::::::::::::::::::::::::::::::::::::::::::::::::::::::",
        ":::::rrrrrrrrrrrrrrrrrrrrrrrrr::::::::::::::::::::::::::::::::::::::::::::::::::::::::::::::::::",
        ":::::rrrrrrrrrrrrrrrrrrrrrrrrr::::::::::::::::::::::::::::::::::::::::::::::::::::::::::::::::::",
        ":::::rrrrrrrrrrrrrrrrrrrrrrrrr::::::::::::::::::::::::::::::::::::::::::::::::::::::::::::::::::",
        ":::::rrrrrrrrrrrrrrrrrrrrrrrrr::::::::::::::::::::::::::::::::::::::::::::::::::::::::::::::::::",
        ":::::rrrrrrrrrrrrrrrrrrrrrrrrr::::::::::::::::::::::::::::::::::::::::::::::::::::::::::::::::::",
        ":::::rrrrrrrrrrrrrrrrrrrrrrrrr::::::::::::::::::::::::::::::::::::::::::::::::::::::::::::::::::",
        ":::::rrrrrrrrrrrrrrrrrrrrrrrrr::::::::::::::::::::::::::::::::::::::::::::::::::::::::::::::::::",
        ":::::rrrrrrrrrrrrrrrrrrrrrrrrr::::::::::::::::::::::::::::::::::::::::::::::::::::::::::::::::::",
        ":::::rrrrrrrrrrrrrrrrrrrrrrrrr::::::::::::::::::::::::::::::::::::::::::::::::::::::::::::::::::",
        ":::::rrrrrrrrrrrrrrrrrrrrrrrrr::::::::::::::::::::::::::::::::::::::::::::::::::::::::::::::::::",
        ":::::rrrrrrrrrrrrrrrrrrrrrrrrr::::::::::::::::::::::::::::::::::::::::::::::::::::::::::::::::::",
        ":::::rrrrrrrrrrrrrrrrrrrrrrrrr::::::::::::::::::::::::::::::::::::::::::::::::::::::::::::::::::",
        ":::::rrrrrrrrrrrrrrrrrrrrrrrrr::::::::::::::::::::::::::::::::::::::::::::::::::::::::::::::::::",
        ":::::rrrrrrrrrrrrrrrrrrrrrrrrr::::::::::::::::::::::::::::::::::::::::::::::::::::::::::::::::::",
        ":::::rrrrrrrrrrrrrrrrrrrrrrrrr::::::::::::::::::::::::::::::::::::::::::::::::::::::::::::::::::",
        ":::::rrrrrrrrrrrrrrrrrrrrrrrrr::::::::::::::::::::::::::::::::::::::::::::::::::::::::::::::::::",
        ":::::rrrrrrrrrrrrrrrrrrrrrrrrr::::::::::::::::::::::::::::::::::::::::::::::::::::::::::::::::::",
        ":::::rrrrrrrrrrrrrrrrrrrrrrrrrrrr:::::::::::::::::::::::::::::::::::::::::::::::::::::::::::::::",
        ":::::rrrrrrrrrrrrrrrrrrrrrrrrrrrr:::::::::::::::::::::::::::::::::::::::::::::::::::::::::::::::",
        ":::::rrrrrrrrrrrrrrrrrrrrrrrrrrrr:::::::::::::::::::::::::::::::::::::::::::::::::::::::::::::::",
        ":::::rrrrrrrrrrrrrrrrrrrrrrrrrrrr:::::::::::::::::::::::::::::::::::::::::::::::::::::::::::::::",
        ":::::rrrrrrrrrrrrrrrrrrrrrrrrrrrr:::::::::::::::::::::::::::::::::::::::::::::::::::::::::::::::",
        ":::::rrrrrrrrrrrrrrrrrrrrrrrrrrrr:::::::::::::::::::::::::::::::::::::::::::::::::::::::::::::::",
        ":::::rrrrrrrrrrrrrrrrrrrrrrrrrrrr:::::::::::::::::::::::::::::::::::::::::::::::::::::::::::::::",
        ":::::rrrrrrrrrrrrrrrrrrrrrrrrrrrr:::::::::::::::::::::::::::::::::::::::::::::::::::::::::::::::",
        ":::::rrrrrrrrrrrrrrrrrrrrrrrrrrrr:::::::::::::::::::::::::::::::::::::::::::::::::::::::::::::::",
        ":::::rrrrrrrrrrrrrrrrrrrrrrrrrrrr:::::::::::::::::::::::::::::::::::::::::::::::::::::::::::::::",
        ":::::rrrrrrrrrrrrrrrrrrrrrrrrrrrr:::::::::::::::::::::::::::::::::::::::::::::::::::::::::::::::",
        ":::::rrrrrrrrrrrrrrrrrrrrrrrrrrrr:::::::::::::::::::::::::::::::::::::::::::::::::::::::::::::::",
        ":::::rrrrrrrrrrrrrrrrrrrrrrrrrrrr:::::::::::::::::::::::::::::::::::::::::::::::::::::::::::::::",
        ":::::rrrrrrrrrrrrrrrrrrrrrrrrrrrr:::::::::::::::::::::::::::::::::::::::::::::::::::::::::::::::",
        ":::::rrrrrrrrrrrrrrrrrrrrrrrrrrrr::::::::::::::::::::::::::::rrrrrrrrrr:::::::::::::::::::::::::",
        ":::::rrrrrrrrrrrrrrrrrrrrrrrrrrrr::::::::::::::::::::::::::::rrrrrrrrrr:::::::::::::::::::::::::",
        ":::::rrrrrrrrrrrrrrrrrrrrrrrrrrrr::::::::::::::::::::::::::::rrrrrrrrrr:::::::::::::::::::::::::",
        ":::::rrrrrrrrrrrrrrrrrrrrrrrrrrrr::::::::::::::::::::::::::::rrrrrrrrrr:::::::::::::::::::::::::",
        ":::::rrrrrrrrrrrrrrrrrrrrrrrrrrrr::::::::::::::::::::::::::::rrrrrrrrrr:::::::::::::::::::::::::",
        ":::::rrrrrrrrrrrrrrrrrrrrrrrrrrrr::::::::::::::::::::::::::::rrrrrrrrrr:::::::::::::::::::::::::",
        ":::::rrrrrrrrrrrrrrrrrrrrrrrrrrrr:::::::::::::::::::::::::::::::::::::::::::::::::::::::::::::::",
        ":::::rrrrrrrrrrrrrrrrrrrrrrrrrrrr:::::::::::::::::::::::::::::::::::::::::::::::::::::::::::::::",
        ":::::rrrrrrrrrrrrrrrrrrrrrrrrrrrr:::::::::::::::::::::::::::::::::::::::::::::::::::::::::::::::",
        ":::::rrrrrrrrrrrrrrrrrrrrrrrrrrrr:::::::::::::::::::::::::::::::::::::::::::::::::::::::::::::::",
        ":::::rrrrrrrrrrrrrrrrrrrrrrrrrrrr:::::::::::::::::::::::::::::::::::::::::::::::::::::::::::::::",
        ":::::rrrrrrrrrrrrrrrrrrrrrrrrrrrr:::::::::::::::::::::::::::::::::::::::::::::::::::::::::::::::",
        ":::::rrrrrrrrrrrrrrrrrrrrrrrrrrrr:::::::::::::::::::::::::::::::::::::::::::::::::::::::::::::::",
        ":::::rrrrrrrrrrrrrrrrrrrrrrrrrrrr:::::::::::::::::::::::::::::::::::::::::::::::::::::::::::::::",
        ":::::::::rrrrrrrrrrrrrrrrrrrrrrrr:::::::::::::::::::::::::::::::::::::::::::::::::::::::::::::::",
        ":::::::::rrrrrrrrrrrrrrrrrrrrrrrr:::::::::::::::::::::::::::::::::::::::::::::::::::::::::::::::",
        ":::::::::rrrrrrrrrrrrrrrrrrrrrrrr:::::::::::::::::::::::::::::::::::::::::::::::::::::::::::::::",
        ":::::::::rrrrrrrrrrrrrrrrrrrrrrrr:::::::::::::::::::::::::::::::::::::::::::::::::::::::::::::::",
        "::::::::::::::::::::::::::::::::::::::::::::::::::::::::::::::::::::::::::::::::::::::::::::::::",
        "::::::::::::::::::::::::::::::::::::::::::::::::::::::::::::::::::::::::::::::::::::::::::::::::",
        "::::::::::::::::::::::::::::::::::::::::::::::::::::::::::::::::::::::::::::::::::::::::::::::::",
        "::::::::::::::::::::::::::::::::::::::::::::::::::::::::::::::::::::::::::::::::::::::::::::::::",
        "::::::::::::::::::::::::::::::::::::::::::::::::::::::::::::::::::::::::::::::::::::::::::::::::",
        "::::::::::::::::::::::::::::::::::::::::::::::::::::::::::::::::::::::::::::::::::::::::::::::::",
        "::::::::::::::::::::::::::::::::::::::::::::::::::::::::::::::::::::::::::::::::::::::::::::::::",
        "::::::::::::::::::::::::::::::::::::::::::::::::::::::::::::::::::::::::::::::::::::::::::::::::",
        "::::::::::::::::::::::::::::::::::::::::::::::::::::::::::::::::::::::::::::::::::::::::::::::::",
        "::::::::::::::::::::::::::::::::::::::::::::::::::::::::::::::::::::::::::::::::::::::::::::::::",
        "::::::::::::::::::::::::::::::::::::::::::::::::::::::::::::::::::::::::::::::::::::::::::::::::",
        "::::::::::::::::::::::::::::::::::::::::::::::::::::::::::::::::::::::::::::::::::::::::::::::::",
        "::::::::::::::::::::::::::::::::::::::::::::::::::::::::::::::::::::::::::::::::::::::::::::::::",
        "::::::::::::::::::::::::::::::::::::::::::::::::::::::::::::::::::::::::::::::::::::::::::::::::",
        "::::::::::::::::::::::::::::::::::::::::::::::::::::::::::::::::::::::::::::::::::::::::::::::::",
        "::::::::::::::::::::::::::::::::::::::::::::::::::::::::::::::::::::::::::::::::::::::::::::::::",
        ":::::::::::::::::::::::::rrrrrrrrrrrrrrrrrrrrrrrr:::::::::::::::::::::::::::::::::::::::::::::::",
        ":::::::::::::::::::::::::rrrrrrrrrrrrrrrrrrrrrrrr:::::::::::::::::::::::::::::::::::::::::::::::",
        ":::::::::::::::::::::::::rrrrrrrrrrrrrrrrrrrrrrrr:::::::::::::::::::::::::::::::::::::::::::::::",
        ":::::::::::::::::::::::::rrrrrrrrrrrrrrrrrrrrrrrr:::::::::::::::::::::::::::::::::::::::::::::::",
        ":::::::::::::::::::::::::rrrrrrrrrrrrrrrrrrrrrrrr:::::::::::::::::::::::::::::::::::::::::::::::",
        ":::::::::::::::::::::::::rrrrrrrrrrrrrrrrrrrrrrrr:::::::::::::::::::::::::::::::::::::::::::::::",
        ":::::::::::::::::::::::::rrrrrrrrrrrrrrrrrrrrrrrr:::::::::::::::::::::::::::::::::::::::::::::::",
        ":::::::::::::::::::::::::rrrrrrrrrrrrrrrrrrrrrrrr:::::::::::::::::::::::::::::::::::::::::::::::",
        ":::::::::::::::::::::::::rrrrrrrrrrrrrrrrrrrrrrrr:::::::::::::::::::::::::::::::::::::::::::::::",
        ":::::::::::::::::::::::::rrrrrrrrrrrrrrrrrrrrrrrr:::::::::::::::::::::::::::::::::::::::::::::::",
        ":::::::::::::::::::::::::rrrrrrrrrrrrrrrrrrrrrrrr:::::::::::::::::::::::::::::::::::::::::::::::",
        ":::::::::::::::::::::::::rrrrrrrrrrrrrrrrrrrrrrrr:::::::::::::::::::::::::::::::::::::::::::::::",
        ":::::::::::::::::::::::::rrrrrrrrrrrrrrrrrrrrrrrr:::::::::::::::::::::::::::::::::::::::::::::::",
        "::::::::::::::::::::::::::::::::::::::::::::::::::::::::::::::::::::::::::::::::::::::::::::::::",
        "::::::::::::::::::::::::::::::::::::::::::::::::::::::::::::::::::::::::::::::::::::::::::::::::",
        "::::::::::::::::::::::::::::::::::::::::::::::::::::::::::::::::::::::::::::::::::::::::::::::::",
        "::::::::::::::::::::::::::::::::::::::::::::::::::::::::::::::::::::::::::::::::::::::::::::::::",
        "::::::::::::::::::::::::::::::::::::::::::::::::::::::::::::::::::::::::::::::::::::::::::::::::",
        "::::::::::::::::::::::::::::::::::::::::::::::::::::::::::::::::::::::::::::::::::::::::::::::::",
        "::::::::::::::::::::::::::::::::::::::::::::::::::::::::::::::::::::::::::::::::::::::::::::::::",
        "::::::::::::::::::::::::::::::::::::::::::::::::::::::::::::::::::::::::::::::::::::::::::::::::",
        "::::::::::::::::::::::::::::::::::::::::::::::::::::::::::::::::::::::::::::::::::::::::::::::::"
      ],
      "terrain": {  },
      "furniture": {  },
      "palettes": [ "steel_mill_palette" ]
    }
  }
]
