[
  {
    "type": "mapgen",
    "method": "json",
    "om_terrain": [ "mil_base_tunnels_a" ],
    "weight": 250,
    "object": {
      "fill_ter": "t_thconc_floor",
      "rows": [
        "@@@@@@@@@@@@@@@@@@@@@@@@",
        "@@@@@@@@@@@@@@@@@@@@@@@@",
        "@@@@@@@@@@@@@@@@@@@@@@@@",
        "@@@@@@@@@@@@@@@@@@@@@@@@",
        "@@@@@@@@@@@@@@@@@@@@@@@@",
        "@@@@@@@@@@@@@@@@@@@@@@@@",
        "@@@@@@@@@@@@@@@@@@@@@@@@",
        "@@@@@@@@@@@@@@@@@@@@@@@@",
        "@@@@@@@@@@@@@@@@@@@@@@@@",
        "@@@@@@@@@@@@@@@@@@@@@@@@",
        "@@@@@@@@@@@@@@@@@@@@@@@@",
        "@@@@@@@@@@@@@@@@@@@@@@@@",
        "@@@@@@@@@@@@@@@@@@@@@@@@",
        "@@@@@@@@@@@@@@@@@@@@@@@@",
        "@@@@@@@@@@@@@@@@@@@@@@@@",
        "@@@@@@@@@@@@@@@@@@@@@@@@",
        "@@@@@/////@@@@@@@@@@@@@@",
        "@@@@@/<../@@@@@@@@@@@@@@",
        "@@@@@//../@@@@@@@@@@@@@@",
        "@@@@@@/../@@@@@@@@@@@@@@",
        "@@@@@@/../@@@@@@@@@@@@@@",
        "@@@@@@/../@@@@@@@@@@@@@@",
        "@@@@@@/../@@@@@@@@@@@@@@",
        "@@@@@@/../@@@@@@@@@@@@@@"
      ],
      "palettes": [ "mil_base_palette" ]
    }
  },
  {
    "type": "mapgen",
    "method": "json",
    "om_terrain": [ "mil_base_tunnels_b" ],
    "weight": 250,
    "object": {
      "fill_ter": "t_thconc_floor",
      "rows": [
        "@@@@@@/../@@@@@@@@@@@@@@",
        "@@@@@@/../@@@@@@@@@@@@@@",
        "@@@@@@/../@@@@@@@@@@@@@@",
        "@@@@@@/../@@@@@@@@@@@@@@",
        "@@@@@@/../@@@@@@@@@@@@@@",
        "@@@@@@/../@@@@@@@@@@@@@@",
        "@@@@@@/../@@@@@@@@@@@@@@",
        "@@@@@@/../@@@@@@@@@@@@@@",
        "@@@@@@/../@@@@@@@@@@@@@@",
        "@@@@@@/../@@@@@@@@@@@@@@",
        "@@@@@@/../@@@@@@@@@@@@@@",
        "@@@@@@/../@@@@@@@@@@@@@@",
        "@@@@@@/../@@@@@@@@@@@@@@",
        "@@@@@@/../@@@@@@@@@@@@@@",
        "@@@@@@/../@@@@@@@@@@@@@@",
        "@@@@@@/../@@@@@@@@@@@@@@",
        "@@@@@@/../@@@@@@@@@@@@@@",
        "@@@@@@/../@@@@@@@@@@@@@@",
        "@@@@@@/../@@@@@@@@@@@@@@",
        "@@@@@@/../@@@@@@@@@@@@@@",
        "@@@@@@/../@@@@@@@@@@@@@@",
        "@@@@@@/../@@@@@@@@@@@@@@",
        "@@@@@@/../@@@@@@@@@@@@@@",
        "@@@@@@/../@@@@@@@@@@@@@@"
      ],
      "palettes": [ "mil_base_palette" ]
    }
  },
  {
    "type": "mapgen",
    "method": "json",
    "om_terrain": [ "mil_base_tunnels_c" ],
    "weight": 250,
    "object": {
      "fill_ter": "t_thconc_floor",
      "rows": [
        "@@@@@@/../@@@@@@@@@@@@@@",
        "///////../@@@@@@@@@@@@@@",
        "........./@@@@@@@@@@@@@@",
        "........./@@@@@@@@@@@@@@",
        "///////../@@@@@@@@@@@@@@",
        "///@@@/../@@@@@@@@@@@@@@",
        "/</@@@/../@@@@@@@@@@@@@@",
        "/./////../@@@@@@@@@@@@@@",
        ".....e/../@@@@@@@@@@@@@@",
        "......D../@@@@@@@@@@@@@@",
        "///////../@@@@@@@@@@@@@@",
        "/////@/../@@@@@@@@@@@@@@",
        "l.#t/@/../@@@@@@@@@@@@@@",
        "..#h/@/../@@@@@@@@@@@@@@",
        "..#./@/../@@@@@@@@@@@@@@",
        "..../@/../@@@@@@@@@@@@@@",
        ".$$$/@/../@@@@@@@@@@@@@@",
        "/////@/../@@@@@@@@@@@@@@",
        "OOOO/@/../@@@@@@@@@@@@@@",
        "..ht/@/../@@@@@@@@@@@@@@",
        ".###/@/../@@@@@@@@@@@@@@",
        "..../@/../@@@@@@@@@@@@@@",
        "Y.$$/@/../@@@@@@@@@@@@@@",
        "/////@/../@@@@@@@@@@@@@@"
      ],
      "palettes": [ "mil_base_palette" ]
    }
  },
  {
    "type": "mapgen",
    "method": "json",
    "om_terrain": [ "mil_base_tunnels_d" ],
    "weight": 250,
    "object": {
      "fill_ter": "t_thconc_floor",
      "rows": [
        "@//////../@@@@@@@@@@@@@@",
        "@/<.D..../@@@@@@@@@@@@@@",
        "@////e.../@@@@@@@@@@@@@@",
        "@@@@//////@@@@@@@@@@@@@@",
        "@@@@@@@@@@@@@@@@@@@@@@@@",
        "@@@@@@@@@@@@@@@@@@@@@@@@",
        "@@@@@@@@@@@@@@@@@@@@@@@@",
        "@@@@@@@@@@@@@@@@@@@@@@@@",
        "@@@@@@@@@@@@@@@@@@@@@@@@",
        "@@@@@@@@@@@@@@@@@@@@@@@@",
        "@@@@@@@@@@@@@@@@@@@@@@@@",
        "@@@@@@@@@@@@@@@@@@@@@@@@",
        "@@@@@@@@@@@@@@@@@@@@@@@@",
        "@@@@@@@@@@@@@@@@@@@@@@@@",
        "@@@@@@@@@@@@@@@@@@@@@@@@",
        "@@@@@@@@@@@@@@@@@@@@@@@@",
        "@@@@@@@@@@@@@@@@@@@@@@@@",
        "@@@@@@@@@@@@@@@@@@@@@@@@",
        "@@@@@@@@@@@@@@@@@@@@@@@@",
        "@@@@@@@@@@@@@@@@@@@@@@@@",
        "@@@@@@@@@@@@@@@@@@@@@@@@",
        "@@@@@@@@@@@@@@@@@@@@@@@@",
        "@@@@@@@@@@@@@@@@@@@@@@@@",
        "@@@@@@@@@@@@@@@@@@@@@@@@"
      ],
      "palettes": [ "mil_base_palette" ]
    }
  },
  {
    "type": "mapgen",
    "method": "json",
    "om_terrain": [ "mil_base_tunnels_e" ],
    "weight": 250,
    "object": {
      "fill_ter": "t_thconc_floor",
      "rows": [
        "@@@@@@@@@@@@@@@@@@@@@@@@",
        "////////////////////////",
        "........................",
        "........................",
        "////////////////////////",
        "@@@@@@@@@@@@@@@@@@@@@@@@",
        "@@@@@@@@@@@@@@@@@@@@@@@@",
        "@@@@@@@@@@@@@///////////",
        "@@@@@@@@@@@@@/[l........",
        "@@@@@@@@@@@@@/[$C.......",
        "@@@@@@@@@@@@@/##////////",
        "@/////////////ll////////",
        "@/$..Y/......$l$h....../",
        "@/$.../................/",
        "@/$.#.=../////../////..=",
        "@/$h#./../$$$....$$$/../",
        "@/$t#./../........../../",
        "@//////../[........[/../",
        "@/t#.l/../[.hhhhhh.[/../",
        "@/h#../../[.''''''.[/../",
        "@/.#..=../........../..=",
        "@/..../..+..hhhhhh..+../",
        "@/$$$O/..+..''''''..+../",
        "///////../..........////"
      ],
      "palettes": [ "mil_base_palette" ]
    }
  },
  {
    "type": "mapgen",
    "method": "json",
    "om_terrain": [ "mil_base_tunnels_f" ],
    "weight": 250,
    "object": {
      "fill_ter": "t_thconc_floor",
      "rows": [
        "/OAAAY/../[.hhhhhh.[/@@@",
        "/.....+../[.''''''.[/@@@",
        "/l..../../[........[/@@@",
        "/l.[[[/../........../@@@",
        "/...../../.'..[[..'./@@@",
        "/OAAAO/../h'..[[..'h/@@@",
        "///////../$'..[[..'$/@@@",
        "/T/T/T/../$........$/@@@",
        "/+/+/+/..//........//@@@",
        "/.....+..//''''''''/@@@@",
        "/ScScS//////////////@@@@",
        "///////@@@@@@@@@@@@@@@@@",
        "@@@@@@@@@@@@@@@@@@@@@@@@",
        "@@@@@@@@@@@@@@@@@@@@@@@@",
        "@@@@@@@@@@@@@@@@@@@@@@@@",
        "@@@@@@@@@@@@@@@@@@@@@@@@",
        "@@@@@@@@@@@@@@@@@@@@@@@@",
        "@@@@@@@@@@@@@@@@@@@@@@@@",
        "@@@@@@@@@@@@@@@@@@@@@@@@",
        "@@@@@@@@@@@@@@@@@@@@@@@@",
        "@@@@@@@@@@@@@@@@@@@@@@@@",
        "@@@@@@@@@@@@@@@@@@@@@@@@",
        "@@@@@@@@@@@@@@@@@@@@@@@@",
        "@@@@@@@@@@@@@@@@@@@@@@@@"
      ],
      "palettes": [ "mil_base_palette" ]
    }
  },
  {
    "type": "mapgen",
    "method": "json",
    "om_terrain": [ "mil_base_tunnels_g" ],
    "weight": 250,
    "object": {
      "fill_ter": "t_thconc_floor",
      "rows": [
        "@@@@@@@@@@@@@@@@@@@@@@@@",
        "////////////////////////",
        "........................",
        "........................",
        "////////////////////////",
        "@@@@@@@@@@@@@@@@@@@@@@@@",
        "@@@@@@@@@@@@@@@@@@@@@@@@",
        "@@@@@@@@@@@@@@@@@@@@@@@@",
        "@@@@@@@@@@@@@@@@@@@@@@@@",
        "@@@@@@@@@@@@@@@@@@@@@@@@",
        "@@@@@@@@@@@@@@@@@@@@@@@@",
        "@@@@@@@@@@@@@@@@@@@@@@@@",
        "@@@@@@@@@@@@@@@@@@@@@@@@",
        "@@@@@@@@@@@@@@@@@@@@@@@@",
        "@@@@@@@@@@@@@@@@@@@@@@@@",
        "@@@@@@@@@@@@@@@@@@@@@@@@",
        "@@@@@@@@@@@@@@@@@@@@@@@@",
        "@@@@@@@@@@@@@@@@@@@@@@@@",
        "@@@@@@@@@@@@@@@@@@@@@@@@",
        "@@@@@@@@@@@@@@@@@@@@@@@@",
        "@@@@@@@@@@@@@@@@@@@@@@@@",
        "@@@@@@@@@@@@@@@@@@@@@@@@",
        "@@@@@@@@@@@@@@@@@@@@@@@@",
        "@@@@@@@@@@@@@@@@@@@@@@@@"
      ],
      "palettes": [ "mil_base_palette" ]
    }
  },
  {
    "type": "mapgen",
    "method": "json",
    "om_terrain": [ "mil_base_tunnels_h" ],
    "weight": 250,
    "object": {
      "fill_ter": "t_thconc_floor",
      "rows": [
        "@@@@@@@@@@@@@@@@///@@@@@",
        "@@@@@@@@@@@@@@@@/<//////",
        "@@@@@@@@@@@@@@@@/.......",
        "@@@@@@@@@@@@@@@@/.......",
        "@@@@@@@@@@@@@@@@////////",
        "@@@@@@@@@@@@@@@@@@@@@@@@",
        "@@@@@@@@@@@@@@@@@@@@@@@@",
        "@@@@@@@@@@@@@@@@@@@@@@@@",
        "@@@@@@@@@@@@@@@@@@@@@@@@",
        "@@@@@@@@@@@@@@@@@@@@@@@@",
        "@@@@@@@@@@@@@@@@@@@@@@@@",
        "@@@@@@@@@@@@@@@@@@@@@@@@",
        "@@@@@@@@@@@@@@@@@@@@@@@@",
        "@@@@@@@@@@@@@@@@@@@@@@@@",
        "@@@@@@@@@@@@@@@@@@@@@@@@",
        "@@@@@@@@@@@@@@@@@@@@@@@@",
        "@@@@@@@@@@@@@@@@@@@@@@@@",
        "@@@@@@@@@@@@@@@@@@@@@@@@",
        "@@@@@@@@@@@@@@@@@@@@@@@@",
        "@@@@@@@@@@@@@@@@@@@@@@@@",
        "@@@@@@@@@@@@@@@@@@@@@@@@",
        "@@@@@@@@@@@@@@@@@@@@@@@@",
        "@@@@@@@@@@@@@@@@@@@@@@@@",
        "@@@@@@@@@@@@@@@@@@@@@@@@"
      ],
      "palettes": [ "mil_base_palette" ]
    }
  }
]
