[
  {
    "type": "mapgen",
    "method": "json",
    "om_terrain": [ "mil_base_3i4" ],
    "weight": 250,
    "object": {
      "fill_ter": "t_metal_floor_no_roof",
      "rows": [
        "                        ",
        "                        ",
        "                        ",
        "                        ",
        "                        ",
        "                        ",
        "                        ",
        "                        ",
        "                        ",
        "                        ",
        "                        ",
        "                        ",
        "                        ",
        "    aaaaaa              ",
        "    a,,,,a              ",
        "    a,RR,a              ",
        "    a,RR,a              ",
        "    av,,,a              ",
        "    aaaaaa              ",
        "                        ",
        "                        ",
        "                        ",
        "                        ",
        "                        "
      ],
      "palettes": [ "roof_palette" ],
      "terrain": { "R": "t_radio_tower", "a": "t_railing", ",": "t_metal_floor_no_roof" }
    }
  }
]
