[
  {
    "type": "mapgen",
    "method": "json",
    "om_terrain": [ "military_base_wall_straight" ],
    "weight": 400,
    "object": {
      "fill_ter": "t_region_groundcover",
      "rows": [
        "...........//.-.'.......",
        "...........//.-.'.......",
        "...........//.-.'.......",
        "...........//.-.'.......",
        "...........//.-.'.......",
        "...........//.-.'.......",
        "...........//.-.'.......",
        "...........//.-.'.......",
        "...........//.-.'.......",
        "...........//.-.'.......",
        "...........//.-.'.......",
        "...........//.-.'.......",
        "...........//.-.'.......",
        "...........//.-.'.......",
        "...........//.-.'.......",
        "...........//.-.'.......",
        "...........//.-.'.......",
        "...........//.-.'.......",
        "...........//.-.'.......",
        "...........//.-.'.......",
        "...........//.-.'.......",
        "...........//.-.'.......",
        "...........//.-.'.......",
        "...........//.-.'......."
      ],
      "palettes": [ "mil_base_palette2" ],
      "monster": { ".": { "group": "GROUP_MIL_BASE_CIVILIAN", "chance": 1 } }
    }
  },
  {
    "type": "mapgen",
    "method": "json",
    "om_terrain": [ "military_base_wall_tee_left" ],
    "weight": 400,
    "object": {
      "fill_ter": "t_region_groundcover",
      "rows": [
        "...........//.-.........",
        "...........//.-.........",
        "...........//.-.........",
        "...........//.-.........",
        "...........//.-.........",
        "...........//.-.........",
        "...........//.-.........",
        "...........//.-.........",
        "...........//.-.........",
        "...........//.-.........",
        "...........//.-.........",
        "//////////////-/////////",
        "//////////////-/////////",
        "..............-.........",
        "------------------------",
        "........................",
        "''''''''''''''''''''''''",
        "........................",
        "........................",
        "........................",
        "........................",
        "........................",
        "........................",
        "........................"
      ],
      "palettes": [ "mil_base_palette2" ],
      "monster": { ".": { "group": "GROUP_MIL_BASE_CIVILIAN", "chance": 1 } }
    }
  },
  {
    "type": "mapgen",
    "method": "json",
    "om_terrain": [ "military_base_wall_tee_right" ],
    "weight": 400,
    "object": {
      "fill_ter": "t_region_groundcover",
      "rows": [
        ".........-.//...........",
        ".........-.//...........",
        ".........-.//...........",
        ".........-.//...........",
        ".........-.//...........",
        ".........-.//...........",
        ".........-.//...........",
        ".........-.//...........",
        ".........-.//...........",
        ".........-.//...........",
        ".........-.//...........",
        "/////////-//////////////",
        "/////////-//////////////",
        ".........-..............",
        "------------------------",
        "........................",
        "''''''''''''''''''''''''",
        "........................",
        "........................",
        "........................",
        "........................",
        "........................",
        "........................",
        "........................"
      ],
      "palettes": [ "mil_base_palette2" ],
      "monster": { ".": { "group": "GROUP_MIL_BASE_CIVILIAN", "chance": 1 } }
    }
  },
  {
    "type": "mapgen",
    "method": "json",
    "om_terrain": [ "military_base_wall_corner_no_tower" ],
    "weight": 400,
    "object": {
      "fill_ter": "t_region_groundcover",
      "rows": [
        "........................",
        "........................",
        "........................",
        "........................",
        "........................",
        "........................",
        "........................",
        "........................",
        "........................",
        "........................",
        "........................",
        ".........../////////////",
        ".........../////////////",
        "...........//...........",
        "...........//.----------",
        "...........//.-.........",
        "...........//.-.''''''''",
        "...........//.-.'.......",
        "...........//.-.'.......",
        "...........//.-.'.......",
        "...........//.-.'.......",
        "...........//.-.'.......",
        "...........//.-.'.......",
        "...........//.-.'......."
      ],
      "palettes": [ "mil_base_palette2" ],
      "monster": { ".": { "group": "GROUP_MIL_BASE_CIVILIAN", "chance": 1 } }
    }
  },
  {
    "type": "mapgen",
    "method": "json",
    "om_terrain": [ "military_base_wall_corner" ],
    "weight": 400,
    "object": {
      "fill_ter": "t_region_groundcover",
      "rows": [
        "........................",
        "........................",
        "........................",
        "........................",
        "........................",
        "........................",
        "........................",
        "........................",
        "........................",
        "........................",
        "........................",
        ".........../////////////",
        ".........../////////////",
        "...........//#####......",
        "...........//#<,,#------",
        "...........//#,,,#......",
        "...........//#,,,£''''''",
        "...........//#####'.....",
        "...........//.-.'''.....",
        "...........//.-.'.......",
        "...........//.-.'.......",
        "...........//.-.'.......",
        "...........//.-.'.......",
        "...........//.-.'......."
      ],
      "palettes": [ "mil_base_palette2" ],
      "monster": { ".": { "group": "GROUP_MIL_BASE_CIVILIAN", "chance": 1 } }
    }
  },
  {
    "type": "mapgen",
    "method": "json",
    "om_terrain": [ "military_base_wall_corner_z1" ],
    "weight": 400,
    "object": {
      "fill_ter": "t_region_groundcover",
      "rows": [
        "........................",
        "........................",
        "........................",
        "........................",
        "........................",
        "........................",
        "........................",
        "........................",
        "........................",
        "........................",
        "........................",
        "........................",
        "........................",
        ".............#####......",
        ".............#>,,#......",
        ".............#,,,#......",
        ".............#<,,#......",
        ".............#####......",
        "........................",
        "........................",
        "........................",
        "........................",
        "........................",
        "........................"
      ],
      "palettes": [ "mil_base_palette2" ],
      "terrain": { ".": "t_open_air" },
      "monster": { ",": { "group": "GROUP_MIL_BASE", "chance": 20 } }
    }
  },
  {
    "type": "mapgen",
    "method": "json",
    "om_terrain": [ "military_base_wall_corner_z2" ],
    "weight": 400,
    "object": {
      "fill_ter": "t_thconc_floor",
      "rows": [
        "........................",
        "........................",
        "........................",
        "........................",
        "........................",
        "........................",
        "........................",
        "........................",
        "........................",
        "........................",
        "........................",
        "........................",
        "........................",
        ".............#OOO#......",
        ".............O>,,O......",
        ".............O,,6O......",
        ".............O,hvO......",
        ".............#OOO#......",
        "........................",
        "........................",
        "........................",
        "........................",
        "........................",
        "........................"
      ],
      "palettes": [ "mil_base_palette2" ],
      "terrain": { ".": "t_open_air" },
      "monster": { ",": { "group": "GROUP_MIL_BASE", "chance": 20 } }
    }
  },
  {
    "type": "mapgen",
    "method": "json",
    "om_terrain": [ "military_base_wall_corner_z3" ],
    "weight": 400,
    "object": {
      "fill_ter": "t_region_groundcover",
      "rows": [
        "                        ",
        "                        ",
        "                        ",
        "                        ",
        "                        ",
        "                        ",
        "                        ",
        "                        ",
        "                        ",
        "                        ",
        "                        ",
        "                        ",
        "                        ",
        "             -----      ",
        "             -...-      ",
        "             -...-      ",
        "             -...-      ",
        "             -----      ",
        "                        ",
        "                        ",
        "                        ",
        "                        ",
        "                        ",
        "                        "
      ],
      "palettes": [ "roof_palette" ]
    }
  }
]
