[
  {
    "type": "mapgen",
    "method": "json",
    "om_terrain": [ "mil_base_3i4" ],
    "weight": 250,
    "object": {
      "fill_ter": "t_open_air",
      "rows": [
        "                        ",
        "                        ",
        "                        ",
        "                        ",
        "                        ",
        "                        ",
        "                        ",
        "                        ",
        "                        ",
        "                        ",
        "                        ",
        "                        ",
        "                        ",
        "    ######              ",
        "    #Zx'Z#              ",
        "    #x''x#              ",
        "    #'>''#              ",
        "    #Zx'Z#              ",
        "    ######              ",
        "                        ",
        "                        ",
        "                        ",
        "                        ",
        "                        "
      ],
      "palettes": [ "mil_base_roof_palette" ]
    }
  }
]
