[
  {
    "type": "mapgen",
    "om_terrain": [ "labyrinth_entrance" ],
    "object": {
      "fill_ter": "t_nl_metal_floor",
      "rows": [
        "vvvvvvvvv3     vvvvvvvvv",
        "vvvvvvvvv      vvvvvvvvv",
        "vvvvvvvvv      vvvvvvvvv",
        "vvvvvvvvv      vvvvvvvvv",
        "vvvvvvvvv      vvvvvvvvv",
        "vvvvvvvvv      vvvvvvvvv",
        "vvvvvv..vv....vv..vvvvvv",
        "vvvvvv.Lvv....vvL.vvvvvv",
        "vvvvvvvvvv(..(vvvvvvvvvv",
        "2     vvv||++||vvv2     ",
        "      ..(|Ç..(|(..      ",
        "      ...+....+...      ",
        "      ...+.A..+...      ",
        "      ..(|(..L|(..      ",
        "      vvv||++||vvv      ",
        "vvvvvvvvvv(..(vvvvvvvvvv",
        "vvvvvv.Lvv....vvL.vvvvvv",
        "vvvvvv..vv....vv..vvvvvv",
        "vvvvvvvvv3     vvvvvvvvv",
        "vvvvvvvvv      vvvvvvvvv",
        "vvvvvvvvv      vvvvvvvvv",
        "vvvvvvvvv      vvvvvvvvv",
        "vvvvvvvvv      vvvvvvvvv",
        "vvvvvvvvv      vvvvvvvvv"
      ],
      "palettes": [ "labyrinthine_base_palette" ],
      "nested": {
        "1": { "chunks": [ "ls_12x12hall4way_basic" ] },
        "2": { "chunks": [ "ls_ew_6x6hall_basic" ] },
        "3": { "chunks": [ "ls_ns_6x6hall_basic" ] }
      },
      "computers": { "Ç": { "name": "Exit Controls", "eocs": [ "EOC_LS_Computer" ], "chat_topics": [ "COMP_LS_Exit_Controls" ] } }
    }
  },
  {
    "type": "mapgen",
    "om_terrain": [ [ "labyrinth_sparkgen_UL", "labyrinth_sparkgen_UR" ], [ "labyrinth_sparkgen_LL", "labyrinth_sparkgen_LR" ] ],
    "object": {
      "fill_ter": "t_nl_metal_floor",
      "rows": [
        "vvvvvvvvvvvvvvvvvvvvvvvv |||||||||||||||||||||||v",
        "vvvvvvvvvvvvvvvvvvvvvvvv ...........+...........|",
        "vvvvv(..vvvvvvvvvvvvvvvv vvvvv..vvv.|...........|",
        "vvvvL................... vvvvv..vvv.||..........|",
        "vvvL.................... vvvvv..vvv..||.........|",
        "vv(..................... vvvvv..vvv...||||......|",
        "vv...................... vvvvv..vvv.v....||.....|",
        "vv.....||||||||||||||||| vvvvv..vv..vvvv..||....|",
        "vvv....|................ vvvvv..v..vvvvvv..|....|",
        "vvv....|................ vv|||..v.vvvvvvvv.||...|",
        "vvv....|............vvvv ..|||..v.vvvvvvvv..||..|",
        "vvv....|........vvvvvvvv ..|||.....|||vvvvv..||+|",
        "vvv....|......vvvvvvvvvv ..........|||vvvv......|",
        "vvv....|.....vvvvvvvvvvv ..........|||vvv..vvvv.|",
        "vvv....|....vvvvvvvvvvvv .||||||......vv..vvvvv.|",
        "vvv....|....vvvvvvvvvvvv .|A...||........vvvvvv.|",
        "vvv....|...vvvvvvvvvvvvv .|1....||....vvvvvvvvv.|",
        "vvv....|...vvvvvvvvvvvvv .|......||.............|",
        "vvv....|...vvvvvvvvvvvvv .|.......|.............|",
        "vvv....|...vvvvvvvvvvvvv .||......+..|||vvvvvvv.|",
        "vvv....|..vvvvvvvvvvvvvv ..||.....+..|||vvvvvvv.|",
        "vvv....|..vvvvvvvvvvvvvv ...||....|..|||vvvvvvv.|",
        "vvv....|..vvvvvvvvvvvvvv ....||||||....vvvvvvvv.|",
        "vvv....|||vvvvvvvvvvvvvv ..............vvvvvvvv.|",
								  
        "vvv....|||vvvvvvvvvvvvvv ..............vvvvvvvvvv",
        "vvv....|..vvvvvvvvvvvvvv ....||||||..vvvvvvvvvvvv",
        "vvv....|..vvvvvvvvvvvvvv ...||....|..vvvvvvvvvvvv",
        "vvv....|..vvvvvvvvvvvvvv ..||.....|..vvvvvvvvvvvv",
        "vvv....|...vvvvvvvvvvvvv .||......|..vvvvvvvvvvvv",
        "vvv....|...vvvvvvvvvvvvv .|.......|..vvvvvvvvvvvv",
        "vvv....|...vvvvvvvvvvvvv .|......||..vvvvvvvvvvvv",
        "vvv....|...vvvvvvvvvvvvv .|.....||..vvvvvvvvvvvvv",
        "vvv....|....vvvvvvvvvvvv .|....||..vvvvvvvvvvvvvv",
        "vvv....|....vvvvvvvvvvvv .||||||..vvvvvvvvvvvvvvv",
        "vvv....|.....vvvvvvvvvvv ........vvvvvvvvvvvvvvvv",
        "vvv....|......vvvvvvvvvv .......vvvvvvvvvvvvvvvvv",
        "vvv....|........vvvvvvvv .vvvvvvvvvvvvvvvvvvvvvvv",
        "vvv....|............vvvv .vvvvvvvvvvvvvvvvvvvvvvv",
        "vvv....|................ vvvvvvvvvvvvvvvvvvvvvvvv",
        "vvv....|................ vvvvvvvvvvvvvvvvvvvvvvvv",
        "vv.....||||||||||||||||| vvvvvvvvvvvvvvvvvvvvvvvv",
        "vv...................... vvvvvvvvvvvvvvvvvvvvvvvv",
        "vv(..................... vvvvvvvvvvvvvvvvvvvvvvvv",
        "vvvL.................... vvvvvvvvvvvvvvvvvvvvvvvv",
        "vvvvL................... vvvvvvvvvvvvvvvvvvvvvvvv",
        "vvvvv(..vvvvvvvvvvvvvvvv vvvvvvvvvvvvvvvvvvvvvvvv",
        "vvvvvvvvvvvvvvvvvvvvvvvv vvvvvvvvvvvvvvvvvvvvvvvv",
        "vvvvvvvvvvvvvvvvvvvvvvvv vvvvvvvvvvvvvvvvvvvvvvvv"
      ],
      "palettes": [ "labyrinthine_base_palette" ],
      "monster": {
        "1": "mon_LS_sparkgenerator",
        "2": "mon_LS"
      }
    }
  }
]
