[
  {
    "type": "mapgen",
    "om_terrain": [ "labyrinth_flooded_entrance" ],
    "object": {
      "fill_ter": "t_nl_bridge",
      "rows": [
        "vvvvvvvvv      vvvvvvvvv",
        "vvvvvvvvv      vvvvvvvvv",
        "vvvvvvvvv      vvvvvvvvv",
        "vvvvvvvvv      vvvvvvvvv",
        "vvvvvvvvv      vvvvvvvvv",
        "vvvvvvvvv      vvvvvvvvv",
        "vvvvvv..vv....vv..vvvvvv",
        "vvvvvv.Lvv....vvL.vvvvvv",
        "vvvvvvvvvv(..(vvvvvvvvvv",
        "      vvv||++||vvv      ",
        "      ..(|@..(|(..      ",
        "      ...+....+...      ",
        "      ...+.A..+...      ",
        "      ..(|(..L|(..      ",
        "      vvv||++||vvv      ",
        "vvvvvvvvvv(..(vvvvvvvvvv",
        "vvvvvv.Lvv....vvL.vvvvvv",
        "vvvvvv..vv....vv..vvvvvv",
        "vvvvvvvvv      vvvvvvvvv",
        "vvvvvvvvv      vvvvvvvvv",
        "vvvvvvvvv      vvvvvvvvv",
        "vvvvvvvvv      vvvvvvvvv",
        "vvvvvvvvv      vvvvvvvvv",
        "vvvvvvvvv      vvvvvvvvv"
      ],
      "palettes": [ "labyrinthine_flooded_palette" ],
      "terrain": { "@": "t_nl_obelisk_mission_water_cooler" }
    }
  },
  {
    "type": "mapgen",
    "om_terrain": "labyrinth_flooded_hall_straight",
    "object": {
      "fill_ter": "t_nl_bridge",
      "place_nested": [ { "chunks": [ "ls_straight_template_chasm_flooded" ], "x": 0, "y": 0 } ]
    }
  },
  {
    "type": "mapgen",
    "om_terrain": "labyrinth_flooded_hall_curved",
    "object": { "fill_ter": "t_nl_bridge", "place_nested": [ { "chunks": [ "ls_corner_template_chasm_flooded" ], "x": 0, "y": 0 } ] }
  },
  {
    "type": "mapgen",
    "om_terrain": "labyrinth_flooded_hall_tee",
    "object": { "fill_ter": "t_nl_bridge", "place_nested": [ { "chunks": [ "ls_tee_template_chasm_flooded" ], "x": 0, "y": 0 } ] }
  },
  {
    "type": "mapgen",
    "om_terrain": "labyrinth_flooded_hall_four_way",
    "object": { "fill_ter": "t_nl_bridge", "place_nested": [ { "chunks": [ "ls_4way_template_chasm_flooded" ], "x": 0, "y": 0 } ] }
  },
  {
    "type": "mapgen",
    "om_terrain": "labyrinth_flooded_hall_end",
    "object": { "fill_ter": "t_nl_bridge", "place_nested": [ { "chunks": [ "ls_deadend_template_chasm_flooded" ], "x": 0, "y": 0 } ] }
  },
  {
    "type": "mapgen",
    "nested_mapgen_id": "ls_straight_template_chasm_flooded",
    "//": "hallway in a chasm",
    "object": {
      "mapgensize": [ 24, 24 ],
      "rows": [
        "!vvvvvvvv?    ?vvvvvvvv!",
        "!vvvvvvvv?    ?vvvvvvvv!",
        "!vvvvvvvv?    ?vvvvvvvv!",
        "!vvvvvvvv?    ?vvvvvvvv!",
        "!vvvvvvvv?    ?vvvvvvvv!",
        "!vvvvvvvv?    ?vvvvvvvv!",
        "!vvvvvvvv?    ?vvvvvvvv!",
        "!vvvvvvvv?    ?vvvvvvvv!",
        "!vvvvvvvv?    ?vvvvvvvv!",
        "!vvvvvvvv?    ?vvvvvvvv!",
        "!vvvvvvvv?    ?vvvvvvvv!",
        "!vvvvvvvv?    ?vvvvvvvv!",
        "!vvvvvvvv?    ?vvvvvvvv!",
        "!vvvvvvvv?    ?vvvvvvvv!",
        "!vvvvvvvv?    ?vvvvvvvv!",
        "!vvvvvvvv?    ?vvvvvvvv!",
        "!vvvvvvvv?    ?vvvvvvvv!",
        "!vvvvvvvv?    ?vvvvvvvv!",
        "!vvvvvvvv?    ?vvvvvvvv!",
        "!vvvvvvvv?    ?vvvvvvvv!",
        "!vvvvvvvv?    ?vvvvvvvv!",
        "!vvvvvvvv?    ?vvvvvvvv!",
        "!vvvvvvvv?    ?vvvvvvvv!",
        "!vvvvvvvv?    ?vvvvvvvv!"
      ],
      "palettes": [ "labyrinthine_flooded_palette" ]
    }
  },
  {
    "type": "mapgen",
    "nested_mapgen_id": "ls_straight_template_chasm_flooded",
    "//": "split passage",
    "object": {
      "mapgensize": [ 24, 24 ],
      "rows": [
        "!v?                  ?v!",
        "!v?                  ?v!",
        "!v?                  ?v!",
        "!v?                  ?v!",
        "!v?                  ?v!",
        "!v?    ??????????    ?v!",
        "!v?    ?vvvvvvvv?    ?v!",
        "!v?    ?vvvvvvvv?    ?v!",
        "!v?    ?vvvvvvvv?    ?v!",
        "!v?    ?vvvvvvvv?    ?v!",
        "!v?    ?vvvvvvvv?    ?v!",
        "!v?    ?vvvvvvvv?    ?v!",
        "!v?    ?vvvvvvvv?    ?v!",
        "!v?    ?vvvvvvvv?    ?v!",
        "!v?    ?vvvvvvvv?    ?v!",
        "!v?    ?vvvvvvvv?    ?v!",
        "!v?    ?vvvvvvvv?    ?v!",
        "!v?    ?vvvvvvvv?    ?v!",
        "!v?    ??????????    ?v!",
        "!v?                  ?v!",
        "!v?                  ?v!",
        "!v?                  ?v!",
        "!v?                  ?v!",
        "!v?                  ?v!"
      ],
      "palettes": [ "labyrinthine_flooded_palette" ]
    }
  },
  {
    "type": "mapgen",
    "nested_mapgen_id": "ls_straight_template_chasm_flooded",
    "//": "wiggly passage",
    "object": {
      "mapgensize": [ 24, 24 ],
      "rows": [
        "!vvvvvvvvoo  oovvvvvvvv!",
        "!vvvvvvvoo  oovvvvvvvvv!",
        "!vvvvvvoo  o vvvvvvvvvv!",
        "!vvvvvvoo  oooovvvvvvvv!",
        "!vvvvvoo  oovoovvvvvvvv!",
        "!vvvvoo  oovvoovvvvvvvv!",
        "!vvvvoo  oovvoovvvvvvvv!",
        "!vvvoo  oovvvvoovvvvvvv!",
        "!vvvoo  oovvvoovvvvvvvv!",
        "!vvoo  oovvvvvoovvvvvvv!",
        "!vvoo  oovvvvvvoovvvvvv!",
        "!vvvoo  oovvvvvvoovvvvv!",
        "!vvvvoo  oovvvvvoovvvvv!",
        "!vvvvvoo  oovvvoovvvvvv!",
        "!vvvvvvoo  oovvoovvvvvv!",
        "!vvvvvvvoo  oooooovvvvv!",
        "!vvvvvvvvoo  o  ovvvvvv!",
        "!vvvvvvvvvoo  ooovvvvvv!",
        "!vvvvvvvvoo  oovvvvvvvv!",
        "!vvvvvvvoo  oovvvvvvvvv!",
        "!vvvvvvvoo  oovvvvvvvvv!",
        "!vvvvvvvvoo  oovvvvvvvv!",
        "!vvvvvvvvoo  oovvvvvvvv!",
        "!vvvvvvvvoo  oovvvvvvvv!"
      ],
      "palettes": [ "labyrinthine_flooded_palette" ]
    }
  },
  {
    "type": "mapgen",
    "nested_mapgen_id": "ls_straight_template_chasm_flooded",
    "//": "hallway in a chasm with possible half-formed juts",
    "object": {
      "mapgensize": [ 24, 24 ],
      "rows": [
        "!vvvvvvvv?    ?vvvvvvvv!",
        "!vvvvvvvv?    ?vvvvvvvv!",
        "!vvvvvvvv?    ?vvvvvvvv!",
        "!vvvvvvvv?    ?vvvvvvvv!",
        "!vvvvvvvv?    ?vvvvvvvv!",
        "!vvvvvvvv?    ?vvvvvvvv!",
        "!vvvvvvvv?    ?vvvvvvvv!",
        "!vvvvvvvv?    ?vvvvvvvv!",
        "!vvvvvvvv?    ?vvvvvvvv!",
        "!vvvvvvvv?    ?vvvvvvvv!",
        "!vvvvvvvv?    ?vvvvvvvv!",
        "!vvvvvvvv?    ?vvvvvvvv!",
        "!vvvvvvvv?    ?vvvvvvvv!",
        "!vvvvvvvv?    ?vvvvvvvv!",
        "!vvvvvvvv?    ?vvvvvvvv!",
        "!vvvvvvvv?    ?vvvvvvvv!",
        "!vvvvvvvv?    ?vvvvvvvv!",
        "!vvvvvvvv?    ?vvvvvvvv!",
        "!vvvvvvvv?    ?vvvvvvvv!",
        "!vvvvvvvv?    ?vvvvvvvv!",
        "!vvvvvvvv?    ?vvvvvvvv!",
        "!vvvvvvvv?    ?vvvvvvvv!",
        "!vvvvvvvv?    ?vvvvvvvv!",
        "!vvvvvvvv?    ?vvvvvvvv!"
      ],
      "palettes": [ "labyrinthine_flooded_palette" ]
    }
  },
  {
    "type": "mapgen",
    "nested_mapgen_id": "ls_corner_template_chasm_flooded",
    "object": {
      "mapgensize": [ 24, 24 ],
      "rows": [
        "!!!!!!!!!!!!!!!!!!!!!!!!",
        "!|||||vvvvvvvvvvvvvvvvvv",
        "!|||vvvvvvvvvvvvvvvvvvvv",
        "!||vvvvvvvvvvvvvvvvvvvvv",
        "!|vvvvvvvvvvvvvvvvvvvvvv",
        "!|vvvvvvvvvvvvvvvvvvvvvv",
        "!vvvvv????????????vvvvvv",
        "!vvvvv?          ?vvvvvv",
        "!vvvvv?          ?vvvvvv",
        "!vvvvv?          ???????",
        "!vvvvv?                 ",
        "!vvvvv?                 ",
        "!vvvvv?                 ",
        "!vvvvv?                 ",
        "!vvvvv?          ???????",
        "!vvvvv?          ?vvvvvv",
        "!vvvvv?          ?vvvvvv",
        "!vvvvv????    ????vvvvvv",
        "!vvvvvvvv?    ?vvvvvvvvv",
        "!vvvvvvvv?    ?vvvvvvvvv",
        "!vvvvvvvv?    ?vvvvvvvvv",
        "!vvvvvvvv?    ?vvvvvvvvv",
        "!vvvvvvvv?    ?vvvvvvvvv",
        "!vvvvvvvv?    ?vvvvvvvvv"
      ],
      "palettes": [ "labyrinthine_flooded_palette" ]
    }
  },
  {
    "type": "mapgen",
    "nested_mapgen_id": "ls_corner_template_chasm_flooded",
    "//": "Messy corner",
    "object": {
      "mapgensize": [ 24, 24 ],
      "rows": [
        "!!!!!!!!!!!!!!!!!!!!!!!!",
        "!|||||||vvvvvvvvvvvvvvvv",
        "!||||vvvvvvvvvvvvvvvvvvv",
        "!||vvvvvvvvvvvvvvvvvvvvv",
        "!||vvvvvvvvvvvvvvvvvvvvv",
        "!|vvvvvvvvooovvvvvvvvvvv",
        "!|vvvvvvooooooovvvvvvvvv",
        "!|vvvvvooovvvoooovvvvvvv",
        "!vvvvvvoovvvvvoooooovvvv",
        "!vvvvvoovvvvvvvvoooooovv",
        "!vvvvvoovvvvvvvvvooooooo",
        "!vvvvvvoovvvvvvooo  oooo",
        "!vvvvvvoovvvvooo        ",
        "!vvvvvoovvvvoo   oooo  o",
        "!vvvvvoovvvoo  oovvvoooo",
        "!vvvvvvoooo  ooovvvvvoov",
        "!vvvvvvoo  ooovvvvvvvvvv",
        "!vvvvvoo  oovvvvvvvvvvvv",
        "!vvvvvoo  oovvvvvvvvvvvv",
        "!vvvvvvoo  oovvvvvvvvvvv",
        "!vvvvvvooo  oovvvvvvvvvv",
        "!vvvvvvvvoo  oovvvvvvvvv",
        "!vvvvvvvoo   oovvvvvvvvv",
        "!vvvvvvvvoo  oovvvvvvvvv"
      ],
      "palettes": [ "labyrinthine_flooded_palette" ]
    }
  },
  {
    "type": "mapgen",
    "nested_mapgen_id": "ls_corner_template_chasm_flooded",
    "//": "Swingy corner, decent chance of a room in the middle",
    "object": {
      "mapgensize": [ 24, 24 ],
      "rows": [
        "!!!!!!!!!!!!!!!!!!!!!!!!",
        "!|||||vvvvvvvvvvvvvvvvvv",
        "!||vvvvvvvvv?????vvvvvvv",
        "!|vvvvvvvvv??   ??ovvvvv",
        "!|vvvvvvvv         ovvvv",
        "!|vvvvvvo           ovvv",
        "!vvvvvvv        ???  ovv",
        "!vvvvvo   ???????v??  ov",
        "!vvvvv   ??vvvvvvvv?   v",
        "!vvvv?   ?vvvvvvvvv?   ?",
        "!vvv??   ?vvvvvvvv??    ",
        "!vvv?    ?vvvvvvvv?     ",
        "!vvv?    ?vvvvvvvv?     ",
        "!vvv?    ?vvvvvvvv?     ",
        "!vvv???  ?vvvvvvvv??????",
        "!vvvvv??  vvvvvvvvvvvvvv",
        "!vvvvvv??   ovvvvvvvvvvv",
        "!vvvvvvv??   ovvvvvvvvvv",
        "!vvvvvvvv?    ?vvvvvvvvv",
        "!vvvvvvvv?    ?vvvvvvvvv",
        "!vvvvvvvv?    ?vvvvvvvvv",
        "!vvvvvvvv?    ?vvvvvvvvv",
        "!vvvvvvvv?    ?vvvvvvvvv",
        "!vvvvvvvv?    ?vvvvvvvvv"
      ],
      "palettes": [ "labyrinthine_flooded_palette" ]
    }
  },
  {
    "type": "mapgen",
    "nested_mapgen_id": "ls_tee_template_chasm_flooded",
    "object": {
      "mapgensize": [ 24, 24 ],
      "rows": [
        "!!!!!!!!!!!!!!!!!!!!!!!!",
        "vvvvvvvvvv||||vvvvvvvvvv",
        "vvvvvvvvvvv||vvvvvvvvvvv",
        "vvvvvvvvvvvvvvvvvvvvvvvv",
        "vvvvvvvvvvvvvvvvvvvvvvvv",
        "vvvvvvvvvvvvvvvvvvvvvvvv",
        "vvvvvv????????????vvvvvv",
        "vvvvvv?          ?vvvvvv",
        "vvvvvv?          ?vvvvvv",
        "???????          ???????",
        "                        ",
        "                        ",
        "                        ",
        "                        ",
        "???????          ???????",
        "vvvvvv?          ?vvvvvv",
        "vvvvvv?          ?vvvvvv",
        "vvvvvv????    ????vvvvvv",
        "vvvvvvvvv?    ?vvvvvvvvv",
        "vvvvvvvvv?    ?vvvvvvvvv",
        "vvvvvvvvv?    ?vvvvvvvvv",
        "vvvvvvvvv?    ?vvvvvvvvv",
        "vvvvvvvvv?    ?vvvvvvvvv",
        "vvvvvvvvv?    ?vvvvvvvvv"
      ],
      "palettes": [ "labyrinthine_flooded_palette" ]
    }
  },
  {
    "type": "mapgen",
    "nested_mapgen_id": "ls_4way_template_chasm_flooded",
    "object": {
      "mapgensize": [ 24, 24 ],
      "rows": [
        "vvvvvvvvv?    ?vvvvvvvvv",
        "vvvvvvvvv?    ?vvvvvvvvv",
        "vvvvvvvvv?    ?vvvvvvvvv",
        "vvvvvvvvv?    ?vvvvvvvvv",
        "vvvvvvvvv?    ?vvvvvvvvv",
        "vvvvvvvvv?    ?vvvvvvvvv",
        "vvvvvv????    ????vvvvvv",
        "vvvvvv?          ?vvvvvv",
        "vvvvvv?          ?vvvvvv",
        "???????          ???????",
        "                        ",
        "                        ",
        "                        ",
        "                        ",
        "???????          ???????",
        "vvvvvv?          ?vvvvvv",
        "vvvvvv?          ?vvvvvv",
        "vvvvvv????    ????vvvvvv",
        "vvvvvvvvv?    ?vvvvvvvvv",
        "vvvvvvvvv?    ?vvvvvvvvv",
        "vvvvvvvvv?    ?vvvvvvvvv",
        "vvvvvvvvv?    ?vvvvvvvvv",
        "vvvvvvvvv?    ?vvvvvvvvv",
        "vvvvvvvvv?    ?vvvvvvvvv"
      ],
      "palettes": [ "labyrinthine_flooded_palette" ]
    }
  },
  {
    "type": "mapgen",
    "nested_mapgen_id": "ls_deadend_template_chasm_flooded",
    "object": {
      "mapgensize": [ 24, 24 ],
      "rows": [
        "!vvvvvvvv?    ?vvvvvvvv!",
        "!vvvvvvvv?    ?vvvvvvvv!",
        "!vvvvvvvv?    ?vvvvvvvv!",
        "!vvvvvvvv?    ?vvvvvvvv!",
        "!vvvvvvvv?    ?vvvvvvvv!",
        "!vvvvvvvv??????vvvvvvvv!",
        "!vvvvvvvvvvvvvvvvvvvvvv!",
        "!vvvvvvvvvvvvvvvvvvvvvv!",
        "!vvvvvvvvvvvvvvvvvvvvvv!",
        "!vvvvvvvvvvvvvvvvvvvvvv!",
        "!vvvvvvvvvvvvvvvvvvvvvv!",
        "!vvvvvvvvvvvvvvvvvvvvvv!",
        "!vvvvvvvvvvvvvvvvvvvvvv!",
        "!vvvvvvvvvvvvvvvvvvvvvv!",
        "!vvvvvvvvvvvvvvvvvvvvvv!",
        "!vvvvvvvvvvvvvvvvvvvvvv!",
        "!vvvvvvvvvvvvvvvvvvvvvv!",
        "!vvvvvvvvvvvvvvvvvvvvvv!",
        "!vvvvvvvvvvvvvvvvvvvvvv!",
        "!vvvvvvvvvvvvvvvvvvvvvv!",
        "!|vvvvvvvvvvvvvvvvvvvv|!",
        "!||vvvvvvvvvvvvvvvvvv||!",
        "!|||vvvvvvvvvvvvvvvv|||!",
        "!!!!!!!!!!!!!!!!!!!!!!!!"
      ],
      "palettes": [ "labyrinthine_flooded_palette" ]
    }
  },
  {
    "type": "mapgen",
    "update_mapgen_id": "labyrinth_nl_flooded_water_cooler_location",
    "object": {
      "flags": [ "ERASE_ALL_BEFORE_PLACING_TERRAIN" ],
      "rows": [
        "vvvvvvvvv......vvvvvvvvv",
        "vvvvvvvvv......vvvvvvvvv",
        "vvvvvvvvv......vvvvvvvvv",
        "vvvvvvvvv......vvvvvvvvv",
        "vvvvvvvvv......vvvvvvvvv",
        "vvvvvvvvv......vvvvvvvvv",
        "vvvvvv..vv....vv..vvvvvv",
        "vvvvvv.Lvv....vvL.vvvvvv",
        "vvvvvvvvvv(..(vvvvvvvvvv",
        "......vvv||++||vvv......",
        "........(|....|(........",
        ".........+..@.+.........",
        ".........+.L..+.........",
        "........(|....|(........",
        "......vvv||++||vvv......",
        "vvvvvvvvvv(..(vvvvvvvvvv",
        "vvvvvv.Lvv....vvL.vvvvvv",
        "vvvvvv..vv....vv..vvvvvv",
        "vvvvvvvvv......vvvvvvvvv",
        "vvvvvvvvv......vvvvvvvvv",
        "vvvvvvvvv......vvvvvvvvv",
        "vvvvvvvvv......vvvvvvvvv",
        "vvvvvvvvv......vvvvvvvvv",
        "vvvvvvvvv......vvvvvvvvv"
      ],
      "palettes": [ "labyrinthine_flooded_palette" ],
      "terrain": { "@": "t_nl_mission_water_cooler", "(": "t_nl_bridge" }
    }
  }
]
