[
  {
    "type": "mapgen",
    "method": "json",
    "om_terrain": [
      [ "nursing_home_psi_lab1", "nursing_home_psi_lab2", "nursing_home_psi_lab3", "nursing_home_psi_lab4" ],
      [ "nursing_home_psi_lab5", "nursing_home_psi_lab6", "nursing_home_psi_lab7", "nursing_home_psi_lab8" ],
      [ "nursing_home_psi_lab9", "nursing_home_psi_lab10", "nursing_home_psi_lab11", "nursing_home_psi_lab12" ]
    ],
    "object": {
      "fill_ter": "t_thconc_floor",
      "rows": [
        "tttttttttttttttttttttttttttttttttttttttttttttttttttttttttttttttttttttttttttttttttttttttttttttttt",
        "tttttttttttttttttttttttttttttttttttttttttttttttttttttttttttttttttttttttttttttttttttttttttttttttt",
        "tttttttttttttttttttttttttttttttttttttttttttttttttttttttttttttttttttttttttttttttttttttttttttttttt",
        "tttttttttttttttttttttttttttttttttttttttttttttttttttttttttttttttttttttttttttttttttttttttttttttttt",
        "tttttttttttttttttttttttttttttttttttttttttttttttttttttttttttttttttttttttttttttttttttttttttttttttt",
        "tttttttttttttttttttttttttttttttttttttttttttttttttttttttttttttttttttttttttttttttttttttttttttttttt",
        "ttttttttttttttttttttttttttttttttttWWWWWWWWWWWWWWWWWWWWWWWWWWWttttttttttttttttttttttttttttttttttt",
        "ttttttttttttttttttttttttttttttttttWk&6W6&kWFccHcWcHccFWZZZZZWWWWWttttttttttttttttttttttttttttttt",
        "ttttttttttttttttttttttttttttttttttWfffWfffWccd~dWd-dccWZ...x.x..Wttttttttttttttttttttttttttttttt",
        "tttttttttttttttttttttttttttttttttWWDWWWWWDWcccccWcccccWZZZZZ^W..Wttttttttttttttttttttttttttttttt",
        "tttttttttttttttttttttttttttttttttWOff414ffWGGGGlWlGGGGWWWWWWWW..Wttttttttttttttttttttttttttttttt",
        "tttttttttttttttttttttttttttttttttWnff414ffW...........x.........Wttttttttttttttttttttttttttttttt",
        "tttttttttttttttttttttttttttttttttWaffffffflo....o....ox........oWttttttttttttttttttttttttttttttt",
        "tttttttttttttttttttttttttttttttttWrfffsssfW...........WWWWWWWWWWWttttttttttttttttttttttttttttttt",
        "ttttttttttttttttttttttttttttttttWWWWDWWWWWWWWWWxxWWWWWWWWWWWWWWWWttttttttttttttttttttttttttttttt",
        "ttttttttttttttttttttttttttttttttWbbWfWbbWo.......eeuuu.........oWttttttttttttttttttttttttttttttt",
        "ttttttttttttttttttttttttttttttttW5cDfDc5W.3=3..3....o....3y.3=3.Wttttttttttttttttttttttttttttttt",
        "ttttttttttttttttttttttttttttttttWWWWfWWWW.222..=...222...=..222.Wttttttttttttttttttttttttttttttt",
        "ttttttttttttttttttttttttttttttttWbbWfWbbW.323....3.222.3....323.Wttttttttttttttttttttttttttttttt",
        "ttttttttttttttttttttttttttttttttW5cDfDc5W........=.....=..w.....Wttttttttttttttttttttttttttttttt",
        "ttttttttttttttttttttttttttttttttWWWWWWWWW.......................Wttttttttttttttttttttttttttttttt",
        "ttttttttttttttttttttttttttttttttttttWEUUW..WGGWGGGGGWGGGGGWGGW..WWWWtttttttttttttttttttttttttttt",
        "ttttttttttttttttttttttttttttttttttttW...W..Gw.X...7.W.....X..G..W.gWtttttttttttttttttttttttttttt",
        "ttttttttttttttttttttttttttttttttttttWUU.X..G.VGBBB.%W%.BBBGV.G..x.gWtttttttttttttttttttttttttttt",
        "ttttttttttttttttttttttttttttttttttttWWWWW..x.7WWWWWWWWWWWWW7.x..W.gWtttttttttttttttttttttttttttt",
        "ttttttttttttttttttttttttttttttttttttttttW..G.hGBBB.%W%.BBBGh.G..WWWWWttttttttttttttttttttttttttt",
        "ttttttttttttttttttttttttttttttttttttttttW..G..X.....W7....X.8G..W.hqWttttttttttttttttttttttttttt",
        "ttttttttttttttttttttttttttttttttttttttttW..WGGWGGGGGWGGGGGWGGW..W.qVWttttttttttttttttttttttttttt",
        "ttttttttttttttttttttttttttttttttttttttttW...........o...........x...Wttttttttttttttttttttttttttt",
        "ttttttttttttttttttttttttttttttttttttttttW...=y..=22WxW22=...=...W.PQWttttttttttttttttttttttttttt",
        "ttttttttttttttttttttttttttttttttttttttttWo..3...3.3W.W3.3...3..oW.VQWttttttttttttttttttttttttttt",
        "ttttttttttttttttttttttttttttttttttttWWWWWWWWWWWWWWWWxWWWWWWWWWWWWWWWWttttttttttttttttttttttttttt",
        "ttttttttttttttttttttttttttttttttttttWo.........oeuu...uueo.........oWttttttttttttttttttttttttttt",
        "ttttttttttttttttttttttttttttttttttttW...q3.....................3q...Wttttttttttttttttttttttttttt",
        "ttttttttttttttttttttttttttttttttttttW...2=2......WGGGGW.......2=2...Wttttttttttttttttttttttttttt",
        "ttttttttttttttttttttttttttttttttttttW............Gh7V.G.............Wttttttttttttttttttttttttttt",
        "ttttttttttttttttttttttttttttttttttttW............G....x.............Wttttttttttttttttttttttttttt",
        "ttttttttttttttttttttttttttttttttttttW.......WGGGGWWWXWWWGGGGW.......Wttttttttttttttttttttttttttt",
        "ttttttttttttttttttttttttttttttttttttW.......G............w..G.......Wttttttttttttttttttttttttttt",
        "ttttttttttttttttttttttttttttttttttttWo..y...G....7BBBBB.....G...y..oWttttttttttttttttttttttttttt",
        "ttttttttttttttttttttttttttttttttttttW.......G%..........8...G.......Wttttttttttttttttttttttttttt",
        "ttttttttttttttttttttttttttttttttttttW..w....WGGGGGGGGGGGGGGGW.......Wttttttttttttttttttttttttttt",
        "ttttttttttttttttttttttttttttttttttttW...............................Wttttttttttttttttttttttttttt",
        "ttttttttttttttttttttttttttttttttttttW........2=2....o....2=2........Wttttttttttttttttttttttttttt",
        "ttttttttttttttttttttttttttttttttttttW.........3q..........3q........Wttttttttttttttttttttttttttt",
        "ttttttttttttttttttttttttttttttttttttWo.............................oWttttttttttttttttttttttttttt",
        "ttttttttttttttttttttttttttttttttttttWWWWWWWWWWWWWWWWxWWWWWWWWWWWWWWWWttttttttttttttttttttttttttt",
        "ttttttttttttttttttttttttttttttttttttttttttttttttWR.|.|.TWttttttttttttttttttttttttttttttttttttttt",
        "ttttttttttttttttttttttttttttttttttttttttttttttttWR.L.L.TWttttttttttttttttttttttttttttttttttttttt",
        "ttttttttttttttttttttttttttttttttttttttttttttttttWR.|o|.TWttttttttttttttttttttttttttttttttttttttt",
        "ttttttttttttttttttttttttttttttttttttttttttttttttWWWWWWWWWttttttttttttttttttttttttttttttttttttttt",
        "tttttttttttttttttttttttttttttttttttttttttttttttttttttttttttttttttttttttttttttttttttttttttttttttt",
        "tttttttttttttttttttttttttttttttttttttttttttttttttttttttttttttttttttttttttttttttttttttttttttttttt",
        "tttttttttttttttttttttttttttttttttttttttttttttttttttttttttttttttttttttttttttttttttttttttttttttttt",
        "tttttttttttttttttttttttttttttttttttttttttttttttttttttttttttttttttttttttttttttttttttttttttttttttt",
        "tttttttttttttttttttttttttttttttttttttttttttttttttttttttttttttttttttttttttttttttttttttttttttttttt",
        "tttttttttttttttttttttttttttttttttttttttttttttttttttttttttttttttttttttttttttttttttttttttttttttttt",
        "tttttttttttttttttttttttttttttttttttttttttttttttttttttttttttttttttttttttttttttttttttttttttttttttt",
        "tttttttttttttttttttttttttttttttttttttttttttttttttttttttttttttttttttttttttttttttttttttttttttttttt",
        "tttttttttttttttttttttttttttttttttttttttttttttttttttttttttttttttttttttttttttttttttttttttttttttttt",
        "tttttttttttttttttttttttttttttttttttttttttttttttttttttttttttttttttttttttttttttttttttttttttttttttt",
        "tttttttttttttttttttttttttttttttttttttttttttttttttttttttttttttttttttttttttttttttttttttttttttttttt",
        "tttttttttttttttttttttttttttttttttttttttttttttttttttttttttttttttttttttttttttttttttttttttttttttttt",
        "tttttttttttttttttttttttttttttttttttttttttttttttttttttttttttttttttttttttttttttttttttttttttttttttt",
        "tttttttttttttttttttttttttttttttttttttttttttttttttttttttttttttttttttttttttttttttttttttttttttttttt",
        "tttttttttttttttttttttttttttttttttttttttttttttttttttttttttttttttttttttttttttttttttttttttttttttttt",
        "tttttttttttttttttttttttttttttttttttttttttttttttttttttttttttttttttttttttttttttttttttttttttttttttt",
        "tttttttttttttttttttttttttttttttttttttttttttttttttttttttttttttttttttttttttttttttttttttttttttttttt",
        "tttttttttttttttttttttttttttttttttttttttttttttttttttttttttttttttttttttttttttttttttttttttttttttttt",
        "tttttttttttttttttttttttttttttttttttttttttttttttttttttttttttttttttttttttttttttttttttttttttttttttt",
        "tttttttttttttttttttttttttttttttttttttttttttttttttttttttttttttttttttttttttttttttttttttttttttttttt",
        "tttttttttttttttttttttttttttttttttttttttttttttttttttttttttttttttttttttttttttttttttttttttttttttttt"
      ],
      "palettes": [ "vitakinesis_lab_palette" ],
      "place_monster": [
        { "group": "GROUP_NURSING_HOME_LAB", "x": [ 40, 47 ], "y": [ 10, 13 ], "repeat": [ 3, 4 ] },
        { "group": "GROUP_NURSING_HOME_LAB", "x": [ 51, 63 ], "y": [ 15, 20 ], "repeat": [ 3, 4 ] },
        { "group": "GROUP_MUTANT_EVOLVED", "x": [ 58, 59 ], "y": [ 39, 40 ], "repeat": [ 2, 3 ] },
        { "monster": "mon_zombie_rot", "x": [ 48, 49 ], "y": [ 22, 23 ], "chance": 100 },
        { "monster": "mon_zombie_rot", "x": [ 48, 49 ], "y": [ 22, 23 ], "chance": 100 },
        { "monster": "mon_boomer", "x": [ 54, 55 ], "y": [ 22, 22 ], "chance": 100 },
        { "monster": "mon_zombie_rot", "x": [ 54, 55 ], "y": [ 22, 22 ], "chance": 100 }
      ],
      "items": {
        "7": { "item": "bed", "chance": 80 },
        "8": { "item": "bed", "chance": 80 },
        "b": { "item": "bed", "chance": 50 },
        "2": { "item": "tools_science", "chance": 20 },
        "k": { "item": "SUS_toilet", "chance": 100 },
        "n": { "item": "cleaning", "chance": 100 },
        "5": { "item": "allclothes", "chance": 80 },
        "r": { "item": "groce_premade", "chance": 80 },
        "F": { "item": "lab_files_generic", "chance": 100, "repeat": [ 3, 4 ] },
        "a": [
          { "item": "dinnerware", "chance": 40, "repeat": [ 0, 1 ] },
          { "item": "SUS_silverware", "chance": 40, "repeat": [ 0, 1 ] },
          { "item": "SUS_knife_drawer", "chance": 40, "repeat": [ 0, 1 ] },
          { "item": "home_hw", "chance": 40, "repeat": [ 0, 1 ] }
        ],
        "T": [
          { "item": "chem_lab", "chance": 75, "repeat": [ 0, 1 ] },
          { "item": "lab_glassware", "chance": 75, "repeat": [ 0, 1 ] }
        ],
        "R": [
          { "item": "lab_mutagen_ingredients_fridge", "chance": 100, "repeat": [ 0, 4 ] },
          { "item": "mut_lab", "chance": 100, "repeat": [ 0, 4 ] }
        ],
        "e": [
          { "item": "SUS_chemistry_bookcase", "chance": 50 },
          { "item": "lab_bookshelves", "chance": 50 },
          { "item": "common_mutation_books", "chance": 20 },
          { "item": "doctors_books", "chance": 60 }
        ],
        "E": [
          { "item": "SUS_chemistry_bookcase", "chance": 60, "repeat": [ 1, 2 ] },
          { "item": "lab_bookshelves", "chance": 60, "repeat": [ 1, 2 ] },
          { "item": "common_mutation_books", "chance": 60, "repeat": [ 1, 2 ] },
          { "item": "rare_mutation_books", "chance": 60, "repeat": [ 1, 2 ] },
          { "item": "doctors_books", "chance": 100 }
        ],
        "u": [
          { "item": "science", "chance": 40, "repeat": [ 0, 1 ] },
          { "item": "SUS_science_personal_effects", "chance": 10, "repeat": [ 0, 1 ] },
          { "item": "tools_science", "chance": 40, "repeat": [ 0, 1 ] },
          { "item": "tools_common", "chance": 40, "repeat": [ 0, 1 ] },
          { "item": "drugs_emergency", "chance": 40, "repeat": [ 0, 1 ] },
          { "item": "drugs_pharmacy", "chance": 40, "repeat": [ 0, 1 ] }
        ],
        "U": [
          { "item": "science", "chance": 80, "repeat": [ 0, 1 ] },
          { "item": "SUS_science_personal_effects", "chance": 25, "repeat": [ 0, 1 ] },
          { "item": "tools_science", "chance": 80, "repeat": [ 0, 1 ] },
          { "item": "harddrugs", "chance": 50, "repeat": [ 0, 1 ] }
        ]
      },
      "place_loot": [
        { "item": "ampoule", "x": 55, "y": 47, "chance": 100, "repeat": [ 0, 3 ] },
        { "item": "rx12_injector", "x": 55, "y": 47, "chance": 100 },
        { "item": "ampoule", "x": 55, "y": 48, "chance": 100, "repeat": [ 0, 3 ] },
        { "item": "rx12_injector", "x": 55, "y": 48, "chance": 100 },
        { "item": "ampoule", "x": 55, "y": 49, "chance": 100, "repeat": [ 0, 3 ] },
        { "item": "rx12_injector", "x": 55, "y": 49, "chance": 100 }
      ]
    }
  }
]
