[
  {
    "type": "mapgen",
    "method": "json",
    "om_terrain": [ [ "rc_grounds_N1a", "rc_grounds_N2a", "rc_grounds_N3a", "rc_grounds_N4a", "rc_grounds_N5a" ] ],
    "weight": 100,
    "object": {
      "fill_ter": "t_grass",
      "rows": [
        "........................................................................................................................",
        "||||||||||||||||||||||||||||||||||||||||||||||||||||||||||||||||||||||||||||||||||||||||||||||||||||||||||||||||||||||||",
        "........................................................................................................................",
        "........................................................................................................................",
        "........................................................................................................................",
        "........................................................................................................................",
        "........................................................................................................................",
        "........................................................................................................................",
        "........................................................................................................................",
        "........................................................................................................................",
        "........................................................................................................................",
        "........................................................................................................................",
        "........................................................................................................................",
        "........................................................................................................................",
        "........................................................................................................................",
        "........................................................................................................................",
        "........................................................................................................................",
        "........................................................................................................................",
        "........................................................................................................................",
        "........................................................................................................................",
        "........................................................................................................................",
        "........................................................................................................................",
        "........................................................................................................................",
        "........................................................................................................................"
      ],
      "palettes": [ "rc_grounds" ]
    }
  },
  {
    "type": "mapgen",
    "method": "json",
    "om_terrain": [ [ "rc_grounds_N1b", "rc_grounds_N2b", "rc_grounds_N3b", "rc_grounds_N4b", "rc_grounds_N5b" ] ],
    "weight": 100,
    "object": {
      "fill_ter": "t_grass",
      "rows": [
        "........................................................................................................................",
        "........................................................................................................................",
        "........................................................................................................................",
        "........................................................................................................................",
        "........................................................................................................................",
        "........................................................................................................................",
        "........................................................................................................................",
        "........................................................................................................................",
        "........................................................................................................................",
        "........................................................................................................................",
        "........................................................................................................................",
        "........................................................................................................................",
        "........................................................................................................................",
        "........................................................................................................................",
        "........................................................................................................................",
        "........................................................................................................................",
        "........................................................................................................................",
        "........................................................................................................................",
        "........................................................................................................................",
        "........................................................................................................................",
        "........................................................................................................................",
        "........................................................................................................................",
        "........................................................................................................................",
        "........................................................................................................................"
      ],
      "palettes": [ "rc_grounds" ]
    }
  },
  {
    "type": "mapgen",
    "method": "json",
    "om_terrain": [ [ "rc_grounds_N1c", "rc_grounds_N2c", "rc_grounds_N3c", "rc_grounds_N4c", "rc_grounds_N5c" ] ],
    "weight": 100,
    "object": {
      "fill_ter": "t_grass",
      "rows": [
        "........................................................................................................................",
        "........................................................................................................................",
        "........................................................................................................................",
        "........................................................................................................................",
        "........................................................................................................................",
        "........................................................................................................................",
        "........................................................................................................................",
        "........................................................................................................................",
        "........................................................................................................................",
        "........................................................................................................................",
        "........................................................................................................................",
        "........................................................................................................................",
        "........................................................................................................................",
        "........................................................................................................................",
        "........................................................................................................................",
        "........................................................................................................................",
        "........................................................................................................................",
        "........................................................................................................................",
        "........................................................................................................................",
        "........................................................................................................................",
        "........................................................................................................................",
        "........................................................................................................................",
        "........................................................................................................................",
        "........................................................................................................................"
      ],
      "palettes": [ "rc_grounds" ]
    }
  },
  {
    "type": "mapgen",
    "method": "json",
    "om_terrain": [ [ "rc_grounds_N1d", "rc_grounds_N2d", "rc_grounds_N3d", "rc_grounds_N4d", "rc_grounds_N5d" ] ],
    "weight": 100,
    "object": {
      "fill_ter": "t_grass",
      "rows": [
        "........................................................................................................................",
        "........................................................................................................................",
        "........................................................................................................................",
        "........................................................................................................................",
        "........................................................................................................................",
        "........................................................................................................................",
        "........................................................................................................................",
        "........................................................................................................................",
        "........................................................................................................................",
        "........................................................................................................................",
        "........................................................................................................................",
        "........................................................................................................................",
        "........................................................................................................................",
        "........................................................................................................................",
        "........................................................................................................................",
        "........................................................................................................................",
        "........................................................................................................................",
        "........................................................................................................................",
        "........................................................................................................................",
        "........................................................................................................................",
        "........................................................................................................................",
        "........................................................................................................................",
        "........................................................................................................................",
        "........................................................................................................................"
      ],
      "palettes": [ "rc_grounds" ]
    }
  },
  {
    "type": "mapgen",
    "method": "json",
    "om_terrain": [ [ "rc_grounds_N1e", "rc_grounds_N2e", "rc_grounds_N3e", "rc_grounds_N4e", "rc_grounds_N5e" ] ],
    "weight": 100,
    "object": {
      "fill_ter": "t_grass",
      "rows": [
        "........................................................................................................................",
        "........................................................................................................................",
        "........................................................................................................................",
        "........................................................................................................................",
        "........................................................................................................................",
        "........................................................................................................................",
        "........................................................................................................................",
        "........................................................................................................................",
        "........................................................................................................................",
        "........................................................................................................................",
        "........................................................................................................................",
        "........................................................................................................................",
        "........................................................................................................................",
        "........................................................................................................................",
        "........................................................................................................................",
        "........................................................................................................................",
        "........................................................................................................................",
        "........................................................................................................................",
        "........................................................................................................................",
        "........................................................................................................................",
        "........................................................................................................................",
        "........................................................................................................................",
        "........................................................................................................................",
        "........................................................................................................................"
      ],
      "palettes": [ "rc_grounds" ]
    }
  },
  {
    "type": "mapgen",
    "method": "json",
    "om_terrain": [
      [ "rc_grounds_N1a_z2", "rc_grounds_N2a_z2", "rc_grounds_N3a_z2", "rc_grounds_N4a_z2", "rc_grounds_N5a_z2" ],
      [ "rc_grounds_N1b_z2", "rc_grounds_N2b_z2", "rc_grounds_N3b_z2", "rc_grounds_N4b_z2", "rc_grounds_N5b_z2" ],
      [ "rc_grounds_N1c_z2", "rc_grounds_N2c_z2", "rc_grounds_N3c_z2", "rc_grounds_N4c_z2", "rc_grounds_N5c_z2" ],
      [ "rc_grounds_N1d_z2", "rc_grounds_N2d_z2", "rc_grounds_N3d_z2", "rc_grounds_N4d_z2", "rc_grounds_N5d_z2" ],
      [ "rc_grounds_N1e_z2", "rc_grounds_N2e_z2", "rc_grounds_N3e_z2", "rc_grounds_N4e_z2", "rc_grounds_N5e_z2" ]
    ],
    "weight": 100,
    "object": { "fill_ter": "t_open_air" }
  },
  {
    "type": "mapgen",
    "method": "json",
    "om_terrain": [
      [ "rc_grounds_N1a_z1", "rc_grounds_N2a_z1", "rc_grounds_N3a_z1", "rc_grounds_N4a_z1", "rc_grounds_N5a_z1" ],
      [ "rc_grounds_N1b_z1", "rc_grounds_N2b_z1", "rc_grounds_N3b_z1", "rc_grounds_N4b_z1", "rc_grounds_N5b_z1" ],
      [ "rc_grounds_N1c_z1", "rc_grounds_N2c_z1", "rc_grounds_N3c_z1", "rc_grounds_N4c_z1", "rc_grounds_N5c_z1" ],
      [ "rc_grounds_N1d_z1", "rc_grounds_N2d_z1", "rc_grounds_N3d_z1", "rc_grounds_N4d_z1", "rc_grounds_N5d_z1" ],
      [ "rc_grounds_N1e_z1", "rc_grounds_N2e_z1", "rc_grounds_N3e_z1", "rc_grounds_N4e_z1", "rc_grounds_N5e_z1" ]
    ],
    "weight": 100,
    "object": { "fill_ter": "t_open_air" }
  },
  {
    "type": "mapgen",
    "method": "json",
    "om_terrain": [
      [ "rc_grounds_N1a_z-1", "rc_grounds_N2a_z-1", "rc_grounds_N3a_z-1", "rc_grounds_N4a_z-1", "rc_grounds_N5a_z-1" ],
      [ "rc_grounds_N1b_z-1", "rc_grounds_N2b_z-1", "rc_grounds_N3b_z-1", "rc_grounds_N4b_z-1", "rc_grounds_N5b_z-1" ],
      [ "rc_grounds_N1c_z-1", "rc_grounds_N2c_z-1", "rc_grounds_N3c_z-1", "rc_grounds_N4c_z-1", "rc_grounds_N5c_z-1" ],
      [ "rc_grounds_N1d_z-1", "rc_grounds_N2d_z-1", "rc_grounds_N3d_z-1", "rc_grounds_N4d_z-1", "rc_grounds_N5d_z-1" ],
      [ "rc_grounds_N1e_z-1", "rc_grounds_N2e_z-1", "rc_grounds_N3e_z-1", "rc_grounds_N4e_z-1", "rc_grounds_N5e_z-1" ]
    ],
    "weight": 100,
    "object": { "fill_ter": "t_rock" }
  },
  {
    "type": "mapgen",
    "method": "json",
    "om_terrain": [
      [ "rc_grounds_N1a_z-2", "rc_grounds_N2a_z-2", "rc_grounds_N3a_z-2", "rc_grounds_N4a_z-2", "rc_grounds_N5a_z-2" ],
      [ "rc_grounds_N1b_z-2", "rc_grounds_N2b_z-2", "rc_grounds_N3b_z-2", "rc_grounds_N4b_z-2", "rc_grounds_N5b_z-2" ],
      [ "rc_grounds_N1c_z-2", "rc_grounds_N2c_z-2", "rc_grounds_N3c_z-2", "rc_grounds_N4c_z-2", "rc_grounds_N5c_z-2" ],
      [ "rc_grounds_N1d_z-2", "rc_grounds_N2d_z-2", "rc_grounds_N3d_z-2", "rc_grounds_N4d_z-2", "rc_grounds_N5d_z-2" ],
      [ "rc_grounds_N1e_z-2", "rc_grounds_N2e_z-2", "rc_grounds_N3e_z-2", "rc_grounds_N4e_z-2", "rc_grounds_N5e_z-2" ]
    ],
    "weight": 100,
    "object": { "fill_ter": "t_rock" }
  },
  {
    "type": "mapgen",
    "method": "json",
    "om_terrain": [
      [ "rc_grounds_N1a_z-3", "rc_grounds_N2a_z-3", "rc_grounds_N3a_z-3", "rc_grounds_N4a_z-3", "rc_grounds_N5a_z-3" ],
      [ "rc_grounds_N1b_z-3", "rc_grounds_N2b_z-3", "rc_grounds_N3b_z-3", "rc_grounds_N4b_z-3", "rc_grounds_N5b_z-3" ],
      [ "rc_grounds_N1c_z-3", "rc_grounds_N2c_z-3", "rc_grounds_N3c_z-3", "rc_grounds_N4c_z-3", "rc_grounds_N5c_z-3" ],
      [ "rc_grounds_N1d_z-3", "rc_grounds_N2d_z-3", "rc_grounds_N3d_z-3", "rc_grounds_N4d_z-3", "rc_grounds_N5d_z-3" ],
      [ "rc_grounds_N1e_z-3", "rc_grounds_N2e_z-3", "rc_grounds_N3e_z-3", "rc_grounds_N4e_z-3", "rc_grounds_N5e_z-3" ]
    ],
    "weight": 100,
    "object": { "fill_ter": "t_rock" }
  },
  {
    "type": "mapgen",
    "method": "json",
    "om_terrain": [
      [ "rc_grounds_N1a_z-4", "rc_grounds_N2a_z-4", "rc_grounds_N3a_z-4", "rc_grounds_N4a_z-4", "rc_grounds_N5a_z-4" ],
      [ "rc_grounds_N1b_z-4", "rc_grounds_N2b_z-4", "rc_grounds_N3b_z-4", "rc_grounds_N4b_z-4", "rc_grounds_N5b_z-4" ],
      [ "rc_grounds_N1c_z-4", "rc_grounds_N2c_z-4", "rc_grounds_N3c_z-4", "rc_grounds_N4c_z-4", "rc_grounds_N5c_z-4" ],
      [ "rc_grounds_N1d_z-4", "rc_grounds_N2d_z-4", "rc_grounds_N3d_z-4", "rc_grounds_N4d_z-4", "rc_grounds_N5d_z-4" ],
      [ "rc_grounds_N1e_z-4", "rc_grounds_N2e_z-4", "rc_grounds_N3e_z-4", "rc_grounds_N4e_z-4", "rc_grounds_N5e_z-4" ]
    ],
    "weight": 100,
    "object": { "fill_ter": "t_rock" }
  }
]
