[
  {
    "type": "mapgen",
    "method": "json",
    "om_terrain": [ [ "refctr_fence_corner", "refctr_fence" ] ],
    "weight": 100,
    "object": {
      "fill_ter": "t_grass",
      "rows": [
        "~~~~~~~~~~~~~~~~~~~~~~~~~~~~~~~~~~~~~~~~~~~~~~~~",
        "~~~~~~~~~~~~~~~~~~~~~~~~~~~~~~~~~~~~~~~~~~~~~~~~",
        "~~~~~~~~~~~~~~~~~~~~~~~~~~~~~~~~~~~~~~~~~~~~~~~~",
        "~~~~~~~~~~~~~~~~~~~~~~~~~~~~~~~~~~~~~~~~~~~~~~~~",
        "~~~~~~~~~~~~~~~~~~~~~~~~~~~~~~~~~~~~~~~~~~~~~~~~",
        "~~~~~~~~~~~~~~~~~~~~~~~~~~~~~~~~~~~~~~~~~~~~~~~~",
        "~~~~~~~~~~~~~~~~~~~~~~~~~~~~~~~~~~~~~~~~~~~~~~~~",
        "~~~~~~~~~~~~~~~~~~~~~~~~~~~~~~~~~~~~~~~~~~~~~~~~",
        "~~~~~~~~~~~~~~~~~~~~~~~~~~~~~~~~~~~~~~~~~~~~~~~~",
        "~~~~~~~~~~~~~~~~~~~~~~~~~~~~~~~~~~~~~~~~~~~~~~~~",
        "~~~~~~~~~~~~~~~~~~~~~~~~~~~~~~~~~~~~~~~~~~~~~~~~",
        "~~~~~~~~~~~|||||||||||||||||||||||||||||||||||||",
        "~~~~~~~~~~~|....................................",
        "~~~~~~~~~~~|....................................",
        "~~~~~~~~~~~|....................................",
        "~~~~~~~~~~~|....................................",
        "~~~~~~~~~~~|....................................",
        "~~~~~~~~~~~|....................................",
        "~~~~~~~~~~~|....................................",
        "~~~~~~~~~~~|....................................",
        "~~~~~~~~~~~|....................................",
        "~~~~~~~~~~~|....................................",
        "~~~~~~~~~~~|....................................",
        "~~~~~~~~~~~|...................................."
      ],
      "palettes": [ "rc_grounds" ]
    }
  },
  {
    "type": "mapgen",
    "method": "json",
    "om_terrain": [ [ "refctr_fence_opening_W", "refctr_road", "refctr_fence_opening_E" ] ],
    "weight": 100,
    "object": {
      "fill_ter": "t_grass",
      "rows": [
        "........................''''________________''''........................",
        "........................''''_______,,_______''''........................",
        "........................''''_______,,_______''''........................",
        "........................''''_______,,_______''''........................",
        "........................''''________________''''........................",
        "........................''''_______,,_______''''........................",
        "........................''''_______,,_______''''........................",
        "........................''''_______,,_______''''........................",
        "........................''''________________''''........................",
        "........................''''_______,,_______''''........................",
        "........................''''_______,,_______''''........................",
        "........................''''_______,,_______''''........................",
        "||||||||||||............''''________________''''............||||||||||||",
        "~~~~~~~~~~~~~~~~~~~~~~~~''''_______,,_______''''~~~~~~~~~~~~~~~~~~~~~~~~",
        "~~~~~~~~~~~~~~~~~~~~~~~~''''_______,,_______''''~~~~~~~~~~~~~~~~~~~~~~~~",
        "~~~~~~~~~~~~~~~~~~~~~~~~''''_______,,_______''''~~~~~~~~~~~~~~~~~~~~~~~~",
        "~~~~~~~~~~~~~~~~~~~~~~~~''''________________''''~~~~~~~~~~~~~~~~~~~~~~~~",
        "~~~~~~~~~~~~~~~~~~~~~~~~''''_______,,_______''''~~~~~~~~~~~~~~~~~~~~~~~~",
        "~~~~~~~~~~~~~~~~~~~~~~~~''''_______,,_______''''~~~~~~~~~~~~~~~~~~~~~~~~",
        "~~~~~~~~~~~~~~~~~~~~~~~~''''_______,,_______''''~~~~~~~~~~~~~~~~~~~~~~~~",
        "~~~~~~~~~~~~~~~~~~~~~~~~''''________________''''~~~~~~~~~~~~~~~~~~~~~~~~",
        "~~~~~~~~~~~~~~~~~~~~~~~~''''_______,,_______''''~~~~~~~~~~~~~~~~~~~~~~~~",
        "~~~~~~~~~~~~~~~~~~~~~~~~''''_______,,_______''''~~~~~~~~~~~~~~~~~~~~~~~~",
        "~~~~~~~~~~~~~~~~~~~~~~~~''''_______,,_______''''~~~~~~~~~~~~~~~~~~~~~~~~"
      ],
      "palettes": [ "rc_grounds" ]
    }
  }
]
