[
  {
    "type": "mapgen",
    "method": "json",
    "om_terrain": [ [ "refctr_field" ] ],
    "weight": 100,
    "object": {
      "fill_ter": "t_grass",
      "rows": [
        "........................",
        "........................",
        "........................",
        "........................",
        "........................",
        "........................",
        "........................",
        "........................",
        "........................",
        "........................",
        "........................",
        "........................",
        "........................",
        "........................",
        "........................",
        "........................",
        "........................",
        "........................",
        "........................",
        "........................",
        "........................",
        "........................",
        "........................",
        "........................"
      ],
      "palettes": [ "rc_grounds" ]
    }
  },
  {
    "type": "mapgen",
    "method": "json",
    "om_terrain": [ [ "refctr_fence_NW", "refctr_fence_NE" ], [ "refctr_fence_SW", "refctr_fence_SE" ] ],
    "weight": 100,
    "object": {
      "fill_ter": "t_grass",
      "rows": [
        "~~~~~~~~~~~~~~~~~~~~~~~~~~~~~~~~~~~~~~~~~~~~~~~~",
        "~~~~~~~~~~~~~~~~~~~~~~~~~~~~~~~~~~~~~~~~~~~~~~~~",
        "~~~~~~~~~~~~~~~~~~~~~~~~~~~~~~~~~~~~~~~~~~~~~~~~",
        "~~~~~~~~~~~~~~~~~~~~~~~~~~~~~~~~~~~~~~~~~~~~~~~~",
        "~~~~~~~~~~~~~~~~~~~~~~~~~~~~~~~~~~~~~~~~~~~~~~~~",
        "~~~~~~~~~~~~~~~~~~~~~~~~~~~~~~~~~~~~~~~~~~~~~~~~",
        "~~~~~~~~~~~~~~~~~~~~~~~~~~~~~~~~~~~~~~~~~~~~~~~~",
        "~~~~~~~~~~~~~~~~~~~~~~~~~~~~~~~~~~~~~~~~~~~~~~~~",
        "~~~~~~~~~~~~~~~~~~~~~~~~~~~~~~~~~~~~~~~~~~~~~~~~",
        "~~~~~~~~~~~~~~~~~~~~~~~~~~~~~~~~~~~~~~~~~~~~~~~~",
        "~~~~~~~~~~~~~~~~~~~~~~~~~~~~~~~~~~~~~~~~~~~~~~~~",
        "~~~~~~~~~~~||||||||||||||||||||||||||~~~~~~~~~~~",
        "~~~~~~~~~~~|........................|~~~~~~~~~~~",
        "~~~~~~~~~~~|........................|~~~~~~~~~~~",
        "~~~~~~~~~~~|........................|~~~~~~~~~~~",
        "~~~~~~~~~~~|........................|~~~~~~~~~~~",
        "~~~~~~~~~~~|........................|~~~~~~~~~~~",
        "~~~~~~~~~~~|........................|~~~~~~~~~~~",
        "~~~~~~~~~~~|........................|~~~~~~~~~~~",
        "~~~~~~~~~~~|........................|~~~~~~~~~~~",
        "~~~~~~~~~~~|........................|~~~~~~~~~~~",
        "~~~~~~~~~~~|........................|~~~~~~~~~~~",
        "~~~~~~~~~~~|........................|~~~~~~~~~~~",
        "~~~~~~~~~~~|........................|~~~~~~~~~~~",
        "~~~~~~~~~~~|........................|~~~~~~~~~~~",
        "~~~~~~~~~~~|........................|~~~~~~~~~~~",
        "~~~~~~~~~~~|........................|~~~~~~~~~~~",
        "~~~~~~~~~~~|........................|~~~~~~~~~~~",
        "~~~~~~~~~~~|........................|~~~~~~~~~~~",
        "~~~~~~~~~~~|........................|~~~~~~~~~~~",
        "~~~~~~~~~~~|........................|~~~~~~~~~~~",
        "~~~~~~~~~~~|........................|~~~~~~~~~~~",
        "~~~~~~~~~~~|........................|~~~~~~~~~~~",
        "~~~~~~~~~~~|........................|~~~~~~~~~~~",
        "~~~~~~~~~~~|........................|~~~~~~~~~~~",
        "~~~~~~~~~~~|........................|~~~~~~~~~~~",
        "~~~~~~~~~~~||||||||||||||||||||||||||~~~~~~~~~~~",
        "~~~~~~~~~~~~~~~~~~~~~~~~~~~~~~~~~~~~~~~~~~~~~~~~",
        "~~~~~~~~~~~~~~~~~~~~~~~~~~~~~~~~~~~~~~~~~~~~~~~~",
        "~~~~~~~~~~~~~~~~~~~~~~~~~~~~~~~~~~~~~~~~~~~~~~~~",
        "~~~~~~~~~~~~~~~~~~~~~~~~~~~~~~~~~~~~~~~~~~~~~~~~",
        "~~~~~~~~~~~~~~~~~~~~~~~~~~~~~~~~~~~~~~~~~~~~~~~~",
        "~~~~~~~~~~~~~~~~~~~~~~~~~~~~~~~~~~~~~~~~~~~~~~~~",
        "~~~~~~~~~~~~~~~~~~~~~~~~~~~~~~~~~~~~~~~~~~~~~~~~",
        "~~~~~~~~~~~~~~~~~~~~~~~~~~~~~~~~~~~~~~~~~~~~~~~~",
        "~~~~~~~~~~~~~~~~~~~~~~~~~~~~~~~~~~~~~~~~~~~~~~~~",
        "~~~~~~~~~~~~~~~~~~~~~~~~~~~~~~~~~~~~~~~~~~~~~~~~",
        "~~~~~~~~~~~~~~~~~~~~~~~~~~~~~~~~~~~~~~~~~~~~~~~~"
      ],
      "palettes": [ "rc_grounds" ]
    }
  },
  {
    "type": "mapgen",
    "method": "json",
    "om_terrain": [ [ "refctr_fence_v" ] ],
    "weight": 100,
    "object": {
      "fill_ter": "t_grass",
      "rows": [
        "............|~~~~~~~~~~~",
        "............|~~~~~~~~~~~",
        "............|~~~~~~~~~~~",
        "............|~~~~~~~~~~~",
        "............|~~~~~~~~~~~",
        "............|~~~~~~~~~~~",
        "............|~~~~~~~~~~~",
        "............|~~~~~~~~~~~",
        "............|~~~~~~~~~~~",
        "............|~~~~~~~~~~~",
        "............|~~~~~~~~~~~",
        "............|~~~~~~~~~~~",
        "............|~~~~~~~~~~~",
        "............|~~~~~~~~~~~",
        "............|~~~~~~~~~~~",
        "............|~~~~~~~~~~~",
        "............|~~~~~~~~~~~",
        "............|~~~~~~~~~~~",
        "............|~~~~~~~~~~~",
        "............|~~~~~~~~~~~",
        "............|~~~~~~~~~~~",
        "............|~~~~~~~~~~~",
        "............|~~~~~~~~~~~",
        "............|~~~~~~~~~~~"
      ],
      "palettes": [ "rc_grounds" ]
    }
  },
  {
    "type": "mapgen",
    "method": "json",
    "om_terrain": [ [ "refctr_fence_h" ] ],
    "weight": 100,
    "object": {
      "fill_ter": "t_grass",
      "rows": [
        "~~~~~~~~~~~~~~~~~~~~~~~~",
        "~~~~~~~~~~~~~~~~~~~~~~~~",
        "~~~~~~~~~~~~~~~~~~~~~~~~",
        "~~~~~~~~~~~~~~~~~~~~~~~~",
        "~~~~~~~~~~~~~~~~~~~~~~~~",
        "~~~~~~~~~~~~~~~~~~~~~~~~",
        "~~~~~~~~~~~~~~~~~~~~~~~~",
        "~~~~~~~~~~~~~~~~~~~~~~~~",
        "~~~~~~~~~~~~~~~~~~~~~~~~",
        "~~~~~~~~~~~~~~~~~~~~~~~~",
        "~~~~~~~~~~~~~~~~~~~~~~~~",
        "||||||||||||||||||||||||",
        "........................",
        "........................",
        "........................",
        "........................",
        "........................",
        "........................",
        "........................",
        "........................",
        "........................",
        "........................",
        "........................",
        "........................"
      ],
      "palettes": [ "rc_grounds" ]
    }
  },
  {
    "type": "mapgen",
    "method": "json",
    "om_terrain": [ [ "refctr_fence_entrance_L", "refctr_road", "refctr_fence_entrance_R" ] ],
    "weight": 100,
    "object": {
      "fill_ter": "t_grass",
      "rows": [
        "........................''''________________''''........................",
        "........................''''_______,,_______''''........................",
        "........................''''_______,,_______''''........................",
        "........................''''_______,,_______''''........................",
        "........................''''________________''''........................",
        "........................''''_______,,_______''''........................",
        "........................''''_______,,_______''''........................",
        "........................''''_______,,_______''''........................",
        "........................''''________________''''........................",
        "........................''''_______,,_______''''........................",
        "........................''''_______,,_______''''........................",
        "........................''''_______,,_______''''........................",
        "||||||||||||............''''________________''''............||||||||||||",
        "~~~~~~~~~~~~~~~~~~~~~~~~''''_______,,_______''''~~~~~~~~~~~~~~~~~~~~~~~~",
        "~~~~~~~~~~~~~~~~~~~~~~~~''''_______,,_______''''~~~~~~~~~~~~~~~~~~~~~~~~",
        "~~~~~~~~~~~~~~~~~~~~~~~~''''_______,,_______''''~~~~~~~~~~~~~~~~~~~~~~~~",
        "~~~~~~~~~~~~~~~~~~~~~~~~''''________________''''~~~~~~~~~~~~~~~~~~~~~~~~",
        "~~~~~~~~~~~~~~~~~~~~~~~~''''_______,,_______''''~~~~~~~~~~~~~~~~~~~~~~~~",
        "~~~~~~~~~~~~~~~~~~~~~~~~''''_______,,_______''''~~~~~~~~~~~~~~~~~~~~~~~~",
        "~~~~~~~~~~~~~~~~~~~~~~~~''''_______,,_______''''~~~~~~~~~~~~~~~~~~~~~~~~",
        "~~~~~~~~~~~~~~~~~~~~~~~~''''________________''''~~~~~~~~~~~~~~~~~~~~~~~~",
        "~~~~~~~~~~~~~~~~~~~~~~~~''''_______,,_______''''~~~~~~~~~~~~~~~~~~~~~~~~",
        "~~~~~~~~~~~~~~~~~~~~~~~~''''_______,,_______''''~~~~~~~~~~~~~~~~~~~~~~~~",
        "~~~~~~~~~~~~~~~~~~~~~~~~''''_______,,_______''''~~~~~~~~~~~~~~~~~~~~~~~~"
      ],
      "palettes": [ "rc_grounds" ]
    }
  },
  {
    "type": "mapgen",
    "method": "json",
    "om_terrain": [ [ "refctr_S3e" ] ],
    "//": "Temporary map until I unhardcode the locate mission",
    "weight": 100,
    "object": {
      "fill_ter": "t_grass",
      "rows": [
        "''''________________''''",
        "''''_______,,_______''''",
        "''''_______,,_______''''",
        "''''_______,,_______''''",
        "''''________________''''",
        "''''_______,,_______''''",
        "''''_______,,_______''''",
        "''''_______,,_______''''",
        "''''________________''''",
        "''''_______,,_______''''",
        "''''_______,,_______''''",
        "''''_______,,_______''''",
        "''''________________''''",
        "''''_______,,_______''''",
        "''''_______,,_______''''",
        "''''_______,,_______''''",
        "''''________________''''",
        "''''_______,,_______''''",
        "''''_______,,_______''''",
        "''''_______,,_______''''",
        "''''________________''''",
        "''''_______,,_______''''",
        "''''_______,,_______''''",
        "''''_______,,_______''''"
      ],
      "palettes": [ "rc_grounds" ]
    }
  }
]
