[
  {
    "type": "mapgen",
    "method": "json",
    "om_terrain": [ [ "rc_grounds_NW1a_z-4", "rc_grounds_NW2a_z-4", "rc_grounds_NW3a_z-4", "rc_grounds_NW4a_z-4", "rc_grounds_NW5a_z-4" ] ],
    "weight": 100,
    "object": {
      "fill_ter": "t_rock",
      "rows": [
        "########################################################################################################################",
        "########################################################################################################################",
        "########################################################################################################################",
        "########################################################################################################################",
        "########################################################################################################################",
        "########################################################################################################################",
        "########################################################################################################################",
        "########################################################################################################################",
        "########################################################################################################################",
        "########################################################################################################################",
        "########################################################################################################################",
        "########################################################################################################################",
        "########################################################################################################################",
        "########################################################################################################################",
        "########################################################################################################################",
        "########################################################################################################################",
        "########################################################################################################################",
        "########################################################################################################################",
        "########################################################################################################################",
        "########################################################################################################################",
        "########################################################################################################################",
        "########################################################################################################################",
        "########################################################################################################################",
        "########################################################################################################################"
      ],
      "terrain": { "#": "t_rock" }
    }
  },
  {
    "type": "mapgen",
    "method": "json",
    "om_terrain": [ [ "rc_grounds_NW1b_z-4", "rc_grounds_NW2b_z-4", "rc_grounds_NW3b_z-4", "rc_grounds_NW4b_z-4", "rc_grounds_NW5b_z-4" ] ],
    "weight": 100,
      "fill_ter": "t_rock",
      "rows": [
        "########################################################################################################################",
        "########################################################################################################################",
        "########################################################################################################################",
        "########################################################################################################################",
        "########################################################################################################################",
        "########################################################################################################################",
        "########################################################################################################################",
        "########################################################################################################################",
        "########################################################################################################################",
        "########################################################################################################################",
        "########################################################################################################################",
        "########################################################################################################################",
        "########################################################################################################################",
        "########################################################################################################################",
        "########################################################################################################################",
        "########################################################################################################################",
        "########################################################################################################################",
        "########################################################################################################################",
        "########################################################################################################################",
        "########################################################################################################################",
        "########################################################################################################################",
        "########################################################################################################################",
        "########################################################################################################################",
        "########################################################################################################################"
      ],
      "terrain": { "#": "t_rock" }
  },
  {
    "type": "mapgen",
    "method": "json",
    "om_terrain": [ [ "rc_grounds_NW1c_z-4", "rc_grounds_NW2c_z-4", "rc_grounds_NW3c_z-4", "rc_grounds_NW4c_z-4", "rc_grounds_NW5c_z-4" ] ],
    "weight": 100,
      "fill_ter": "t_rock",
      "rows": [
        "########################################################################################################################",
        "########################################################################################################################",
        "########################################################################################################################",
        "########################################################################################################################",
        "########################################################################################################################",
        "########################################################################################################################",
        "########################################################################################################################",
        "########################################################################################################################",
        "########################################################################################################################",
        "########################################################################################################################",
        "########################################################################################################################",
        "########################################################################################################################",
        "########################################################################################################################",
        "########################################################################################################################",
        "########################################################################################################################",
        "########################################################################################################################",
        "########################################################################################################################",
        "########################################################################################################################",
        "########################################################################################################################",
        "########################################################################################################################",
        "########################################################################################################################",
        "########################################################################################################################",
        "########################################################################################################################",
        "########################################################################################################################"
      ],
      "terrain": { "#": "t_rock" }
  },
  {
    "type": "mapgen",
    "method": "json",
    "om_terrain": [ [ "rc_grounds_NW1d_z-4", "rc_grounds_NW2d_z-4", "rc_grounds_NW3d_z-4", "rc_grounds_NW4d_z-4", "rc_grounds_NW5d_z-4" ] ],
    "weight": 100,
      "fill_ter": "t_rock",
      "rows": [
        "########################################################################################################################",
        "########################################################################################################################",
        "########################################################################################################################",
        "########################################################################################################################",
        "########################################################################################################################",
        "########################################################################################################################",
        "########################################################################################################################",
        "########################################################################################################################",
        "########################################################################################################################",
        "########################################################################################################################",
        "########################################################################################################################",
        "########################################################################################################################",
        "########################################################################################################################",
        "########################################################################################################################",
        "########################################################################################################################",
        "########################################################################################################################",
        "########################################################################################################################",
        "########################################################################################################################",
        "########################################################################################################################",
        "########################################################################################################################",
        "########################################################################################################################",
        "########################################################################################################################",
        "########################################################################################################################",
        "########################################################################################################################"
      ],
      "terrain": { "#": "t_rock" }
  },
  {
    "type": "mapgen",
    "method": "json",
    "om_terrain": [ [ "rc_grounds_NW1e_z-4", "rc_grounds_NW2e_z-4", "rc_grounds_NW3e_z-4", "rc_grounds_NW4e_z-4", "rc_grounds_NW5e_z-4" ] ],
    "weight": 100,
      "fill_ter": "t_rock",
      "rows": [
        "########################################################################################################################",
        "########################################################################################################################",
        "########################################################################################################################",
        "########################################################################################################################",
        "########################################################################################################################",
        "########################################################################################################################",
        "########################################################################################################################",
        "########################################################################################################################",
        "########################################################################################################################",
        "########################################################################################################################",
        "########################################################################################################################",
        "########################################################################################################################",
        "########################################################################################################################",
        "########################################################################################################################",
        "########################################################################################################################",
        "########################################################################################################################",
        "########################################################################################################################",
        "########################################################################################################################",
        "########################################################################################################################",
        "########################################################################################################################",
        "########################################################################################################################",
        "########################################################################################################################",
        "########################################################################################################################",
        "########################################################################################################################"
      ],
    "terrain": { "#": "t_rock" }
    }
    }
  }
]
