[
  {
    "type": "mapgen",
    "method": "json",
    "om_terrain": [ [ "evac_center_6_z1", "evac_center_7_z1", "evac_center_8_z1", "evac_center_9_z1", "evac_center_10_z1" ] ],
    "weight": 100,
    "object": {
      "fill_ter": "t_flat_roof",
      "rows": [
        "                                                                                                                        ",
        "                                                                                                                        ",
        "                             22222222222222222222222222222222222222222222222222222222222222                             ",
        "                            |5............................................................53                            ",
        "                            |..............................................................3                            ",
        "                            |..............................................................3                            ",
        "                            |..............................................................3                            ",
        "                            |..........................oooooooooo..........................3                            ",
        "                            |..........................oooooooooo..........................3                            ",
        "                            |..........................oooooooooo..........................3                            ",
        "                            |..............................................................3                            ",
        "                            |...ooooooooooooo..............................ooooooooooooo...3                            ",
        "                            |...ooooooooooooo..............................ooooooooooooo...3                            ",
        "                            |...ooooooooooooo..............................ooooooooooooo...3                            ",
        "                            |..............................................................3                            ",
        "                            |..............................................................3                            ",
        "                            |..............................................................3                            ",
        "                            |.........&...........................................:........3                            ",
        "                            |..............................................................3                            ",
        "                            |..............................................................3                            ",
        "                            |..............................................................3                            ",
        "                            |..............................................................3                            ",
        "                            -5............................................................5-                            ",
        "                             |-----|...............................................|------|                             "
      ],
      "palettes": [ "roof_palette" ],
      "furniture": { ":": "f_standing_tank", "#": "f_solar_unit", "&": "f_roof_turbine_vent" }
    }
  },
  {
    "type": "mapgen",
    "method": "json",
    "om_terrain": [ [ "evac_center_11_z1", "evac_center_12_z1", "evac_center_13_z1", "evac_center_14_z1", "evac_center_15_z1" ] ],
    "weight": 100,
    "object": {
      "fill_ter": "t_flat_roof",
      "rows": [
        "                                   52.............................................25                                    ",
        "                                    |.............................................3                                     ",
        "                                    |.............................................3                                     ",
        "                                    |.................oooo...oooo.................3                                     ",
        "                                    |.................oooo...oooo.................3                                     ",
        "                                    |.............................................3                                     ",
        "                                    |.................oooo...oooo.................3                                     ",
        "                                    |.................oooo...oooo.................3                                     ",
        "                                    |.............................................3                                     ",
        "                                    |.............................................3                                     ",
        "                                    |.............................................3                                     ",
        "                                    |..........WWWWW.......&.......WWWWW..........3                                     ",
        "                                    |..........WflfW...............WflfW..........3                                     ",
        "                                    |..........W>ffW...............Wff>W..........3                                     ",
        "                                    |..........WWMWW...............WWMWW..........3                                     ",
        "                                    |.............................................3                                     ",
        "                                    |......................:......................3                                     ",
        "                                    |.............................................3                                     ",
        "                                    |.............................................3                                     ",
        "                                    |.............................................3                                     ",
        "                                    |.............................................3                                     ",
        "                                    |.............................................3                                     ",
        "                                    |.............................................3                                     ",
        "                                   5-.............................................-5                                    "
      ],
      "palettes": [ "roof_palette" ],
      "terrain": {
        ">": "t_stairs_down",
        "W": "t_brick_wall",
        "f": "t_thconc_floor",
        "l": "t_thconc_floor_olight",
        "M": "t_door_metal_locked"
      },
      "furniture": { ":": "f_standing_tank", "#": "f_solar_unit", "&": "f_roof_turbine_vent" }
    }
  },
  {
    "type": "mapgen",
    "method": "json",
    "om_terrain": [ [ "evac_center_16_z1", "evac_center_17_z1", "evac_center_18_z1", "evac_center_19_z1", "evac_center_20_z1" ] ],
    "weight": 100,
    "object": {
      "fill_ter": "t_flat_roof",
      "rows": [
        "                             2222222...............................................2222222                              ",
        "                            |5...........................................................533                            ",
        "                            |..............................................................3                            ",
        "                            |..............................................................3                            ",
        "                            |..............................................................3                            ",
        "                            |..............................................................3                            ",
        "                            |.....................5------------------5.....................3                            ",
        "                            |.....................|                  |.........ooo.........3                            ",
        "                            |.....................|                  |.........ooo.........3                            ",
        "                            |.....................|                  |.........ooo.........3                            ",
        "                            |.....................|                  |.........ooo.........3                            ",
        "                            |..........:..........|                  |..........&..........3                            ",
        "                            |.....................|                  |.....................3                            ",
        "                            |.....................|                  |.........ooo.........3                            ",
        "                            |.....................|                  |.........ooo.........3                            ",
        "                            |.....................|                  |.........ooo.........3                            ",
        "                            |.....................|                  |.........ooo.........3                            ",
        "                            |.....................|                  |.....................3                            ",
        "                            |.....................|                  |.....................3                            ",
        "                            |.....................|                  |.....................3                            ",
        "                            |5...................5|                  |5...................53                            ",
        "                             ---------------------                    ---------------------                             ",
        "                                                                                                                        ",
        "                                                                                                                        "
      ],
      "palettes": [ "roof_palette" ],
      "furniture": { ":": "f_standing_tank", "#": "f_solar_unit", "&": "f_roof_turbine_vent" }
    }
  },
  {
    "type": "mapgen",
    "method": "json",
    "om_terrain": [
      [ "evac_center_1_z1", "evac_center_2_z1", "evac_center_3_z1", "evac_center_4_z1", "evac_center_5_z1" ],
      [ "evac_center_21_z1", "evac_center_22_z1", "evac_center_23_z1", "evac_center_24_z1", "evac_center_25_z1" ]
    ],
    "weight": 100,
    "object": { "fill_ter": "t_open_air" }
  }
]
