[
  {
    "type": "mapgen",
    "method": "json",
    "om_terrain": [
      [
        "lab_surface_parking_blockA0",
        "lab_surface_parking_blockB0",
        "lab_surface_parking_blockC0",
        "lab_surface_parking_blockD0",
        "lab_surface_parking_blockE0"
      ],
      [
        "lab_surface_parking_blockA1",
        "lab_surface_parking_blockB1",
        "lab_surface_parking_blockC1",
        "lab_surface_parking_blockD1",
        "lab_surface_parking_blockE1"
      ],
      [ "lab_surface_parking_blockA2", "null", "null", "null", "lab_surface_parking_blockE2" ]
    ],
    "object": {
      "fill_ter": "t_strconc_floor",
      "rows": [
        "########################################################################################################################",
        "#,__,,]]]]]]]]]]]]]]]]]]]]]]]]]]]]]]]]]]]]]]]]]]]]]]]]]]]]]]]]]]]]]]]]]]]]]]]]]]]]]]]]]]]]]]]]]]]]]]]]]]]]]]]]]]]],,__,#",
        "#__,_,]]]]]]]]]]]]]]]]]]]]]]]]]]]]]]]]]]]]]]]]]]]]]]]]]]]]]]]]]]]]]]]]]]]]]]]]]]]]]]]]]]]]]]]]]]]]]]]]]]]]]]]]]]]],_,__#",
        "#_,__,____,,____,,____,,____,,____,,____,,____,,____,,____,]],____,,____,,____,,____,,____,,____,,____,,____,,____,,_,_#",
        "#,__,,____,,____,,____,,____,,____,,____,,____,,____,,____,]],____,,____,,____,,____,,____,,____,,____,,____,,____,,__,#",
        "#__,_,_Á__,,_Á__,,_Á__,,____,,_Á__,,_Á__,,_Á__,,____,,_Á__,]],_Á__,,____,,_Á__,,_Á__,,_Á__,,____,,_Á__,,_Á__,,_Á__,_,__#",
        "#_,__,____,,____,,____,,____,,____,,____,,____,,____,,____,]],____,,____,,____,,____,,____,,____,,____,,____,,____,__,_#",
        "#,__,,____,,____,,____,,____,,____,,____,,____,,____,,____,]],____,,____,,____,,____,,____,,____,,____,,____,,____,,__,#",
        "#__,_,____,,____,,____,,____,,____,,____,,____,,____,,____,]],____,,____,,____,,____,,____,,____,,____,,____,,____,_,__#",
        "#_,__,____,,____,,____,,____,,____,,____,,____,,____,,____,÷÷,____,,____,,____,,____,,____,,____,,____,,____,,____,__,_#",
        "#,__,,____________________________________________________________________________________________________________,,__,#",
        "#__,_,_____________________________________________________÷÷_____________________________________________________,_,__#",
        "#_,__,____________________________________________________________________________________________________________,__,_#",
        "#,__,,_____________________________________________________÷÷_____________________________________________________,,__,#",
        "#__,_,____________________________________________________________________________________________________________,_,__#",
        "#_,__,__________,,____,,____,,____,,____,,____,,____,,____,÷÷,____,,____,,____,,____,,____,,____,,____,,__________,__,_#",
        "#,__,,__________,,____,,____,,____,,____,,____,,____,,____,]],____,,____,,____,,____,,____,,____,,____,,__________,,__,#",
        "#__,_,__________,,____,,____,,____,,____,,____,,____,,____,]],____,,____,,____,,____,,____,,____,,____,,__________,_,__#",
        "#_,__,__________,,____,,____,,____,,____,,____,,____,,____,]],____,,____,,____,,____,,____,,____,,____,,__________,__,_#",
        "#,__,,__________,,__É_,,____,,__É_,,__É_,,__É_,,____,,__É_,]],__É_,,____,,__É_,,__É_,,__É_,,____,,__É_,,__________,,__,#",
        "#__,_,__________,,____,,____,,____,,____,,____,,____,,____,]],____,,____,,____,,____,,____,,____,,____,,__________,_,__#",
        "#_,__,__________,,____,,____,,____,,____,,____,,____,,____,]],____,,____,,____,,____,,____,,____,,____,,__________,__,_#",
        "#,__,,__________,]]]]]]]]]]]]]]]]]]]]]]]]]]]]]]]]]]]]]]]]]]]]]]]]]]]]]]]]]]]]]]]]]]]]]]]]]]]]]]]]]]]]]],__________,,__,#",
        "#__,_,__________,]]]]]]]]]]]]]]]]]]]]]]]]]]]]]]]]]]]]]]]]]]]]]]]]]]]]]]]]]]]]]]]]]]]]]]]]]]]]]]]]]]]]]],__________,_,__#",
        "#_,__,__________,,____,,____,,____,,____,,____,,____,,____,]],____,,____,,____,,____,,____,,____,,____,,__________,__,_#",
        "#,__,_____,,____,,____,,____,,____,,____,,____,,____,,____,]],____,,____,,____,,____,,____,,____,,____,,____,,_____,__,#",
        "#__,______,,____,,_Á__,,____,,_Á__,,_Á__,,_Á__,,____,,_Á__,]],_Á__,,____,,_Á__,,_Á__,,_Á__,,____,,_Á__,,___,,,,_____,__#",
        "#_,_______,,____,,____,,____,,____,,____,,____,,____,,____,]],____,,____,,____,,____,,____,,____,,____,,____,,_______,_#",
        "#,_______,,,,___,,____,,____,,____,,____,,____,,____,,____,]],____,,____,,____,,____,,____,,____,,____,,____,,________,#",
        "#_________,,____,,____,,____,,____,,____,,____,,____,,____,]],____,,____,,____,,____,,____,,____,,____,,____,,_________#",
        "!@@@@?__________,,____,,____,,____,,____,,____,,____,,____,]],____,,____,,____,,____,,____,,____,,____,,_______________#",
        "!__________________________________________________________÷÷__________________________________________________________#",
        "!______________________________________________________________________________________________________________________#",
        "!__________________________________________________________÷÷__________________________________________________________#",
        "!______________________________________________________________________________________________________________________#",
        "!__________________________________________________________÷÷__________________________________________________________#",
        "!______________________________________________________________________________________________________________________#",
        "!__________________________________________________________÷÷__________________________________________________________#",
        "!______________________________________________________________________________________________________________________#",
        "!__________________________________________________________÷÷__________________________________________________________#",
        "!______________________________________________________________________________________________________________________#",
        "!__________________________________________________________÷÷__________________________________________________________#",
        "!______________________________________________________________________________________________________________________#",
        "!__________________________________________________________÷÷__________________________________________________________#",
        "#_____________________________________________]]]]]]]]]]]]]]]]]]]]]]]]]]]]_____________________________________________#",
        "#____________________________________________]]]]]]]]]]]]]]]]]]]]]]]]]]]]]]____________________________________________#",
        "#___________________________________________]]]]]]]]]]]]]]]]]]]]]]]]]]]]]]]]___________________________________________#",
        "#__________________________________________]]]]]]]]]]]]]]]]]]]]]]]]]]]]]]]]]]__________________________________________#",
        "#______________________]                                                                        ]______________________#",
        "#]_________,,_________]]                                                                        ]]_________,,_________]#",
        "#]_________,,_________]#                                                                        #]_________,,_________]#",
        "#]__Û______,,__Û______]#                                                                        #]__Û______,,__Û______]#",
        "#]_________,,_________]#                                                                        #]_________,,_________]#",
        "#]_________,,_________]#                                                                        #]_________,,_________]#",
        "#]_________,,_________]#                                                                        #]_________,,_________]#",
        "#]_________,,_________]#                                                                        #]_________,,_________]#",
        "#]_________,,_________]#                                                                        #]_________,,_________]#",
        "#]_________,,_________]#                                                                        #]_________,,_________]#",
        "#]_________,,_________]#                                                                        #]_________,,_________]#",
        "#]_________,,_________]#                                                                        #]_________,,_________]#",
        "#]_________,,_________]#                                                                        #]_________,,_________]#",
        "#]_________,,_________]#                                                                        #]_________,,_________]#",
        "#]_________,,_________]#                                                                        #]_________,,_________]#",
        "#]____Ü____,,____Ü____]#                                                                        #]____Ü____,,____Ü____]#",
        "#]_________,,_________]#                                                                        #]_________,,_________]#",
        "#]_________,,_________]#                                                                        #]_________,,_________]#",
        "#]_________,,_________]#                                                                        #]_________,,_________]#",
        "#]_________,,_________]#                                                                        #]_________,,_________]#",
        "#]]]]]]]]]]]]]]]]]]]]]]#                                                                        #]]]]]]]]]]]]]]]]]]]]]]#",
        "########################                                                                        ########################",
        "########################                                                                        ########################",
        "########################                                                                        ########################"
      ],
      "palettes": [ "lab_surface_palette" ],
      "terrain": {
        "#": "t_concrete_wall",
        "÷": "t_zebra",
        "Á": "t_pavement",
        "É": "t_pavement",
        "Û": "t_pavement",
        "Ü": "t_pavement",
        "!": "t_boom_barrier_lowered",
        "?": "t_gates_boom_barrier",
        "@": "t_concrete_wall_bb"
      },
      "vehicles": {
        "Á": { "vehicle": "parkinglotbasic", "chance": 20, "rotation": 270 },
        "É": { "vehicle": "parkinglotbasic", "chance": 20, "rotation": 90 },
        "Û": { "vehicle": "semi_truck", "chance": 20, "rotation": 270 },
        "Ü": { "vehicle": "truck_trailer", "chance": 20, "rotation": 270 }
      }
    }
  },
  {
    "type": "terrain",
    "id": "t_boom_barrier_lowered",
    "name": "lowered boom barrier",
    "description": "A lowered boom barrier.",
    "symbol": "-",
    "color": "light_red",
    "move_cost": 0,
    "coverage": 55,
    "flags": [ "TRANSPARENT", "FLAMMABLE", "NOITEM" ],
    "bash": {
      "ter_set": "t_pavement",
      "str_min": 3,
      "str_max": 40,
      "sound": "smash!",
      "sound_fail": "whump.",
      "items": [ { "item": "2x4", "count": [ 2, 6 ] }, { "item": "nail", "charges": [ 4, 8 ] }, { "item": "splinter", "count": 1 } ]
    }
  },
  {
    "type": "terrain",
    "id": "t_boom_barrier_raised",
    "name": "raised boom barrier",
    "description": "A raised boom barrier.",
    "looks_like": "t_pavement",
    "symbol": ".",
    "color": "dark_gray",
    "move_cost": 2,
    "flags": [ "TRANSPARENT", "FLAT", "ROAD", "MINEABLE" ],
    "bash": {
      "ter_set": "t_pavement",
      "str_min": 3,
      "str_max": 40,
      "sound": "smash!",
      "sound_fail": "whump.",
      "items": [ { "item": "2x4", "count": [ 2, 6 ] }, { "item": "nail", "charges": [ 4, 8 ] }, { "item": "splinter", "count": 1 } ]
    }
  },
  {
    "type": "gate",
    "id": "t_gates_boom_barrier",
    "door": "t_boom_barrier_lowered",
    "floor": "t_boom_barrier_raised",
    "walls": [ "t_concrete_wall_bb" ],
    "messages": {
      "pull": "You press the button…",
      "open": "The barrier is raised!",
      "close": "The barrier is lowered!",
      "fail": "The barrier can't be lowered!"
    },
    "moves": 300,
    "bashing_damage": 10
  },
  {
    "type": "terrain",
    "id": "t_concrete_wall_bb",
    "name": "concrete wall",
    "looks_like": "t_rock",
    "description": "An aesthetically pleasing design with simple lines, this type of concrete was used with a weaker chemical mixture in order to have faster setting times.  Not ideal for multi-story buildings, but still capable of supporting a roof.",
    "symbol": "LINE_OXOX",
    "color": "dark_gray",
    "move_cost": 0,
    "coverage": 100,
    "roof": "t_concrete_roof",
    "connect_groups": "WALL",
    "connects_to": "WALL",
    "flags": [ "NOITEM", "SUPPORTS_ROOF", "WALL", "NO_SCENT", "AUTO_WALL_SYMBOL", "MINEABLE", "BLOCK_WIND" ],
    "bash": {
      "str_min": 70,
      "str_max": 300,
      "sound": "crash!",
      "sound_fail": "whump!",
      "ter_set": "t_reb_cage",
      "items": [ { "item": "rock", "count": [ 10, 22 ] } ]
    }
  },
  {
    "type": "terrain",
    "id": "t_gates_boom_barrier",
    "name": "boom barrier controls",
    "description": "Controls for a boom barrier.  If functioning, they can be used to raise or lower a nearby boom barrier.",
    "symbol": "6",
    "color": "cyan_red",
    "move_cost": 0,
    "flags": [ "TRANSPARENT", "NOITEM", "INDOORS", "PERMEABLE", "THIN_OBSTACLE" ],
    "examine_action": "controls_gate",
    "bash": {
      "str_min": 18,
      "str_max": 80,
      "sound": "metal screeching!",
      "sound_fail": "clang!",
      "ter_set": "t_floor",
      "items": [ { "item": "steel_chunk", "count": [ 1, 4 ] }, { "item": "scrap", "count": [ 3, 6 ] } ]
    }
  }
]
