[
  {
    "method": "json",
    "om_terrain": "lab_1x1_RES_8_bedrooms_maintenance",
    "type": "mapgen",
    "weight": 200,
    "object": {
      "fill_ter": "t_thconc_floor",
      "rows": [
        "||||||||||||||||||||||||",
        "|@@___D|________|D___@@|",
        "|s__h__+___jj___+_h___s|",
        "|T__IIy|__%%%%__|YII__T|",
        "||||||||__%!!%__||||||||",
        "|@@___D|_h%!!%h_|D___@@|",
        "|s__h__+_f%!!%f_+_h___s|",
        "|T__IIy|_h%!!%h_|YII__T|",
        "||||||||__%!!%__||||||||",
        "|@@___D|_h%!!%h_|D___@@|",
        "|s__h__+_f%!!%f_+_h___s|",
        "|T__IIy|_h%!!%h_|YII__T|",
        "||||||||__%!!%__||||||||",
        "|@@___D|__%!!%__|D___@@|",
        "|s__h__+__%!!%__+_h___s|",
        "|T__IIy|__%!!%__|YII__T|",
        "||||||||__%%%%__||||||||",
        "|t|t|8S|________|@@I__D|",
        "|+|+|,,|__|>>|__|@@___d|",
        "|,,,,,,|__||||__|___||||",
        "|,,,,,,+__|UU|__+___|8t|",
        "|+|+|,,|__+,,+__|_h_+,,|",
        "|9|9|8S|__|UU|__|IIy|S9|",
        "|||||||||||±||||||||||||"
      ],
      "palettes": [ "lab_common_palette", "lab_residential_palette", "standard_domestic_lino_bathroom" ],
      "terrain": { "!": "t_open_air_rooved", "U": "t_linoleum_gray" }
    }
  },
  {
    "method": "json",
    "om_terrain": "lab_1x1_RES_8_bedrooms_security",
    "type": "mapgen",
    "weight": 200,
    "object": {
      "fill_ter": "t_thconc_floor",
      "rows": [
        "||||||||||||||||||||||||",
        "|@@;;;L|;;;;;;;;|L;;;@@|",
        "|≠;;h;;+;;;jj;;;+;h;;;≠|",
        "|T;;IIy|;;%%%%;;|YII;;T|",
        "||||||||;;%!!%;;||||||||",
        "|@@;;;L|;h%!!%h;|L;;;@@|",
        "|≠;;h;;+;f%!!%f;+;h;;;≠|",
        "|T;;IIy|;h%!!%h;|YII;;T|",
        "||||||||;;%!!%;;||||||||",
        "|@@;;;L|;h%!!%h;|L;;;@@|",
        "|≠;;h;;+;f%!!%f;+;h;;;≠|",
        "|T;;IIy|;h%!!%h;|YII;;T|",
        "||||||||;;%!!%;;||||||||",
        "|@@;;;L|;;%!!%;;|L;;;@@|",
        "|≠;;h;;+;;%!!%;;+;h;;;≠|",
        "|T;;IIy|;;%!!%;;|YII;;T|",
        "||||||||;;%%%%;;||||||||",
        "|t|t|8S|;;;;;;;;|@@I;;L|",
        "|+|+|,,|;;|>>|;;|@@;;;≠|",
        "|,,,,,,|;;||||;;|;;;||||",
        "|,,,,,,+;;|UU|;;+;;;|8t|",
        "|+|+|,,|;;+,,+;;|;h;+,,|",
        "|9|9|8S|;;|UU|;;|IIy|S9|",
        "|||||||||||±||||||||||||"
      ],
      "palettes": [ "lab_common_palette", "lab_security_palette", "standard_domestic_lino_bathroom" ],
      "terrain": { "!": "t_open_air_rooved", "U": "t_linoleum_gray" },
      "items": {
        "f": { "item": "snacks", "chance": 5 },
        "I": [ { "item": "SUS_desks_bedroom_unisex", "chance": 5 }, { "item": "office", "chance": 25 } ],
        "U": { "item": "cleaning", "chance": 30 },
        "≠": [
          { "item": "prison_weapons", "chance": 30 },
          { "item": "swat_gear", "chance": 5 },
          { "item": "prison_armor", "chance": 20 }
        ],
        "L": [ { "item": "SUS_dresser_mens", "chance": 50 }, { "item": "SUS_dresser_womens", "chance": 50 } ]
      }
    }
  },
  {
    "method": "json",
    "om_terrain": "lab_1x1_RES_8_commons",
    "type": "mapgen",
    "weight": 200,
    "object": {
      "fill_ter": "t_thconc_floor",
      "rows": [
        "|||||||||||++|||||||||||",
        "|_ÿÿÿÿÿÿ___!!____!!!!!!|",
        "|_ÿÿÿÿÿÿ___!!____!!!!!!|",
        "|_ÿÿÿÿÿÿ___!!____!!!!!!|",
        "|_ÿÿÿÿÿÿ___!!____!!!!!!|",
        "|_ÿÿÿÿÿÿ___!!____!!!!!!|",
        "|_ÿÿÿÿÿÿ___!!____!!!!!!|",
        "||||JJJ____!!____!!!!!!|",
        "|y____JA___!!____!!!!!!|",
        "|3____J_A__!!____!!!!!!|",
        "|4____JA___!!____!!!!!!|",
        "|O____J_A__!!____!!!!!!|",
        "|2_________!!___||||||||",
        "|157F3____!!!!__|ÿÿÿÿÿÿ|",
        "||||||_||_!!!!__|ÿÿÿÿÿÿ|",
        "|6______+_!!!!__|ÿÿÿÿÿÿ|",
        "|66JJJ66|_!!!!__+ÿÿÿÿÿÿ|",
        "|||||||||__!!___|ÿÿÿÿÿÿ|",
        "|_________|<<|__|ÿÿÿÿÿÿ|",
        "|_____||+|||||__||||||||",
        "|_____|___|UU|__|YS,,+t|",
        "|_____|___|,,+__+,,,,|||",
        "|_____|___|UU|__|YS,,+t|",
        "|||||||||||±||||||||||||"
      ],
      "parameters": {
        "carpet_type": {
          "type": "ter_str_id",
          "default": {
            "distribution": [
              [ "t_carpet_concrete_yellow", 2 ],
              [ "t_carpet_concrete_green", 2 ],
              [ "t_carpet_concrete_purple", 1 ],
              [ "t_carpet_concrete_red", 1 ],
              [ "t_thconc_floor", 2 ]
            ]
          }
        },
        "floor_type": {
          "type": "ter_str_id",
          "default": {
            "distribution": [
              [ "t_carpet_concrete_yellow", 2 ],
              [ "t_carpet_concrete_green", 2 ],
              [ "t_carpet_concrete_purple", 1 ],
              [ "t_carpet_concrete_red", 1 ],
              [ "t_floor", 1 ],
              [ "t_thconc_floor", 2 ]
            ]
          }
        }
      },
      "palettes": [ "lab_common_palette", "lab_residential_palette", "standard_domestic_lino_bathroom" ],
      "terrain": {
        "U": "t_linoleum_gray",
        "Y": "t_linoleum_gray",
        "!": { "param": "carpet_type", "fallback": "t_carpet_concrete_yellow" },
        "ÿ": { "param": "floor_type", "fallback": "t_floor" }
      },
      "place_nested": [
        {
          "chunks": [
            [ "diningroom_6x6_E_W_1", 20 ],
            [ "diningroom_6x6_E_W_2", 20 ],
            [ "diningroom_6x6_N_S_2", 20 ],
            [ "diningroom_6x6_N_S_1B", 20 ],
            [ "diningroom_6x6_N_S_1A", 20 ]
          ],
          "x": 2,
          "y": 1
        },
        {
          "chunks": [
            [ "bonus_room_3x3_1", 20 ],
            [ "bonus_room_3x3_3", 20 ],
            [ "bonus_room_3x3_E_5", 20 ],
            [ "bonus_room_3x3_E_6", 20 ],
            [ "bonus_room_3x3_W_6", 20 ],
            [ "bonus_room_3x3_E_8", 20 ],
            [ "bonus_room_3x3_S_8", 20 ],
            [ "bonus_room_3x3_W_8", 20 ],
            [ "bonus_room_3x3_S_6", 20 ]
          ],
          "x": 7,
          "y": 20
        },
        { "chunks": [ [ "lab_residential_6x6_W", 100 ] ], "x": 17, "y": 6 },
        { "chunks": [ [ "lab_residential_6x6_W", 100 ] ], "x": 17, "y": 13 },
        {
          "chunks": [
            [ "livingroom_5x5_N_2", 30 ],
            [ "livingroom_5x5_S_2", 20 ],
            [ "livingroom_5x5_W_2", 30 ],
            [ "5x5_pool", 10 ],
            [ "5x5_gym_S", 20 ],
            [ "5x5_dojo", 20 ],
            [ "5x5_gym_W", 20 ]
          ],
          "x": 1,
          "y": 18
        },
        {
          "chunks": [
            [ "livingroom_5x5_N_1", 10 ],
            [ "livingroom_5x5_S_1", 10 ],
            [ "livingroom_5x5_W_1", 10 ],
            [ "livingroom_5x5_N_2", 10 ],
            [ "livingroom_5x5_S_2", 10 ],
            [ "livingroom_5x5_E_2", 10 ],
            [ "livingroom_5x5_W_2", 10 ]
          ],
          "x": 18,
          "y": 1
        }
      ]
    }
  }
]
