[
  {
    "type": "mapgen",
    "method": "json",
    "om_terrain": [ [ "miniaturerailway_0_0_1", "miniaturerailway_1_0_1" ], [ "miniaturerailway_0_1_1", "miniaturerailway_1_1_1" ] ],
    "object": {
      "fill_ter": "t_grass",
      "rows": [
        "::::::::::::::::::::::::::::::::::::::::::::::::",
        "::::::::::::::::::::::::::::::::::::::::::::::::",
        "::::::::::::::::::::::::::::::::::::::::::::::::",
        "::::::::::::::::::::::::::::::::::::::::::::::::",
        "::::::::::::::::::::::::::::::::::::::::::::::::",
        "::::::::::::::::::::::::::::::::::::::::::::::::",
        "::::::::::::::::::::::::::::::::::::::::::::::::",
        "::::::::::::::::::::::::::::::::::::::::::::::::",
        "::::::::::::::::::::::::::::::::::::::::::::::::",
        "::::::::::::::::::::::::::::::::::::::::::::::::",
        "::::::::::::::::::::::::::::::::::::::::::::::::",
        "::::::::::::::::::::::::::::::::::::::::::::::::",
        "::::::::::::::::::::::::::::::::::::::::::::::::",
        "::::::::::::::::::::::::::::::::::::::::::::::::",
        "::::::::::::::::::::::::::::::::::::::::::::::::",
        "::::::::::::::::::::::::::::::::::::::::::::::::",
        "::::::::::::::::::::::::::::::::::::::::::::::::",
        "::::::::::::::::::::::::::::::::::::::::::::::::",
        ":::::::::::::::::::::::::::::::::rrrrrrrrrrrrrr:",
        ":::::::::::::::::::::::::::::::::rrrrrrrrrrrrrr:",
        ":::::::::::::::::::::::::::::::::rrrrrrrrrrrrrr:",
        ":::::::::::::::::::::::::::::::::rrrrrrrrrrrrrr:",
        ":::::::::::::::::::::::::::::::::rrrrrrrrrrrrrr:",
        ":::::::::::::::::::::::::::::::::rrrrrrrrrrrrrr:",
        "::::::::::::::::::::::::::::::::::::::::::::::::",
        "::::::::::::::::::::::::::::::::::::::::::::::::",
        "::::::::::::::::::::::::::::::::::::::::::::::::",
        "::::::::::::::::::::::::::::::::::::::::::::::::",
        "::::::::::::::::::::::::::::::::::::::::::::::::",
        "::::::::::::::::::::::::::::::::::::::::::::::::",
        "::::::::::::::::::::::::::::::::::::::::::::::::",
        "::::::::::::::::::::::::::::::::::::::::::::::::",
        "::::::::::::::::::::::::::::::::::::::::::::::::",
        "::::::::::::::::::::::::::::::::::::::::::::::::",
        ":::::::::::::::::::::::::::::::::::::::rrrrrr:::",
        ":::::::::::::::::::::::::::::::::::::::rrrrrr:::",
        ":::::::::::::::::::::::::::::::::::::::rrrrrr:::",
        ":::::::::::::::::::::::::::::::::::::::rrrrrr:::",
        ":::::::::::::::::::::::::::::::::::::::rrrrrr:::",
        ":::::::::::::::::::::::::::::::::::::::rrrrrr:::",
        ":::::::::::::::::::::::::::::::::::::::rrrrrr:::",
        ":::::::::::::::::::::::::::::::::::::::rrrrrr:::",
        ":::::::::::::::::::::::::::::::::::::::rrrrrr:::",
        ":::::::::::::::::::::::::::::::::::::::rrrrrr:::",
        ":::::::::::::::::::::::::::::::::::::::rrrrrr:::",
        "::::::::::::::::::::::::::::::::::::::::::::::::",
        "::::::::::::::::::::::::::::::::::::::::::::::::",
        "::::::::::::::::::::::::::::::::::::::::::::::::"
      ],
      "terrain": {  },
      "furniture": {  },
      "palettes": [ "miniature_railway_palette" ]
    }
  }
]
