[
  {
    "type": "mapgen",
    "method": "json",
    "om_terrain": [ [ "miniaturerailway_0_0_0", "miniaturerailway_1_0_0" ], [ "miniaturerailway_0_1_0", "miniaturerailway_1_1_0" ] ],
    "object": {
      "fill_ter": "t_grass",
      "rows": [
        ".@@@@@@@@@@@@@@@@@@@@@@@@@@@@@@@@@@@@@@@@@@@@@@.",
        ".@@@@@@@@@@@@@@@@@@@@@@@@@@@@@@@@@@@@@@@@@@@@@@.",
        ".@@@@@@@@@@@@@@@@@@@@@@@@@@@@@@@@@@@@@@@@@@@@@@.",
        ".@@@@@@@@@@@@@@@@@@@@@@@@@@@@@@@@@@@@@@@@@@@@@@.",
        ".@@@@@@@@@@@@@@@@@@@@@@@@@@@@@@@@@@@@@@@@@@@@@@.",
        ".@@@@@@@@@@@@@@@@@@@@@@@@@@@@@@@@@@@@@@@@@@@@@@.",
        ".@@@@@@@@@@@@@@@@@@@@@@@@@@@@@@@@@@@@@@@@@@@@@@.",
        ".@@@@@@@@@@@@@@@@@@@@@@@@@@@@@@@@@@@@@@@@@@@@@@.",
        ".@@@@@@@@@@@@@@@@@@@@@@@@@@@@@@@@@@@@@@@@@@@@@@.",
        ".@@@@@`@@@@`@@@@`@@@@`@@@@`@@@@`@@@@`@pppppppp@.",
        ".@@@@@`@@@@`@@@@`@@@@`@@@@`@@@@`@@@@`@pppppppp@.",
        ".@@@@@`@@@@`@@@@`@@@@`@@@@`@@@@`@@@@`@pppppppp@.",
        ".@@@@@`@@@@`@@@@`@@@@`@@@@`@@@@`@@@@`@pppppppp@.",
        ".@@@@@`@@@@`@@@@`@@@@`@@@@`@@@@`@@@@`@pppppppp@.",
        ".@@@@@`@@@@`@@@@`@@@@`@@@@`@@@@`@@@@`@pppppppp@.",
        ".@@@@@`@@@@`@@@@`@@@@`@@@@`@@@@`@@@@`@pppppppp@.",
        ".@@@@@`@@@@`@@@@`@@@@`@@@@`@@@@`@@@@`@pppppppp@.",
        ".pppppppppppppppppppppppppppppppppppppppppppppp.",
        ".%%%%%%%%%%%%%%%%%%%%%%%%%%%%%%%%HHHHHHHH__HHHH.",
        ".%uuuuu.............uuuuuuuuuuu..HtHtHD||||H7|H.",
        ".%uu....X======X....uuuuuuuuuuu..H|H|HV||||*dhH.",
        ".%uuu..XX.uuuu.XX...uuuuuuuuuuu..H_H_H|||||H||H.",
        ".%uuu.XX.uuuuuu.XX..uuuuuuuuuuu..H|||||||||_||H.",
        ".%uuuXX.uuuuuuuu.=..uuuuuuuuuuu..HHHHHHHH__HHHH.",
        ".%uuu=..uuuuuuu..=........................p.uu%.",
        ".%uuu=..uuuuuuu..=........................p.uu%.",
        ".%uuu=.uuuuuuuu..=...pppppppp.............p.uu%.",
        ".%uuu=.uuuuuuuu.XX...pWWppWWp.............p.uu%.",
        ".%uuu=.uuuuuuu.XX....pppppppp.............p.uu%.",
        ".%uuu=.uuuuuu.XX.....pWWppWWppppppppppppppp.uu%.",
        ".%uuu=.uuuuuu.=......pppppppp.............p.uu%.",
        ".%uuu=.uuuuuu.=.........p.................p.uu%.",
        ".%uuu=.uuuuuu.XX........p................=p.uu%.",
        ".%uuu=.uuuuuu..XX..ppppppppppppppp.......=p.uu%.",
        ".%uuu=.uuuuuuu..X==================X...5|=||5.%.",
        ".%uuu=..uuuuuuuu...ppppppppppppppp.XX..5|=||5.%.",
        ".%uuu=.uuuuuuuuuu.......p.uuuuuuuu..XX.5|=||5.%.",
        ".%uuu=.uuuuuuuuuuuu.....p.uuuuuuuuu..=.5|=||5.%.",
        ".%uuu=.uuuuuuuuuuuuu....p.uuuuuuuuu..=.5|=||5.%.",
        ".%uuu=.......ww.........p....ww......=.5|=|l5.%.",
        ".%uuuXX.....pppppppppppppppppppp....XX.5|=|s5.%.",
        ".%uuu.XX.....ww..............ww....XX..5|=|s5.%.",
        ".%uuuu.XX...uuuuuuuuuuuuuuuuuu....XX...5|=|l5.%.",
        ".%uuuuu.XX..uuuuuuuuuuuuuuuuuu...XX....5|=||5.%.",
        ".%uuuuu..X=======================X.....555555.%.",
        ".%uuuuuu..............................uuuuuuu.%.",
        ".%%%%%%%%%%%%%%%%%%%%%%%%%%%%%%%%%%%%%%%%%%%%%%.",
        "................................................"
      ],
      "terrain": {  },
      "furniture": {  },
      "palettes": [ "miniature_railway_palette" ],
      "place_monsters": [
        { "monster": "GROUP_SCHOOL", "x": [ 35, 40 ], "y": [ 10, 15 ], "repeat": [ 0, 1 ], "density": 1 },
        { "monster": "GROUP_SCHOOL", "x": [ 35, 40 ], "y": [ 35, 40 ], "repeat": [ 0, 1 ], "density": 1 }
      ],
      "place_vehicles": [
        { "vehicle": "miniature_train_loco", "x": 5, "y": 31, "chance": 5, "fuel": 20, "status": 25, "rotation": 270 },
        { "vehicle": "miniature_train_loco", "x": 41, "y": 41, "chance": 5, "fuel": 5, "status": 15, "rotation": 270 }
      ]
    }
  },
  {
    "type": "mapgen",
    "method": "json",
    "om_terrain": [ [ "miniaturerailway_0_0_1", "miniaturerailway_1_0_1" ], [ "miniaturerailway_0_1_1", "miniaturerailway_1_1_1" ] ],
    "object": {
      "fill_ter": "t_grass",
      "rows": [
        "::::::::::::::::::::::::::::::::::::::::::::::::",
        "::::::::::::::::::::::::::::::::::::::::::::::::",
        "::::::::::::::::::::::::::::::::::::::::::::::::",
        "::::::::::::::::::::::::::::::::::::::::::::::::",
        "::::::::::::::::::::::::::::::::::::::::::::::::",
        "::::::::::::::::::::::::::::::::::::::::::::::::",
        "::::::::::::::::::::::::::::::::::::::::::::::::",
        "::::::::::::::::::::::::::::::::::::::::::::::::",
        "::::::::::::::::::::::::::::::::::::::::::::::::",
        "::::::::::::::::::::::::::::::::::::::::::::::::",
        "::::::::::::::::::::::::::::::::::::::::::::::::",
        "::::::::::::::::::::::::::::::::::::::::::::::::",
        "::::::::::::::::::::::::::::::::::::::::::::::::",
        "::::::::::::::::::::::::::::::::::::::::::::::::",
        "::::::::::::::::::::::::::::::::::::::::::::::::",
        "::::::::::::::::::::::::::::::::::::::::::::::::",
        "::::::::::::::::::::::::::::::::::::::::::::::::",
        "::::::::::::::::::::::::::::::::::::::::::::::::",
        ":::::::::::::::::::::::::::::::::rrrrrrrrrrrrrr:",
        ":::::::::::::::::::::::::::::::::rrrrrrrrrrrrrr:",
        ":::::::::::::::::::::::::::::::::rrrrrrrrrrrrrr:",
        ":::::::::::::::::::::::::::::::::rrrrrrrrrrrrrr:",
        ":::::::::::::::::::::::::::::::::rrrrrrrrrrrrrr:",
        ":::::::::::::::::::::::::::::::::rrrrrrrrrrrrrr:",
        "::::::::::::::::::::::::::::::::::::::::::::::::",
        "::::::::::::::::::::::::::::::::::::::::::::::::",
        "::::::::::::::::::::::::::::::::::::::::::::::::",
        "::::::::::::::::::::::::::::::::::::::::::::::::",
        "::::::::::::::::::::::::::::::::::::::::::::::::",
        "::::::::::::::::::::::::::::::::::::::::::::::::",
        "::::::::::::::::::::::::::::::::::::::::::::::::",
        "::::::::::::::::::::::::::::::::::::::::::::::::",
        "::::::::::::::::::::::::::::::::::::::::::::::::",
        "::::::::::::::::::::::::::::::::::::::::::::::::",
        ":::::::::::::::::::::::::::::::::::::::rrrrrr:::",
        ":::::::::::::::::::::::::::::::::::::::rrrrrr:::",
        ":::::::::::::::::::::::::::::::::::::::rrrrrr:::",
        ":::::::::::::::::::::::::::::::::::::::rrrrrr:::",
        ":::::::::::::::::::::::::::::::::::::::rrrrrr:::",
        ":::::::::::::::::::::::::::::::::::::::rrrrrr:::",
        ":::::::::::::::::::::::::::::::::::::::rrrrrr:::",
        ":::::::::::::::::::::::::::::::::::::::rrrrrr:::",
        ":::::::::::::::::::::::::::::::::::::::rrrrrr:::",
        ":::::::::::::::::::::::::::::::::::::::rrrrrr:::",
        ":::::::::::::::::::::::::::::::::::::::rrrrrr:::",
        "::::::::::::::::::::::::::::::::::::::::::::::::",
        "::::::::::::::::::::::::::::::::::::::::::::::::",
        "::::::::::::::::::::::::::::::::::::::::::::::::"
      ],
      "terrain": {  },
      "furniture": {  },
      "palettes": [ "miniature_railway_palette" ]
    }
  },
  {
    "type": "mapgen",
    "method": "json",
    "om_terrain": [
      [ "luna_park_0_0_0", "luna_park_1_0_0", "luna_park_2_0_0" ],
      [ "luna_park_0_1_0", "luna_park_1_1_0", "luna_park_2_1_0" ]
    ],
    "object": {
      "fill_ter": "t_sidewalk",
      "rows": [
        ".@@@@@@@@@@@@@@@@@@@@@@@@@@@@@@@@@@@@@@@@@@@@@@@@@@@@@@@@@@@@@@@@@@@@@@.",
        ".@@@@@@@@@@@@@@@@@@@@@@@@@@@@@@@@@@@@@@@@@@@@@@@@@@@@@@@@@@@@@@@@@@@@@@.",
        ".@@@@@@@@@@@@@@@@@@@@@@@@@@@@@@@@@@@@@@@@@@@@@@@@@@@@@@@@@@@@@@@@@@@@@@.",
        ".@@@@@@@@@@@@@@@@@@@@@@@@@@@@@@@@@@@@@@@@@@@@@@@@@@@@@@@@@@@@@@@@@@@@@@.",
        ".@@@@@@@@@@@@@@@@@@@@@@@@@@@@@@@@@@@@@@@@@@@@@@@@@@@@@@@@@@@@@@@@@@@@@@.",
        ".@@@@@@@@@@@@@@@@@@@@@@@@@@@@@@@@@@@@@@@@@@@@@@@@@@@@@@@@@@@@@@@@@@@@@@.",
        ".pppppppppppppppppppppppppppppppppppppppppppppppppppppppppppppppppppppp.",
        ".%%%%%%%%%%%%%%HHHHHH_HHHHHH%%%%%%%%%%%%%%%%%%%%%%%%%%%%%%%%%%%%%%%%%%%.",
        ".%uuuuuuuuuuuuuH||hC|||||||Huuuuuuuuuuuuuuuuuuuuuuuuuuuuuuuuuuuuuuuuuu%.",
        ".%uu###..bbb..uH|CCC|||H_H_Huu..X================================X....%.",
        ".%uupppppppppppH|||||||H|H|Huu.XXuuuuuuuuuuuuuuuuuuuuuuuuuuuuuuuuXX...%.",
        ".%uu###..bbbuupH|DV||||HtHtHuuXX.uuuuuuuuuuuuuuuuuuuuuuuuuuuuuuuu.XX..%.",
        ".%uuuuuuuuuuuupHHHHHH_HHHHHHuu=..uuuuuuuuuuuuuuuuuuuuuuuuuuuuuuuu..=..%.",
        ".%uuLLL..bbbuBpppppppppppppppp=..uuuuuuuuuuuuuuuuuuuuuuuuuuuuuuuu..=..%.",
        ".%uuLLLppppppppppppppppppppppp=pppppppppppppppppppppppp....uuuuuu..=..%.",
        ".%uuLLL..bbbuBpppppppppppppppp=uuu..X===================X..uuuuuu..=..%.",
        ".%uuuuuuuuuuuupuuuuuuuuuuuu%..=uuu.XXpppppppppppppppppp.XX.uuuuuu..=..%.",
        ".%uuLLL..bbbuup..bbb..MMMuu%..=uuuXX.p...ppppppppppp.....XXuuuuuu..=..%.",
        ".%uuLLLpppppppppppppppMMMuu%..=uuu=..p...~~~~~!~~~~~...uuu=uuuuuu..=..%.",
        ".%uuLLL..bbbuup..bbb..MMMuu%..=uuu=..p..~~~~~~!~~~~~~..uuu=uuuuuu..=..%.",
        ".%uuuuuuuuuuuupuuuuuuuuuuuu%.XXuuu=..p.~~~~~~~!~~~~~~~.uuu=uuuuuu..=..%.",
        ".%%%%%%%%%%%%%%%%%%%%%%%%%%%XX.uuu=..p~~~~~~~~!~~~~~~~~uuu=uuuuuu..=..%.",
        ".%uuuuuuuuu..X==============X..uuu=..p~~~~~!!!!!!!~~~~~~uu=uuuuuu..=..%.",
        ".%uuuuuuuuu.XXuuuuuuuuuuuuuuuuuuuu=..p~~~~~~~~~~~~~~~~~~~u=uuuuuu.XX..%.",
        ".%uuuuuuuuuXX.uuuuuu..TTTTTTTTTTTT=..p~~~~~~~~~~~~~~~~~~~u=uuuuuuXXuuu%.",
        ".%uuuuuuuuu=..uuuuuu.TTX=========================================X.uuu%.",
        ".%uuuuuuuuu=..uuuuuuTTXXTTTTTTTTTT=..p~~~~~~~~~~~~~~~~~~~u=uuuuuuuuuuu%.",
        ".%uuuuuuuuu=..uuuuuuTXXTTuuuuuuuuu=..p~~~~~~~~~~~~~~~~~~~u=uuuuuuuuuuu%.",
        ".%uuuuuuuuu=..uuuuuuT=TTuuuuuuuuuu=..p~~~~~~~~~~~~~~~~~~uu=uuuuuuuuuuu%.",
        ".%uuuuuuuuu=..uuuuuuT=Tuuuuuuuuuuu=..p~~~~~~~~~~~~~~~~~uuu=uuuuuuuuuuu%.",
        ".%uuuuuuuuu=..uuuuuuT=Tuuuuuuuuuuu=..p~~~~~~~~~~~~~~~~~uuu=uuuuuuuuuuu%.",
        ".%uuuuuuuuu=..uuuuuuT=TTuuuuuuuuuu=..p.~~~~~~~~~~~~~~~.uuu=uuuuuuuuuuu%.",
        ".%uuuuuuuuu=..uuuuuuTXXTTuuuuuuuuu=..p..~~~~~~~~~~~~~....XXuuuuuuuuuuu%.",
        ".%uuuuuuuuu=..uuuuuuTTXXTTTTTTTTTT=..p...~~~~~~~~~~~....XX.uuuuuuuuuuu%.",
        ".%uuuuuu..XX..uuuuuu.TTX================================X..uuuuuuuuuuu%.",
        ".%uuuuuu.XXuuuuuuuuu..TTTTTTTTTTTT=..puuuuuuuuuuuuuuuuuuuuuuuuuuuuuuuu%.",
        ".%uuuuuuXX.uuuuuuuuuuuuuuuuuuuuuuuX..puuuuuuuuuuuuuuuuuuuuuuuuuuuuuuuu%.",
        ".%uuu..XX..uuuuuuuuuuuuuuuuuuuuuuuXX.puuuuuuuuuuuuuuuuuuuuuuuuuuuuuuuu%.",
        ".%uuu.XXuuuuuuuuuuuuuuuuuuuuuuuuuu.X=========================X..uuuuuu%.",
        ".%uuuXX.uuuuuuuuuuuu5555555555555....p......uuuuuuuuuuuuuuuuuXX.uuuuuu%.",
        ".%uuu=..uuuuuuuuuuuu5|||lssl||||5....p......uuuuuuuuuuuuuuuuu.XXuuuuuu%.",
        ".%uuu=..uuuuuuuuuuuu5|||||||||||ppppppppppp.uuuuuuuuuuuuuuuuu..=uuuuuu%.",
        ".%uuuX..uuuuuuuuuuuu5=============*****==Xppuuuuuuuuuuuuuuuuu..=uuuuuu%.",
        ".%uuuXX.uuuuuuuuuuuu5|||||||||||5uuuuuuuuXXpuuuuuuuuuuuuuuuuu.XXuuuuuu%.",
        ".%uuu.XXuuuuuuuuuuuu5555555555555uuuuuuuu.X1uuuuuuuuuuuuuuuuuXX.uuuuuu%.",
        ".%uuu..X============================*========================X..uuuuuu%.",
        ".%%%%%%%%%%%%%%%%%%%%%%%%%%%%%%%%%%%%%%%%%%%%%%%%%%%%%%%%%%%%%%%%%%%%%%.",
        "........................................................................"
      ],
      "terrain": {
        "~": [ "t_water_sh" ],
        "!": [ "t_dock" ],
        "1": [ "t_gates_control_metal" ],
        "T": [ "t_tree", "t_tree_walnut", "t_tree_chestnut", "t_tree_beech", "t_tree_hazelnut", "t_tree_cottonwood", "t_tree_elm" ],
        "L": [ "t_sandbox" ],
        "M": [ "t_monkey_bars" ],
        "#": [ "t_slide" ],
        "*": [ "t_railroad_track_small" ]
      },
      "furniture": { "b": [ "f_bench" ], "B": [ "f_birdbath" ], "C": [ "f_counter" ] },
      "monsters": { "u": { "monster": "GROUP_SCHOOL", "chance": 1, "density": 0.001 } },
      "item": { "*": { "item": "talking_doll", "chance": 100 } },
      "place_vehicles": [
        { "vehicle": "miniature_train_loco", "x": 50, "y": 45, "chance": 100, "fuel": 20, "status": 25, "rotation": 180 },
        {
          "vehicle": "miniature_train_loco",
          "x": 30,
          "y": 14,
          "chance": 100,
          "fuel": 5,
          "status": 15,
          "rotation": 270
        }
      ],
      "palettes": [ "miniature_railway_palette" ]
    }
  },
  {
    "type": "mapgen",
    "method": "json",
    "om_terrain": [
      [ "luna_park_0_0_1", "luna_park_1_0_1", "luna_park_2_0_1" ],
      [ "luna_park_0_1_1", "luna_park_1_1_1", "luna_park_2_1_1" ]
    ],
    "object": {
      "fill_ter": "t_open_air",
      "rows": [
        "                                                                        ",
        "                                                                        ",
        "                                                                        ",
        "                                                                        ",
        "                                                                        ",
        "                                                                        ",
        "                                                                        ",
        "               rrrrrrrrrrrrr                                            ",
        "               rrrrrrrrrrrrr                                            ",
        "               rrrrrrrrrrrrr                                            ",
        "               rrrrrrrrrrrrr                                            ",
        "               rrrrrrrrrrrrr                                            ",
        "                                                                        ",
        "                                                                        ",
        "                                                                        ",
        "                                                                        ",
        "                                                                        ",
        "                                                                        ",
        "                                                                        ",
        "                                                                        ",
        "                                                                        ",
        "                                                                        ",
        "                                                                        ",
        "                                                                        ",
        "                                                                        ",
        "                                                                        ",
        "                                                                        ",
        "                                                                        ",
        "                                                                        ",
        "                                                                        ",
        "                                                                        ",
        "                                                                        ",
        "                                                                        ",
        "                                                                        ",
        "                                                                        ",
        "                                                                        ",
        "                                                                        ",
        "                                                                        ",
        "                                                                        ",
        "                    rrrrrrrrrrrrr                                       ",
        "                    rrrrrrrrrrrrr                                       ",
        "                    rrrrrrrrrrrrr                                       ",
        "                    rrrrrrrrrrrrr                                       ",
        "                    rrrrrrrrrrrrr                                       ",
        "                    rrrrrrrrrrrrr                                       ",
        "                                                                        ",
        "                                                                        ",
        "                                                                        "
      ],
      "terrain": {  },
      "furniture": {  },
      "palettes": [ "miniature_railway_palette" ]
    }
  }
]
