[
  {
    "type": "mapgen",
    "om_terrain": "ruined_tower_basement",
    "object": {
      "rows": [
        ",,,,,,,,,,,,,,,,,,,,,,,,",
        ",,,,,,,,,,,,,,,,,,,,,,,,",
        ",,,,,,,,,,,,,,,,,,,,,,,,",
        ",,,,,,,,,,,,,,,,,,,,,,,,",
        ",,,,,,,,,,,,,,,,,,,,,,,,",
        ",,,,,,,,,,,,,,,,,,,,,,,,",
        ",,,,,,,,,,,,,,,,,,,,,,,,",
        ",,,,,,,,,######,,,,,,,,,",
        ",,,,,,,,##    ##,,,,,,,,",
        ",,,,,,,##      ##,,,,,,,",
        ",,,,,,,#        #,,,,,,,",
        ",,,,,,,#   ##   #,,,,,,,",
        ",,,,,,,#   ##   #,,,,,,,",
        ",,,,,,,#   <<   #,,,,,,,",
        ",,,,,,,##      ##,,,,,,,",
        ",,,,,,,,##    ##,,,,,,,,",
        ",,,,,,,,,######,,,,,,,,,",
        ",,,,,,,,,,,,,,,,,,,,,,,,",
        ",,,,,,,,,,,,,,,,,,,,,,,,",
        ",,,,,,,,,,,,,,,,,,,,,,,,",
        ",,,,,,,,,,,,,,,,,,,,,,,,",
        ",,,,,,,,,,,,,,,,,,,,,,,,",
        ",,,,,,,,,,,,,,,,,,,,,,,,",
        ",,,,,,,,,,,,,,,,,,,,,,,,"
      ],
      "terrain": { ",": "t_soil", " ": "t_stone_masonry_floor", "<": "t_stairs_up", "#": "t_rock_wall" },
      "place_item": [
        { "item": "wooden_barrel_rotten", "x": 10, "y": 8, "chance": 100 },
        { "item": "wooden_barrel_rotten", "x": 11, "y": 8, "chance": 100 },
        { "item": "wooden_barrel_rotten", "x": 12, "y": 8, "chance": 100 },
        { "item": "wooden_barrel_rotten", "x": 9, "y": 9, "chance": 100 },
        { "item": "wooden_barrel_rotten", "x": 10, "y": 9, "chance": 100 }
      ],
      "place_fields": [ { "field": "fd_dust", "x": [ 8, 15 ], "y": [ 8, 15 ], "repeat": [ 10, 20 ] } ]
    }
  },
  {
    "type": "mapgen",
    "om_terrain": "ruined_tower_ground",
    "object": {
      "rows": [
        ",,,,,,,,,,,,,,,,,,,,,,,,",
        ",,,,,,,,,,,,,,,,,,,,,,,,",
        ",,,,,,,,,,,,,,,,,,,,,,,,",
        ",,,,,,,,,,,,,,,,,,,,,,,,",
        ",,,,,,,,,,,,,,,,,,,,,,,,",
        ",,,,,,,,,,,,,,,,,,,,,,,,",
        ",,,,,,,,,,,,,,,,,,,,,,,,",
        ",,,,,,,,,######,,,,,,,,,",
        ",,,,,,,,##    ##,,,,,,,,",
        ",,,,,,,##      ##,,,,,,,",
        ",,,,,,,#   <<   #,,,,,,,",
        ",,,,,,,+   ##   #,,,,,,,",
        ",,,,,,,+   ##   #,,,,,,,",
        ",,,,,,,#   >>   #,,,,,,,",
        ",,,,,,,##      ##,,,,,,,",
        ",,,,,,,,##    ##,,,,,,,,",
        ",,,,,,,,,######,,,,,,,,,",
        ",,,,,,,,,,,,,,,,,,,,,,,,",
        ",,,,,,,,,,,,,,,,,,,,,,,,",
        ",,,,,,,,,,,,,,,,,,,,,,,,",
        ",,,,,,,,,,,,,,,,,,,,,,,,",
        ",,,,,,,,,,,,,,,,,,,,,,,,",
        ",,,,,,,,,,,,,,,,,,,,,,,,",
        ",,,,,,,,,,,,,,,,,,,,,,,,"
      ],
      "terrain": {
        ",": [ [ "t_region_groundcover", 50 ], [ "t_region_groundcover_forest", 5 ], "t_region_shrub", "t_region_tree" ],
        " ": [ [ "t_floor_rotted", 7 ], [ "t_open_air", 1 ] ],
        "<": "t_stairs_up",
        ">": "t_stairs_down",
        "+": "t_door_b",
        "#": "t_rock_wall"
      }
    }
  },
  {
    "type": "mapgen",
    "om_terrain": "ruined_tower_z1",
    "object": {
      "fill_ter": "t_open_air",
      "rows": [
        "                        ",
        "                        ",
        "                        ",
        "                        ",
        "                        ",
        "                        ",
        "                        ",
        "         ##ww##         ",
        "        ##    ##        ",
        "       ##  ..  ##       ",
        "       #  .>>.  #       ",
        "       w  .##...w       ",
        "       w  .##.,.w       ",
        "       #   .., ,#       ",
        "       ##  ,,  ##       ",
        "        ##.<<.##        ",
        "         ##ww##         ",
        "                        ",
        "                        ",
        "                        ",
        "                        ",
        "                        ",
        "                        ",
        "                        "
      ],
      "terrain": {
        ".": [ [ "t_floor_rotted", 10 ], [ "t_open_air", 1 ] ],
        ",": [ [ "t_floor_rotted", 3 ], [ "t_open_air", 1 ] ],
        "w": "t_embrasure_rock",
        "<": "t_stairs_up",
        ">": "t_stairs_down",
        "#": [ [ "t_rock_wall", 20 ], [ "t_rock_wall_half", 1 ] ]
      }
    }
  },
  {
    "type": "mapgen",
    "om_terrain": "ruined_tower_z2",
    "object": {
      "fill_ter": "t_open_air",
      "rows": [
        "                        ",
        "                        ",
        "                        ",
        "                        ",
        "                        ",
        "                        ",
        "                        ",
        "         ######         ",
        "        ## << ##        ",
        "       ##  ,,  ##       ",
        "       #   ,,,,.#       ",
        "       #  .##.,.#       ",
        "       #  .##.,.#       ",
        "       #   ,,,  #       ",
        "       ##  ,,  ##       ",
        "        ##.>>.##        ",
        "         ######         ",
        "                        ",
        "                        ",
        "                        ",
        "                        ",
        "                        ",
        "                        ",
        "                        "
      ],
      "terrain": {
        ".": [ [ "t_floor_rotted", 10 ], [ "t_open_air", 1 ] ],
        ",": [ [ "t_floor_rotted", 2 ], [ "t_open_air", 1 ] ],
        "w": "t_embrasure_rock",
        "<": "t_stairs_up",
        ">": "t_stairs_down",
        "#": [ [ "t_rock_wall", 10 ], [ "t_rock_wall_half", 1 ] ]
      }
    }
  },
  {
    "type": "mapgen",
    "om_terrain": "ruined_tower_z3",
    "object": {
      "fill_ter": "t_open_air",
      "rows": [
        "                        ",
        "                        ",
        "                        ",
        "                        ",
        "                        ",
        "                        ",
        "                        ",
        "         ##ww##         ",
        "        ##.>>.##        ",
        "       ##  ..  ##       ",
        "       #    , ,.#       ",
        "       w   ##. .w       ",
        "       w   ##.,.w       ",
        "       #   , ,  #       ",
        "       ##  ,,  ##       ",
        "        ##.<<.##        ",
        "         ##ww##         ",
        "                        ",
        "                        ",
        "                        ",
        "                        ",
        "                        ",
        "                        ",
        "                        "
      ],
      "terrain": {
        ".": [ [ "t_floor_rotted", 10 ], [ "t_open_air", 1 ] ],
        ",": [ [ "t_floor_rotted", 2 ], [ "t_open_air", 1 ] ],
        "w": "t_embrasure_rock",
        "<": "t_stairs_up",
        ">": "t_stairs_down",
        "#": [ [ "t_rock_wall", 5 ], [ "t_rock_wall_half", 1 ] ]
      }
    }
  },
  {
    "type": "mapgen",
    "om_terrain": "ruined_tower_z4",
    "object": {
      "fill_ter": "t_open_air",
      "rows": [
        "                        ",
        "                        ",
        "                        ",
        "                        ",
        "                        ",
        "                        ",
        "                        ",
        "         ######         ",
        "        ##.<<.##        ",
        "       ##  ..  ##       ",
        "       #    , ,.#       ",
        "       #   ##. .#       ",
        "       #   ##.,.#       ",
        "       #   , ,  #       ",
        "       ##  ,,  ##       ",
        "        ##.>> ##        ",
        "         ######         ",
        "                        ",
        "                        ",
        "                        ",
        "                        ",
        "                        ",
        "                        ",
        "                        "
      ],
      "terrain": {
        ".": [ [ "t_floor_rotted", 5 ], [ "t_open_air", 1 ] ],
        ",": [ [ "t_floor_rotted", 2 ], [ "t_open_air", 1 ] ],
        "w": "t_embrasure_rock",
        "<": "t_stairs_up",
        ">": "t_stairs_down",
        "#": [ [ "t_rock_wall", 10 ], [ "t_rock_wall_half", 3 ], [ "t_open_air", 1 ] ]
      }
    }
  },
  {
    "type": "mapgen",
    "om_terrain": "ruined_tower_z5",
    "object": {
      "fill_ter": "t_open_air",
      "rows": [
        "                        ",
        "                        ",
        "                        ",
        "                        ",
        "                        ",
        "                        ",
        "                        ",
        "         ##ww##         ",
        "        ##.>>.##        ",
        "       ##  ..  ##       ",
        "       #    , ,.#       ",
        "       w   ##. .w       ",
        "       w  ,##.,.w       ",
        "       #   , ,  #       ",
        "       ##  ,,  ##       ",
        "        ##.   ##        ",
        "         ##ww##         ",
        "                        ",
        "                        ",
        "                        ",
        "                        ",
        "                        ",
        "                        ",
        "                        "
      ],
      "terrain": {
        ".": [ [ "t_floor_rotted", 2 ], [ "t_open_air", 1 ] ],
        ",": [ [ "t_floor_rotted", 1 ], [ "t_open_air", 1 ] ],
        "w": "t_window_empty_stone",
        ">": "t_stairs_down",
        "#": [ [ "t_rock_wall", 2 ], [ "t_rock_wall_half", 4 ], [ "t_open_air", 1 ] ]
      }
    }
  }
]
