[
  {
    "type": "mapgen",
    "om_terrain": [
      [ "phavan_office_skyscraper_lab_lower_nw", "phavan_office_skyscraper_lab_lower_ne" ],
      [ "phavan_office_skyscraper_lab_lower_sw", "phavan_office_skyscraper_lab_lower_se" ]
    ],
    "method": "json",
    "weight": 250,
    "object": {
      "fill_ter": "t_linoleum_white",
      "rows": [
        "                                                ",
        "                                                ",
        "                                                ",
        "                                                ",
        "   |-HHH-HHH-HHH--HHH--HH--HHH--HHH-HHH-HHH-|   ",
        "   |........|........|....|........|........|   ",
        "   V........|........|....|........|........V   ",
        "   V........|........|....|........|........V   ",
        "   V........|........|....|........|........V   ",
        "   |........|........|....|........|........|   ",
        "   V........|........|....|........|........V   ",
        "   V........|........|....|........|........V   ",
        "   V........|........|....|........|........V   ",
        "   |-----GG-|-----GG-|-GG-|-GG-----|-GG-----|   ",
        "   V....|..............................|....V   ",
        "   V....|..............................|....V   ",
        "   V....|..............................|....V   ",
        "   |....|...|--|-|-|--¥!!---|-|-|--|...|....|   ",
        "   |----|...|SS|T|T|^......^|T|T|SS|...|----V   ",
        "   V....|...+..|+|+|^......^|+|+|..+...|....V   ",
        "   V....|...|......|^......^|......|...|....V   ",
        "   |....|...|---|--||......||--|---|...|....|   ",
        "   |....|...|<R>|EEE|......|xEE|<R>|...|....|   ",
        "   |----|...|'R'|EEED......DEEE|'R'|...|----|   ",
        "   V....|...¥'''|EEED......DEEE|'''¥...|....V   ",
        "   V....|...!'''|EEx|......|EEE|'''!...|....V   ",
        "   |....|...|---|-|-|------|-|-|---|...|....|   ",
        "   V....|..............................|....V   ",
        "   |----|..............................|----|   ",
        "   V....|..............................|....V   ",
        "   |....|..............................|....|   ",
        "   V....|..............................|....V   ",
        "   V....|..............................|....V   ",
        "   |-----GG--------GG------GG--------GG-----V   ",
        "   V.........|.........||.........|.........V   ",
        "   |.........|.........||.........|.........|   ",
        "   V.........|.........||.........|.........V   ",
        "   V.........|.........||.........|.........V   ",
        "   V.........|.........||.........|.........V   ",
        "   |.........|.........||.........|.........|   ",
        "   V.........|.........||.........|.........V   ",
        "   V.........|.........||.........|.........V   ",
        "   V.........|.........||.........|.........V   ",
        "   |-HHH-HHHH-HHH-|-HHHHHHHH-|-HHH-HHHH-HHH-|   ",
        "                                                ",
        "                                                ",
        "                                                ",
        "                                                "
      ],
      "terrain": {  },
      "palettes": [ "phavian_skyscraper_office_palette" ],
      "place_nested": [
        { "chunks": [ "phavian_skyscraper_lab_lrdoor_north" ], "x": 4, "y": 5 },
        { "chunks": [ "phavian_skyscraper_lab_lrdoor_north" ], "x": 13, "y": 5 },
        { "chunks": [ "phavian_skyscraper_lab_lldoor_north" ], "x": 27, "y": 5 },
        { "chunks": [ "phavian_skyscraper_lab_lldoor_north" ], "x": 36, "y": 5 }
      ]
    }
  },
  {
    "type": "mapgen",
    "om_terrain": [
      [ "phavan_office_skyscraper_lab_upper_nw", "phavan_office_skyscraper_lab_upper_ne" ],
      [ "phavan_office_skyscraper_lab_upper_sw", "phavan_office_skyscraper_lab_upper_se" ]
    ],
    "method": "json",
    "weight": 250,
    "object": {
      "fill_ter": "t_linoleum_white",
      "rows": [
        "                                                ",
        "                                                ",
        "                                                ",
        "                                                ",
        "   |-HHH-HHH-HHH--|HHH-|--HHH|--HHH-HHH-HHH-|   ",
        "   |........................................|   ",
        "   V........................................V   ",
        "   V........................................V   ",
        "   V........................................V   ",
        "   |........................................|   ",
        "   V........................................V   ",
        "   V........................................V   ",
        "   V........................................V   ",
        "   |........................................|   ",
        "   V........................................V   ",
        "   V........................................V   ",
        "   V........................................V   ",
        "   |........|--|-|-|--¥!!---|-|-|--|........|   ",
        "   V........|SS|T|T|^......^|T|T|SS|........V   ",
        "   V........+..|+|+|^......^|+|+|..+........V   ",
        "   V........|......|^......^|......|........V   ",
        "   |........|---|--||......||--|---|........|   ",
        "   |........|<R>|EEE|......|xEE|<R>|........|   ",
        "   V........|'R'|EEED......DEEE|'R'|........V   ",
        "   V........¥'''|EEED......DEEE|'''¥........V   ",
        "   V........!'''|EEx|......|EEE|'''!........V   ",
        "   |........|---|-|-|------|-|-|---|........|   ",
        "   V........................................V   ",
        "   V........................................V   ",
        "   V........................................V   ",
        "   |........................................|   ",
        "   V........................................V   ",
        "   V........................................V   ",
        "   V........................................V   ",
        "   |........................................|   ",
        "   V........................................V   ",
        "   V........................................V   ",
        "   V........................................V   ",
        "   |........................................|   ",
        "   V........................................V   ",
        "   V........................................V   ",
        "   V........................................V   ",
        "   |........................................|   ",
        "   |-HHH-HHHH-HHH-|-HHHHHHHH-|-HHH-HHHH-HHH-|   ",
        "                                                ",
        "                                                ",
        "                                                ",
        "                                                "
      ],
      "terrain": { "a": "t_linoleum_gray" },
      "palettes": [ "phavian_skyscraper_office_palette" ]
    }
  }
]
