[
  {
    "type": "mapgen",
    "om_terrain": [
      [ "phavan_office_skyscraper_lab_lower_nw", "phavan_office_skyscraper_lab_lower_ne" ],
      [ "phavan_office_skyscraper_lab_lower_sw", "phavan_office_skyscraper_lab_lower_se" ]
    ],
    "object": {
      "fill_ter": "t_linoleum_white",
      "rows": [
        "                                                ",
        "                                                ",
        "                                                ",
        "                                                ",
        "   ##VVV#VVV#VVV##VVV##VV##VVV##VVV#VVV#VVV##   ",
        "   #........|........|..cd|........|........#   ",
        "   V........|........|d..l|........|........V   ",
        "   V........|........|dc.l|........|........V   ",
        "   V........|........|d..l|........|........V   ",
        "   #........|........|dc..|........|........#   ",
        "   V........|........|....|........|........V   ",
        "   V........|........|..cx|........|........V   ",
        "   V........|........|.ddd|........|........V   ",
        "   #|||||GG|||||||GG||....||GG|||||||GG|||||#   ",
        "   V....|..............................|....V   ",
        "   V....|..............................|....V   ",
        "   V....|..............................|....V   ",
        "   #....+...||||||||||¥!!|||||||||||...+....#   ",
        "   #|||||...|SS|T|T|^......^|T|T|SS|...|||||#   ",
        "   V....|...+..|+|+|^......^|+|+|..+...|....V   ",
        "   V....|...|......|^......^|......|...|....V   ",
        "   #....|...|||||||||......|||||||||...|....#   ",
        "   #....+...|<R>|EEE|......|xEE|<R>|...+....#   ",
        "   #|||||...|'R'|EEED......DEEE|'R'|...|||||#   ",
        "   V....|...|'''|EEED......DEEE|'''|...|....V   ",
        "   V....|...1'''|EEx|......|EEE|'''1...|....V   ",
        "   #....|...||||||||||||||||||||||||...|....#   ",
        "   V....+...|<R.|...|...|e.C...........+....V   ",
        "   #|||||...|.R.|...|...|Ƒ.S...........|||||#   ",
        "   V....|...|...|...|...|Đ.............|....V   ",
        "   #....|...||+|||+|||+|||||...........|....#   ",
        "   V....|..............................|....V   ",
        "   V....+..............................+....V   ",
        "   #||||||GG||||||||GG||||GG||||||||GG||||||#   ",
        "   V.........|.........||.........|.........V   ",
        "   #.........|.........||.........|.........#   ",
        "   V.........|.........||.........|.........V   ",
        "   V.........|.........||.........|.........V   ",
        "   V.........|.........||.........|.........V   ",
        "   #.........|.........||.........|.........#   ",
        "   V.........|.........||.........|.........V   ",
        "   V.........|.........||.........|.........V   ",
        "   V.........|.........||.........|.........V   ",
        "   ##VVV#VVV##VVV###VVV##VVV###VVV#VVV##VVV##   ",
        "                                                ",
        "                                                ",
        "                                                ",
        "                                                "
      ],
      "terrain": {  },
      "palettes": [ "phavian_skyscraper_office_palette" ],
      "place_nested": [
        { "chunks": [ "phavian_skyscraper_lab_north_lrdoor" ], "x": 4, "y": 5 },
        { "chunks": [ "phavian_skyscraper_lab_north_lrdoor" ], "x": 13, "y": 5 },
        { "chunks": [ "phavian_skyscraper_lab_north_lldoor" ], "x": 27, "y": 5 },
        { "chunks": [ "phavian_skyscraper_lab_north_lldoor" ], "x": 36, "y": 5 },
        { "chunks": [ "phavian_skyscraper_lab_south_urdoor" ], "x": 4, "y": 34 },
        { "chunks": [ "phavian_skyscraper_lab_south_urdoor" ], "x": 14, "y": 34 },
        { "chunks": [ "phavian_skyscraper_lab_south_uldoor" ], "x": 25, "y": 34 },
        { "chunks": [ "phavian_skyscraper_lab_south_uldoor" ], "x": 35, "y": 34 },
        { "chunks": [ "phavian_skyscraper_lab_office_Edoor4x4" ], "x": 4, "y": 14 },
        { "chunks": [ "phavian_skyscraper_lab_office_Edoor4x4" ], "x": 4, "y": 19 },
        { "chunks": [ "phavian_skyscraper_lab_office_Edoor4x4" ], "x": 4, "y": 24 },
        { "chunks": [ "phavian_skyscraper_lab_office_Edoor4x4" ], "x": 4, "y": 29 },
        { "chunks": [ "phavian_skyscraper_lab_office_Wdoor4x4" ], "x": 40, "y": 14 },
        { "chunks": [ "phavian_skyscraper_lab_office_Wdoor4x4" ], "x": 40, "y": 19 },
        { "chunks": [ "phavian_skyscraper_lab_office_Wdoor4x4" ], "x": 40, "y": 24 },
        { "chunks": [ "phavian_skyscraper_lab_office_Wdoor4x4" ], "x": 40, "y": 29 },
        { "chunks": [ "phavian_skyscraper_lab_store_room_3x3" ], "x": 17, "y": 27 },
        { "chunks": [ "phavian_skyscraper_lab_store_room_3x3" ], "x": 21, "y": 27 },
        { "chunks": [ "phavian_skyscraper_lab_break_area_4x4" ], "x": 28, "y": 27 },
        { "chunks": [ "phavian_skyscraper_lab_break_area_4x4" ], "x": 32, "y": 27 }
      ],
      "item": { "l": [ { "item": "grenade_anti_psi", "chance": 15 } ] },
      "items": {
        "e": { "item": "SUS_fridge_breakroom", "chance": 80, "repeat": [ 1, 4 ] },
        "l": { "item": "feral_security_death_drops_9mm", "chance": 80, "repeat": [ 1, 3 ] },
        "d": { "item": "SUS_office_desk", "chance": 33 },
        ".": { "item": "SUS_office_mess", "chance": 1 }
      },
      "vendingmachines": { "Đ": { "item_group": "vending_drink" }, "Ƒ": { "item_group": "vending_food" } },
      "place_monster": [
        { "group": "GROUP_LAB_BASIC_SECURITY", "x": [ 22, 23 ], "y": [ 5, 12 ], "chance": 60, "repeat": [ 2, 5 ] },
        { "group": "GROUP_LAB_BASIC_SECURITY", "x": [ 24, 25 ], "y": [ 5, 12 ], "chance": 60, "repeat": [ 2, 5 ] },
        { "group": "GROUP_PHAVIAN_SKYSCRAPER_LAB", "x": [ 9, 23 ], "y": [ 14, 16 ], "chance": 60, "repeat": [ 2, 5 ] },
        {
          "group": "GROUP_PHAVIAN_SKYSCRAPER_LAB",
          "x": [ 24, 38 ],
          "y": [ 14, 16 ],
          "chance": 60,
          "repeat": [ 2, 5 ]
        },
        { "group": "GROUP_PHAVIAN_SKYSCRAPER_LAB", "x": [ 9, 11 ], "y": [ 14, 23 ], "chance": 60, "repeat": [ 2, 5 ] },
        { "group": "GROUP_PHAVIAN_SKYSCRAPER_LAB", "x": [ 9, 11 ], "y": [ 24, 30 ], "chance": 60, "repeat": [ 2, 5 ] },
        { "group": "GROUP_PHAVIAN_SKYSCRAPER_LAB", "x": [ 9, 23 ], "y": [ 31, 32 ], "chance": 60, "repeat": [ 2, 5 ] },
        {
          "group": "GROUP_PHAVIAN_SKYSCRAPER_LAB",
          "x": [ 24, 38 ],
          "y": [ 31, 32 ],
          "chance": 60,
          "repeat": [ 2, 5 ]
        },
        {
          "group": "GROUP_PHAVIAN_SKYSCRAPER_LAB",
          "x": [ 36, 38 ],
          "y": [ 14, 23 ],
          "chance": 60,
          "repeat": [ 2, 5 ]
        },
        {
          "group": "GROUP_PHAVIAN_SKYSCRAPER_LAB",
          "x": [ 36, 38 ],
          "y": [ 24, 30 ],
          "chance": 60,
          "repeat": [ 2, 5 ]
        }
      ]
    }
  },
  {
    "type": "mapgen",
    "om_terrain": [
      [ "phavan_office_skyscraper_lab_middle_nw", "phavan_office_skyscraper_lab_middle_ne" ],
      [ "phavan_office_skyscraper_lab_middle_sw", "phavan_office_skyscraper_lab_middle_se" ]
    ],
    "object": {
      "fill_ter": "t_linoleum_white",
      "rows": [
        "                                                ",
        "                                                ",
        "                                                ",
        "                                                ",
        "   ##VVV#VVV#VVV##VVV##VV##VVV##VVV#VVV#VVV##   ",
        "   #........|........|..cd|........|........#   ",
        "   V........|........|d..l|........|........V   ",
        "   V........|........|dc.l|........|........V   ",
        "   V........|........|d..l|........|........V   ",
        "   #........|........|....|........|........#   ",
        "   V........|........|..cx|........|........V   ",
        "   V........|........|.ddd|........|........V   ",
        "   V........|........|....|........|........V   ",
        "   #|||||GG|||||||GG||VGGV||GG|||||||GG|||||#   ",
        "   V....|..............................|....V   ",
        "   V....|..............................|....V   ",
        "   V....|..............................|....V   ",
        "   #....+...||||||||||VGGV||||||||||...+....#   ",
        "   #|||||...|SS|T|T|ç......ç|T|T|SS|...|||||V   ",
        "   V....|...+..|+|+|ç......ç|+|+|..+...|....V   ",
        "   V....|...|......|ç..çç..ç|......|...|....V   ",
        "   #....|...||||||||ç..çç..ç||||||||...|....#   ",
        "   #....+...|<R>|h.h.h....h.h.h|<R>|...+....#   ",
        "   #|||||...|'R'|x.x.x....x.x.x|'R'|...|||||#   ",
        "   V....|...|'''|..............|'''|...|....V   ",
        "   V....|...|'''|..............|'''|...|....V   ",
        "   #....|...|||||:=:|:=:|:=:|:=|||||...|....#   ",
        "   V....+...|<R>|X̄..|X̄..|Ẋ..|Ẋ..|Đ.y...+....V   ",
        "   #|||||...|.R.|...|...|...|...|Ƒ.....|||||#   ",
        "   V....|...|...|...|...|...|...|b.....|....V   ",
        "   #....|...||+||||||||||||||||||b.....|....#   ",
        "   V....|..............................|....V   ",
        "   V....+..............................+....V   ",
        "   #||||||GG||||||||GG||||GG||||||||GG||||||#   ",
        "   V.........|.........||.........|.........V   ",
        "   #.........|.........||.........|.........#   ",
        "   V.........|.........||.........|.........V   ",
        "   V.........|.........||.........|.........V   ",
        "   V.........|.........||.........|.........V   ",
        "   #.........|.........||.........|.........#   ",
        "   V.........|.........||.........|.........V   ",
        "   V.........|.........||.........|.........V   ",
        "   V.........|.........||.........|.........V   ",
        "   ##VVV#VVV##VVV###VVV##VVV###VVV#VVV##VVV##   ",
        "                                                ",
        "                                                ",
        "                                                ",
        "                                                "
      ],
      "terrain": { ":": "t_reinforced_glass", "=": "t_door_glass_frosted_lab_c" },
      "palettes": [ "phavian_skyscraper_office_palette" ],
      "place_nested": [
        { "chunks": [ "phavian_skyscraper_lab_north_lrdoor" ], "x": 4, "y": 5 },
        { "chunks": [ "phavian_skyscraper_lab_north_lrdoor" ], "x": 13, "y": 5 },
        { "chunks": [ "phavian_skyscraper_lab_north_lldoor" ], "x": 27, "y": 5 },
        { "chunks": [ "phavian_skyscraper_lab_north_lldoor" ], "x": 36, "y": 5 },
        { "chunks": [ "phavian_skyscraper_lab_south_urdoor" ], "x": 4, "y": 34 },
        { "chunks": [ "phavian_skyscraper_lab_south_urdoor" ], "x": 14, "y": 34 },
        { "chunks": [ "phavian_skyscraper_lab_south_uldoor" ], "x": 25, "y": 34 },
        { "chunks": [ "phavian_skyscraper_lab_south_uldoor" ], "x": 35, "y": 34 },
        { "chunks": [ "phavian_skyscraper_lab_office_Edoor4x4" ], "x": 4, "y": 14 },
        { "chunks": [ "phavian_skyscraper_lab_office_Edoor4x4" ], "x": 4, "y": 19 },
        { "chunks": [ "phavian_skyscraper_lab_office_Edoor4x4" ], "x": 4, "y": 24 },
        { "chunks": [ "phavian_skyscraper_lab_office_Edoor4x4" ], "x": 4, "y": 29 },
        { "chunks": [ "phavian_skyscraper_lab_office_Wdoor4x4" ], "x": 40, "y": 14 },
        { "chunks": [ "phavian_skyscraper_lab_office_Wdoor4x4" ], "x": 40, "y": 19 },
        { "chunks": [ "phavian_skyscraper_lab_office_Wdoor4x4" ], "x": 40, "y": 24 },
        { "chunks": [ "phavian_skyscraper_lab_office_Wdoor4x4" ], "x": 40, "y": 29 }
      ],
      "place_items": [ { "item": "clairsentient_matrix_crystals_group", "x": 20, "y": 21, "chance": 30 } ],
      "item": { "l": [ { "item": "grenade_anti_psi", "chance": 15 } ] },
      "items": {
        "e": { "item": "SUS_fridge_breakroom", "chance": 80, "repeat": [ 1, 4 ] },
        "l": { "item": "feral_security_death_drops_9mm", "chance": 80, "repeat": [ 1, 3 ] },
        "d": { "item": "SUS_office_desk", "chance": 33 },
        ".": { "item": "SUS_office_mess", "chance": 1 },
        "ç": [
          { "item": "psi_lab_no_recipes", "chance": 60, "repeat": [ 1, 3 ] },
          { "item": "dist_lab_file_phavian_skyscraper_lab", "chance": 5 }
        ]
      },
      "nested": {
        "X̄": { "chunks": [ [ "phavian_skyscraper_osiris_chamber_clairsentient", 1 ] ] },
        "Ẋ": { "chunks": [ [ "phavian_skyscraper_osiris_chamber_telepathic", 1 ] ] }
      },
      "vendingmachines": { "Đ": { "item_group": "vending_drink" }, "Ƒ": { "item_group": "vending_food" } },
      "place_monster": [
        { "group": "GROUP_LAB_BASIC_SECURITY", "x": [ 22, 23 ], "y": [ 5, 12 ], "chance": 60, "repeat": [ 2, 5 ] },
        { "group": "GROUP_LAB_BASIC_SECURITY", "x": [ 24, 25 ], "y": [ 5, 12 ], "chance": 60, "repeat": [ 2, 5 ] },
        { "group": "GROUP_PHAVIAN_SKYSCRAPER_LAB", "x": [ 9, 23 ], "y": [ 14, 16 ], "chance": 60, "repeat": [ 2, 5 ] },
        {
          "group": "GROUP_PHAVIAN_SKYSCRAPER_LAB",
          "x": [ 24, 38 ],
          "y": [ 14, 16 ],
          "chance": 60,
          "repeat": [ 2, 5 ]
        },
        { "group": "GROUP_PHAVIAN_SKYSCRAPER_LAB", "x": [ 9, 11 ], "y": [ 14, 23 ], "chance": 60, "repeat": [ 2, 5 ] },
        { "group": "GROUP_PHAVIAN_SKYSCRAPER_LAB", "x": [ 9, 11 ], "y": [ 24, 30 ], "chance": 60, "repeat": [ 2, 5 ] },
        { "group": "GROUP_PHAVIAN_SKYSCRAPER_LAB", "x": [ 9, 23 ], "y": [ 31, 32 ], "chance": 60, "repeat": [ 2, 5 ] },
        {
          "group": "GROUP_PHAVIAN_SKYSCRAPER_LAB",
          "x": [ 24, 38 ],
          "y": [ 31, 32 ],
          "chance": 60,
          "repeat": [ 2, 5 ]
        },
        {
          "group": "GROUP_PHAVIAN_SKYSCRAPER_LAB",
          "x": [ 36, 38 ],
          "y": [ 14, 23 ],
          "chance": 60,
          "repeat": [ 2, 5 ]
        },
        {
          "group": "GROUP_PHAVIAN_SKYSCRAPER_LAB",
          "x": [ 36, 38 ],
          "y": [ 24, 30 ],
          "chance": 60,
          "repeat": [ 2, 5 ]
        },
        {
          "group": "GROUP_PHAVIAN_SKYSCRAPER_LAB",
          "x": [ 20, 23 ],
          "y": [ 19, 23 ],
          "chance": 60,
          "repeat": [ 2, 4 ]
        },
        {
          "group": "GROUP_PHAVIAN_SKYSCRAPER_LAB",
          "x": [ 24, 27 ],
          "y": [ 19, 23 ],
          "chance": 60,
          "repeat": [ 2, 4 ]
        }
      ]
    }
  },
  {
    "type": "mapgen",
    "om_terrain": [
      [ "phavan_office_skyscraper_lab_upper_nw", "phavan_office_skyscraper_lab_upper_ne" ],
      [ "phavan_office_skyscraper_lab_upper_sw", "phavan_office_skyscraper_lab_upper_se" ]
    ],
    "object": {
      "fill_ter": "t_linoleum_white",
      "rows": [
        "                                                ",
        "                                                ",
        "                                                ",
        "                                                ",
        "   ##VVV|VVV#VVV##VVV##VV##VVV##VVV#VVV#VVV##   ",
        "   #........|........|..cd|........|........#   ",
        "   V........|........|d..l|........|........V   ",
        "   V........|........|dc.l|........|........V   ",
        "   V........|........|d..l|........|........V   ",
        "   #........|........|....|........|........#   ",
        "   V........|........|..cx|........|........V   ",
        "   V........|........|.ddd|........|........V   ",
        "   V........|........|....|........|........V   ",
        "   #|||||GG|||||||GG||VGGV||GG|||||||GG|||||#   ",
        "   V....|..............................|....V   ",
        "   V....|..............................|....V   ",
        "   V....|..............................|....V   ",
        "   #....+...||||||||||¥!!|||||||||||...+....#   ",
        "   #|||||...|SS|T|T|^......^|T|T|SS|...|||||V   ",
        "   V....|...+..|+|+|^......^|+|+|..+...|....V   ",
        "   V....|...|......|^......^|......|...|....V   ",
        "   #....|...|||||||||......|||||||||...|....#   ",
        "   #....+...|<R>|EEE|......|xEE|<R>|...+....#   ",
        "   #|||||...|'R'|EEED......DEEE|'R'|...||||||   ",
        "   V....|...|'''|EEED......DEEE|'''|...|....V   ",
        "   V....|...|'''|EEx|......|EEE|'''|...|....V   ",
        "   #....|...||||||||||||||||||||||||...|....#   ",
        "   V....+...|.R>|...|...|e.C...........+....V   ",
        "   #|||||...|.R.|...|...|Ƒ.S...........||||||   ",
        "   V....|...|...|...|...|Đ.............|....V   ",
        "   #....|...||+|||+|||+||..............|....#   ",
        "   V....|..............................|....V   ",
        "   V....+..............................+....V   ",
        "   #||||||GG||||||||GG||||GG||||||||GG||||||#   ",
        "   V.........|.........||.........|.........V   ",
        "   #.........|.........||.........|.........#   ",
        "   V.........|.........||.........|.........V   ",
        "   V.........|.........||.........|.........V   ",
        "   V.........|.........||.........|.........V   ",
        "   #.........|.........||.........|.........#   ",
        "   V.........|.........||.........|.........V   ",
        "   V.........|.........||.........|.........V   ",
        "   V.........|.........||.........|.........V   ",
        "   ##VVV#VVV##VVV###VVV##VVV###VVV#VVV##VVV##   ",
        "                                                ",
        "                                                ",
        "                                                ",
        "                                                "
      ],
      "terrain": {  },
      "palettes": [ "phavian_skyscraper_office_palette" ],
      "place_nested": [
        { "chunks": [ "phavian_skyscraper_lab_north_lrdoor" ], "x": 4, "y": 5 },
        { "chunks": [ "phavian_skyscraper_lab_north_lrdoor" ], "x": 13, "y": 5 },
        { "chunks": [ "phavian_skyscraper_lab_north_lldoor" ], "x": 27, "y": 5 },
        { "chunks": [ "phavian_skyscraper_lab_north_lldoor" ], "x": 36, "y": 5 },
        { "chunks": [ "phavian_skyscraper_lab_south_urdoor" ], "x": 4, "y": 34 },
        { "chunks": [ "phavian_skyscraper_lab_south_urdoor" ], "x": 14, "y": 34 },
        { "chunks": [ "phavian_skyscraper_lab_south_uldoor" ], "x": 25, "y": 34 },
        { "chunks": [ "phavian_skyscraper_lab_south_uldoor" ], "x": 35, "y": 34 },
        { "chunks": [ "phavian_skyscraper_lab_office_Edoor4x4" ], "x": 4, "y": 14 },
        { "chunks": [ "phavian_skyscraper_lab_office_Edoor4x4" ], "x": 4, "y": 19 },
        { "chunks": [ "phavian_skyscraper_lab_office_Edoor4x4" ], "x": 4, "y": 24 },
        { "chunks": [ "phavian_skyscraper_lab_office_Edoor4x4" ], "x": 4, "y": 29 },
        { "chunks": [ "phavian_skyscraper_lab_office_Wdoor4x4" ], "x": 40, "y": 14 },
        { "chunks": [ "phavian_skyscraper_lab_office_Wdoor4x4" ], "x": 40, "y": 19 },
        { "chunks": [ "phavian_skyscraper_lab_office_Wdoor4x4" ], "x": 40, "y": 24 },
        { "chunks": [ "phavian_skyscraper_lab_office_Wdoor4x4" ], "x": 40, "y": 29 },
        { "chunks": [ "phavian_skyscraper_lab_store_room_3x3" ], "x": 17, "y": 27 },
        { "chunks": [ "phavian_skyscraper_lab_store_room_3x3" ], "x": 21, "y": 27 },
        { "chunks": [ "phavian_skyscraper_lab_break_area_4x4" ], "x": 28, "y": 27 },
        { "chunks": [ "phavian_skyscraper_lab_break_area_4x4" ], "x": 32, "y": 27 }
      ],
      "item": { "l": [ { "item": "grenade_anti_psi", "chance": 15 } ] },
      "items": {
        "e": { "item": "SUS_fridge_breakroom", "chance": 80, "repeat": [ 1, 4 ] },
        "l": { "item": "feral_security_death_drops_9mm", "chance": 80, "repeat": [ 1, 3 ] },
        "d": { "item": "SUS_office_desk", "chance": 33 },
        ".": { "item": "SUS_office_mess", "chance": 1 }
      },
      "vendingmachines": { "Đ": { "item_group": "vending_drink" }, "Ƒ": { "item_group": "vending_food" } },
      "place_monster": [
        { "group": "GROUP_LAB_BASIC_SECURITY", "x": [ 22, 23 ], "y": [ 5, 12 ], "chance": 60, "repeat": [ 2, 5 ] },
        { "group": "GROUP_LAB_BASIC_SECURITY", "x": [ 24, 25 ], "y": [ 5, 12 ], "chance": 60, "repeat": [ 2, 5 ] },
        { "group": "GROUP_PHAVIAN_SKYSCRAPER_LAB", "x": [ 9, 23 ], "y": [ 14, 16 ], "chance": 60, "repeat": [ 2, 5 ] },
        {
          "group": "GROUP_PHAVIAN_SKYSCRAPER_LAB",
          "x": [ 24, 38 ],
          "y": [ 14, 16 ],
          "chance": 60,
          "repeat": [ 2, 5 ]
        },
        { "group": "GROUP_PHAVIAN_SKYSCRAPER_LAB", "x": [ 9, 11 ], "y": [ 14, 23 ], "chance": 60, "repeat": [ 2, 5 ] },
        { "group": "GROUP_PHAVIAN_SKYSCRAPER_LAB", "x": [ 9, 11 ], "y": [ 24, 30 ], "chance": 60, "repeat": [ 2, 5 ] },
        { "group": "GROUP_PHAVIAN_SKYSCRAPER_LAB", "x": [ 9, 23 ], "y": [ 31, 32 ], "chance": 60, "repeat": [ 2, 5 ] },
        {
          "group": "GROUP_PHAVIAN_SKYSCRAPER_LAB",
          "x": [ 24, 38 ],
          "y": [ 31, 32 ],
          "chance": 60,
          "repeat": [ 2, 5 ]
        },
        {
          "group": "GROUP_PHAVIAN_SKYSCRAPER_LAB",
          "x": [ 36, 38 ],
          "y": [ 14, 23 ],
          "chance": 60,
          "repeat": [ 2, 5 ]
        },
        {
          "group": "GROUP_PHAVIAN_SKYSCRAPER_LAB",
          "x": [ 36, 38 ],
          "y": [ 24, 30 ],
          "chance": 60,
          "repeat": [ 2, 5 ]
        }
      ]
    }
  }
]
