[
  {
    "type": "mapgen",
    "om_terrain": "2StoryModern03_basement",
    "weight": 250,
    "method": "json",
    "object": {
      "palettes": [ "standard_domestic_palette", "standard_domestic_basement_palette" ],
      "fill_ter": "t_floor",
      "rows": [
        "^^^^^^^^^^^^^^^^^^^^^^^^",
        "^^^^^^^^^^^^^^^^^^^^^^^^",
        "^^^^^^^^^^^^^^^^^^^^^^^^",
        "^^^^^^^^^^^^^^^^^^^^^^^^",
        "^^^^^^^^^^^^^^^^^^^^^^^^",
        "^^^^^^^^^^^^^^^^^^^^^^^^",
        "^^^^###################^",
        "^^^^#UU_m|u__c|A !!!!A#^",
        "^^^^#___m|____|       #^",
        "^^^^#g__m|b__X|V eee  #^",
        "^^^^#||+|||+|||V eee A#^",
        "^^^^#q+               #^",
        "^^^^#||||||||        T#^",
        "^^^^#D,$,,,,+         #^",
        "^^^^#,,,,h,,|||++|++| #^",
        "^^^^#¤@@,II,+d|zz|LL|<#^",
        "^^^^###################^",
        "^^^^^^^^^^^^^^^^^^^^^^^^",
        "^^^^^^^^^^^^^^^^^^^^^^^^",
        "^^^^^^^^^^^^^^^^^^^^^^^^",
        "^^^^^^^^^^^^^^^^^^^^^^^^",
        "^^^^^^^^^^^^^^^^^^^^^^^^",
        "^^^^^^^^^^^^^^^^^^^^^^^^",
        "^^^^^^^^^^^^^^^^^^^^^^^^"
      ],
      "terrain": {
        "_": "t_thconc_floor",
        "m": "t_thconc_floor",
        "g": "t_thconc_floor",
        "U": "t_thconc_floor",
        "b": "t_thconc_floor",
        ",": "t_carpet_red",
        "d": "t_carpet_red",
        "I": "t_carpet_red",
        "h": "t_carpet_red",
        "@": "t_carpet_red",
        "$": "t_carpet_red",
        "¶": "t_door_glass_c",
        "D": "t_carpet_red",
        "¤": "t_carpet_red"
      },
      "furniture": { "!": "f_counter", "$": "f_bigmirror" }
    }
  },
  {
    "type": "mapgen",
    "om_terrain": "2StoryModern03_1",
    "weight": 250,
    "method": "json",
    "object": {
      "palettes": [ "domestic_general_and_variant_palette", "standard_domestic_lino_bathroom" ],
      "fill_ter": "t_floor_waxed",
      "rows": [
        ".--.....................",
        ".--p...........[........",
        ".--......[..............",
        ".------------.....,,,...",
        ".------------.....,,,...",
        ".--%%%%#oo#--...........",
        ".--#oo##yy#--%#::::::#%.",
        ".--#ffh  V#*#%#HHHsyy#%.",
        ".--off   V| |o|H    a#%.",
        ".--#h    RR |&|H ll a#%.",
        ".--##3        |s     ##.",
        ".--%#2               yo.",
        ".--%#F    6|        A≠o.",
        ".--%#1J   6|  RR   |||#.",
        ".--%::JO574#  ||+| | <#.",
        ".--%%::#####L |S~|   >#.",
        ".------%%%##o¶#t~###o##.",
        ".-------------##o#^%%%%.",
        "..###*####..............",
        "..#N//``U#......----G-..",
        "..oN$/``Uo...X..------..",
        "..#NNNqqU#......-G-KG-..",
        "..###oo###.[....---G--..",
        "........................"
      ],
      "terrain": {
        "%": [ [ "t_shrub", 2 ], "t_shrub_strawberry", "t_shrub_blueberry" ],
        "[": [ [ "t_region_tree_nut", 5 ], [ "t_region_tree_shade", 4 ], [ "t_region_tree_fruit", 2 ] ],
        ",": "t_shrub_lilac",
        "`": "t_thconc_floor",
        "U": "t_thconc_floor",
        "q": "t_thconc_floor",
        "/": "t_carpet_yellow",
        "N": "t_carpet_yellow",
        "$": "t_carpet_yellow",
        "K": "t_sidewalk",
        "G": "t_sidewalk"
      },
      "furniture": { "≠": "f_piano", "$": "f_stool", "&": "f_table" },
      "place_nested": [ { "chunks": [ "rolling_trash_can_1x1" ], "x": 17, "y": 4 } ],
      "items": { "&": { "item": "table_foyer", "chance": 50 } }
    }
  },
  {
    "type": "mapgen",
    "om_terrain": "2StoryModern03_2",
    "weight": 250,
    "method": "json",
    "object": {
      "palettes": [ "domestic_general_and_variant_palette", "standard_domestic_lino_bathroom" ],
      "fill_ter": "t_floor_waxed",
      "rows": [
        "........................",
        "........................",
        "........................",
        "........................",
        "........................",
        ".......{{{{.............",
        "...{{{{{,,{...##o##o##..",
        "...{,,,,,,{{{.#88w~~t#..",
        "...{,,,,,,,,{{#B~~~S##..",
        "...{,₸,₸,₸,,,,#B~~~8##..",
        "...##::::::#¶o####+####.",
        "....#d           +  y!#.",
        "....od    T bRRRR#    o.",
        "....#D @@ |+||||||+|| #.",
        "....##¤@@¤# d|v    R|>o.",
        ".....#::::#Dd|Ph z!R|y#.",
        "..........#####rr#o####.",
        "..............#oo#.^....",
        "..((((((((..............",
        "..((((((((..............",
        "..((((((((..............",
        "..((((((((..............",
        "..((((((((..............",
        "........................"
      ],
      "terrain": { ".": "t_open_air", "(": "t_shingle_flat_roof", "{": "t_railing_v", ",": "t_floor_noroof", "₸": "t_floor_noroof" },
      "furniture": { "!": "f_table", "₸": "f_deckchair" },
      "items": { "!": { "item": "table_foyer", "chance": 50 } }
    }
  },
  {
    "type": "mapgen",
    "om_terrain": "2StoryModern03_roof",
    "weight": 250,
    "method": "json",
    "object": {
      "palettes": [ "roof_palette" ],
      "fill_ter": "t_flat_roof",
      "rows": [
        "                        ",
        "                        ",
        "                        ",
        "                        ",
        "                        ",
        "                        ",
        "              --------  ",
        "              -......-  ",
        "              -.....~-  ",
        "              -.....~-  ",
        "   ------------......-- ",
        "    -...........=.....- ",
        "    -.A...............- ",
        "    -.................- ",
        "    --.....N.......&..- ",
        "     ------...........- ",
        "          -----..------ ",
        "              ----      ",
        "                        ",
        "                        ",
        "                        ",
        "                        ",
        "                        ",
        "                        "
      ]
    }
  }
]
