[
  {
    "type": "mapgen",
    "om_terrain": "bungalow18",
    "weight": 50,
    "method": "json",
    "object": {
      "palettes": [ "domestic_general_and_variant_palette", "standard_domestic_lino_bathroom", "standard_domestic_landscaping_palette" ],
      "fill_ter": "t_floor_waxed",
      "rows": [
        "................_______.",
        "................_______.",
        "...............p_______.",
        "..[........[...._______.",
        "............----_______.",
        "............----_______.",
        ".%%%...%%%..--.._______.",
        ".##o####oo##o*#########.",
        ".#B~t|@¤  d|i |Lq|D zD#.",
        ".#B~S|@   d|i +  ||+||#.",
        ".#~~8| h  ||? ||||y  ¤#.",
        "^#Q~8|rrr +   + U|d @@o.",
        ".#|+|||||||y  |zU|d @@o.",
        ".oy  b yRRR   ||||   ¤#.",
        ".oy           T  +    #.",
        ".#|+||           |||||#^",
        ".#W~Z|  R|         666#.",
        ".#||||  R|    h |    7#.",
        ".#  xx  T|a hff |& J 4#.",
        ".ol     E|   ffh|Y J 2o.",
        ".ol      |    h      2o.",
        ".# sHHHsy|VV      F5O1#.",
        ".##oo#######oo#:¶:#####.",
        "...............---......"
      ],
      "terrain": {
        "Z": { "param": "linoleum_color_bathroom", "fallback": "t_linoleum_gray" },
        "W": { "param": "linoleum_color_bathroom", "fallback": "t_linoleum_gray" }
      },
      "furniture": { "&": "f_bookcase", "?": "f_rack" },
      "items": { "?": { "item": "clothing_outdoor_shoes", "chance": 50, "repeat": [ 1, 3 ] } },
      "place_loot": [ { "item": "television", "x": [ 4, 5 ], "y": 18 }, { "group": "SUS_cooking_bookcase", "x": 17, "y": 18 } ],
      "place_vehicles": [ { "vehicle": "car", "x": 18, "y": 2, "chance": 15, "rotation": 270 } ],
      "place_nested": [ { "chunks": [ "rolling_trash_can_1x1" ], "x": 5, "y": 1 } ]
    }
  },
  {
    "type": "mapgen",
    "om_terrain": "bungalow18_roof",
    "weight": 50,
    "method": "json",
    "object": {
      "palettes": [ "roof_palette" ],
      "fill_ter": "t_shingle_flat_roof",
      "rows": [
        "                        ",
        "                        ",
        "                        ",
        "                        ",
        "                        ",
        "                        ",
        "                        ",
        " ---------------------- ",
        " -....................- ",
        " -....................- ",
        " -....................- ",
        " 5....=...............- ",
        " -....................- ",
        " -....................- ",
        " -....................- ",
        " -....................5 ",
        " -....................- ",
        " -....................- ",
        " -........~...........- ",
        " -....................- ",
        " -....................- ",
        " -....................- ",
        " ----------------5----- ",
        "                        "
      ],
      "terrain": { ".": "t_shingle_flat_roof" }
    }
  }
]
