[
  {
    "type": "mapgen",
    "om_terrain": "bungalow16",
    "weight": 200,
    "method": "json",
    "object": {
      "palettes": [
        "domestic_general_construction_and_variant_palette",
        "standard_domestic_lino_bathroom",
        "standard_domestic_landscaping_palette",
        "parametrized_carpets_palette"
      ],
      "fill_ter": "t_floor",
      "rows": [
        "..........p--...........",
        "........[..--..X........",
        "...........--...........",
        ".##o##o###%--%###o##o##.",
        ".#Ry    s#%--%#¤,,,,,r#.",
        ".#R   l H#%--%#&&,,,}r#.",
        ".#R x l H#%--%#&&,,,,r#.",
        ".#    l H##o*##|,,,,,P#.",
        ".o  |||||||L |c+,{$$,,o.",
        ".#  |BtS8Q|  |||||||+|#.",
        ".#  |B____+  ((      T#^",
        ".#  |||||||           #.",
        ".#Y   TVV|y     R|+|++#.",
        ".#476           R|q|ZW#.",
        ".#2           |+||||||#.",
        ".o1 JA   |(  i|===ddb=o.",
        ".#5 J   h|(  i|=======#.",
        ".#O J  ff|L  i|@@====/#.",
        ".#F   hff##:~##@@=?===#.",
        ".##o##o###----###o##o##.",
        ".......^..----jjj.......",
        "......................[.",
        "..[....[.....G...G......",
        "........................"
      ],
      "terrain": {
        "~": "t_door_glass_c",
        "_": { "param": "linoleum_color_bathroom", "fallback": "t_linoleum_gray" },
        "=": { "param": "carpet_color_type", "fallback": "t_carpet_purple" },
        ",": { "param": "carpet_color_type", "fallback": "t_carpet_red" },
        "¤": { "param": "carpet_color_type", "fallback": "t_carpet_red" },
        "G": "t_region_groundcover_urban",
        "?": { "param": "carpet_color_type", "fallback": "t_carpet_purple" },
        "@": { "param": "carpet_color_type", "fallback": "t_carpet_purple" },
        "/": { "param": "carpet_color_type", "fallback": "t_carpet_purple" },
        "d": { "param": "carpet_color_type", "fallback": "t_carpet_purple" },
        "b": { "param": "carpet_color_type", "fallback": "t_carpet_purple" },
        "$": { "param": "carpet_color_type", "fallback": "t_carpet_red" },
        "{": { "param": "carpet_color_type", "fallback": "t_carpet_red" },
        "v": { "param": "carpet_color_type", "fallback": "t_carpet_red" },
        "&": { "param": "carpet_color_type", "fallback": "t_carpet_red" },
        "c": { "param": "carpet_color_type", "fallback": "t_carpet_red" },
        "P": { "param": "carpet_color_type", "fallback": "t_carpet_red" },
        "r": { "param": "carpet_color_type", "fallback": "t_carpet_red" },
        "}": { "param": "carpet_color_type", "fallback": "t_carpet_red" },
        "]": { "param": "carpet_color_type", "fallback": "t_carpet_red" },
        "W": { "param": "linoleum_color_bathroom", "fallback": "t_linoleum_gray" },
        "Z": { "param": "linoleum_color_bathroom", "fallback": "t_linoleum_gray" }
      },
      "furniture": {
        "$": "f_dresser",
        "&": "f_bed",
        "?": "f_exercise",
        "/": "f_punching_bag",
        "0": "f_table",
        "{": "f_wardrobe",
        "}": "f_chair",
        "c": "f_gunsafe_ml",
        "]": "f_table",
        "(": "f_table"
      },
      "items": {
        "$": [
          { "item": "SUS_dresser_mens", "chance": 50, "repeat": [ 1, 2 ] },
          { "item": "SUS_dresser_womens", "chance": 50, "repeat": [ 1, 2 ] }
        ],
        "{": [
          { "item": "SUS_wardrobe_mens", "chance": 50, "repeat": [ 1, 2 ] },
          { "item": "SUS_wardrobe_womens", "chance": 50, "repeat": [ 1, 2 ] }
        ],
        "]": { "item": "nightstand", "chance": 40 },
        "c": { "item": "guns_pistol_common", "chance": 50 },
        "(": { "item": "table_foyer", "chance": 50, "repeat": [ 1, 2 ] }
      },
      "place_nested": [
        { "chunks": [ "rolling_trash_can_1x1" ], "x": 0, "y": 1 },
        { "chunks": [ [ "null", 95 ], [ "carcrash_10x10_rand", 5 ] ], "x": [ 2, 12 ], "y": 0 }
      ],
      "place_loot": [ { "item": "television", "x": 4, "y": 6, "chance": 100 } ]
    }
  },
  {
    "type": "mapgen",
    "om_terrain": "bungalow16_roof",
    "weight": 50,
    "method": "json",
    "object": {
      "palettes": [ "roof_palette" ],
      "fill_ter": "t_shingle_flat_roof",
      "rows": [
        "                        ",
        "                        ",
        "                        ",
        " ---------    --------- ",
        " -.......-    -.......- ",
        " -.......-    -.......- ",
        " -.......-    -.......- ",
        " -.N.....------.......- ",
        " -....................- ",
        " -.X..................- ",
        " -....................5 ",
        " -....................- ",
        " -............1.......- ",
        " -....................- ",
        " -....................- ",
        " -....=...............- ",
        " -....................- ",
        " -....................- ",
        " -.......------.......- ",
        " ------5--    --------- ",
        "                        ",
        "                        ",
        "                        ",
        "                        "
      ],
      "terrain": { ".": "t_shingle_flat_roof" }
    }
  }
]
