[
  {
    "type": "mapgen",
    "om_terrain": "bungalow07",
    "weight": 250,
    "method": "json",
    "object": {
      "palettes": [ "domestic_general_and_variant_palette", "standard_domestic_lino_bathroom", "standard_domestic_landscaping_palette" ],
      "fill_ter": "t_floor",
      "rows": [
        ".................---.p..",
        ".....X...........---....",
        "..[....%###oo###%---....",
        ".......%#D¤@@¤ #%---....",
        "..##oo###  @@  ##o*###%.",
        "..#¤@@¤D|     d|b  LL#%.",
        "..o @@  |+|    |     #%.",
        "..o    )|v|  II|V  xy#%.",
        "..#++|  |||+||||V lllo%.",
        "..#dd|b +    RRy     o%.",
        "..#||||||         HHH#^.",
        "..oB~~~~+   ==$=  sss#..",
        "..#B8tS8|R  =ff=     #..",
        "..#||||||R  $ff$    1#..",
        "..orh   +   =$==  J Fo..",
        "..#r  PR|        AJ 2o..",
        "..#||+||###¶¶###  5 O#..",
        "..#Z   U#j----j#6 J 3#..",
        "..#WzNNU#j----j#6  yY#..",
        "..##oo###j....j####oo#..",
        "........................",
        ".......[................",
        "..[..........G.KG.....[.",
        "........................"
      ],
      "terrain": {
        "G": "t_region_groundcover_urban",
        "K": "t_region_groundcover_urban",
        "=": "t_carpet_green",
        "f": "t_carpet_green",
        "$": "t_carpet_green"
      },
      "furniture": { ")": "f_treadmill", "$": "f_chair" },
      "place_nested": [ { "chunks": [ "rolling_trash_can_1x1" ], "x": 9, "y": 1 } ],
      "place_loot": [ { "item": "television", "x": 19, "y": 7 } ]
    }
  },
  {
    "type": "mapgen",
    "om_terrain": "bungalow07_roof",
    "weight": 250,
    "method": "json",
    "object": {
      "fill_ter": "t_shingle_flat_roof",
      "rows": [
        "                        ",
        "                        ",
        "        --------        ",
        "        -......-        ",
        "  -------......-------  ",
        "  -..................-  ",
        "  -..................-  ",
        "  -..................-  ",
        "  -...N..............-  ",
        "  -..................-  ",
        "  -..................5  ",
        "  -..................-  ",
        "  -..................-  ",
        "  -..................-  ",
        "  -..............X...-  ",
        "  -..................-  ",
        "  -..................-  ",
        "  -..................-  ",
        "  -..................-  ",
        "  --------------------  ",
        "                        ",
        "                        ",
        "                        ",
        "                        "
      ],
      "palettes": [ "roof_palette" ],
      "terrain": { ".": "t_shingle_flat_roof" }
    }
  }
]
