[
  {
    "type": "mapgen",
    "method": "json",
    "om_terrain": "garden_house_1_floor_1",
    "object": {
      "fill_ter": "t_floor",
      "rows": [
        "....p``.[.[.[.[.[.[.[.[.",
        ".[...``.................",
        "...````/%%%%%%%/%%..[.[.",
        ".[.`#*o#o#o#o#o#o##.....",
        "...`#=={    }     #.[.[.",
        ".[.`#==           #.....",
        "...`#             o.[.[.",
        ".[.`#             o.....",
        "...`#             #.[.[.",
        "...`#<>           #.....",
        ".ŦŦɤ####||+|      #ŦŦŦŦ.",
        ".Ŧ.`..^#t~~|Y==1==o...Ŧ.",
        ".Ŧ.`...#88S|7=====*.[.Ŧ.",
        ".Ŧ[`[..#o###F====3#...Ŧ.",
        ".Ŧ.````````#6J45O2#.[.Ŧ.",
        ".Ŧ[.[.[.[.`###oo###...Ŧ.",
        ".Ŧ]......[`.........[.Ŧ.",
        ".Ŧ......[.`[0[.[!.....Ŧ.",
        ".Ŧ.......[`000[.......Ŧ.",
        ".Ŧ......[.`000.[......Ŧ.",
        ".Ŧ.......[`000[.......Ŧ.",
        ".Ŧ......[..[0[........Ŧ.",
        ".Ŧ.......[..[..[......Ŧ.",
        ".ŦŦŦŦŦŦŦŦŦŦŦŦŦŦŦŦŦŦŦŦŦŦ."
      ],
      "palettes": [
        "parametrized_linoleum_palette",
        "domestic_general_and_variant_palette",
        "standard_domestic_lino_kitchen",
        "standard_domestic_lino_bathroom",
        "standard_domestic_landscaping_palette"
      ],
      "terrain": {
        "!": "t_region_groundcover_urban",
        "]": "t_region_groundcover_urban",
        "0": "t_water_pool_shallow_outdoors",
        "/": "t_column",
        "Y": { "param": "linoleum_color", "fallback": "t_linoleum_white" }
      },
      "place_nested": [ { "chunks": [ "rolling_trash_can_1x1" ], "x": 10, "y": 1 } ],
      "nested": {
        "{": {
          "chunks": [
            [ "livingroom_5x5_N_1", 20 ],
            [ "livingroom_5x5_S_1", 20 ],
            [ "livingroom_5x5_E_1", 20 ],
            [ "livingroom_5x5_W_1", 20 ]
          ]
        },
        "}": {
          "chunks": [
            [ "diningroom_6x6_E_W_1", 20 ],
            [ "diningroom_6x6_E_W_2", 20 ],
            [ "diningroom_6x6_N_S_2", 20 ],
            [ "diningroom_6x6_N_S_1B", 20 ]
          ]
        },
        "!": {
          "chunks": [
            [ "roof_6x6_garden_4", 5 ],
            [ "roof_6x6_garden_1", 15 ],
            [ "firepit_5x5_1", 10 ],
            [ "firepit_5x5_2", 10 ],
            [ "reflecting_pool_5x5_1", 10 ],
            [ "reflecting_pool_5x5_2", 10 ],
            [ "garden_3x3_1", 10 ],
            [ "garden_3x3_2", 10 ]
          ]
        },
        "]": {
          "chunks": [
            [ "shed_6x6_junk", 10 ],
            [ "greenhouse_6x6_herbal", 10 ],
            [ "greenhouse_6x6_vegetable", 10 ],
            [ "pond_6x6", 15 ],
            [ "garden_3x3_3", 10 ]
          ]
        }
      }
    }
  },
  {
    "type": "mapgen",
    "method": "json",
    "om_terrain": "garden_house_1_floor_2",
    "object": {
      "fill_ter": "t_floor",
      "rows": [
        "                        ",
        "                        ",
        "    ##oo##o#o##oo##     ",
        "    #{___|ERE|}___#     ",
        "    o____|===|____o     ",
        "    o____|===|____o     ",
        "    #____+===+____#     ",
        "    #|||||==||||||#     ",
        "    #=======+_[___#     ",
        "    #>R|||+||_____o     ",
        "    ####BB_8|_____o     ",
        "      ^#___i|_____#     ",
        "       0w_t8#¶#oo##     ",
        "       ##o###~~~~~0     ",
        "           0~~~~~~0     ",
        "           ]000000]     ",
        "                        ",
        "                        ",
        "                        ",
        "                        ",
        "                        ",
        "                        ",
        "                        ",
        "                        "
      ],
      "palettes": [ "standard_domestic_palette", "parametrized_carpets_palette" ],
      "terrain": {
        " ": "t_open_air",
        "_": "t_floor",
        "~": "t_thconc_floor",
        "]": "t_column",
        "H": { "param": "carpet_color_type", "fallback": "t_carpet_red" },
        "0": "t_screened_porch_wall",
        "R": { "param": "carpet_color_type", "fallback": "t_carpet_red" }
      },
      "nested": {
        "{": {
          "chunks": [
            [ "bedroom_4x4_adult_1_N", 20 ],
            [ "bedroom_4x4_adult_1_E", 20 ],
            [ "bedroom_4x4_adult_1_W", 20 ],
            [ "bedroom_4x4_adult_1_S", 20 ],
            [ "bedroom_4x4_adult_2_N", 10 ],
            [ "bedroom_4x4_adult_3_N", 20 ]
          ]
        },
        "}": {
          "chunks": [
            [ "bedroom_4x4_adult_1_W", 10 ],
            [ "bedroom_4x4_adult_1_S", 10 ],
            [ "bedroom_4x4_adult_2_N", 5 ],
            [ "bedroom_4x4_adult_3_N", 10 ],
            [ "home_office_4x4_N", 30 ]
          ]
        },
        "[": { "chunks": [ [ "bedroom_4x4_adult_2_N", 20 ], [ "bedroom_4x4_adult_2_S", 20 ] ] }
      }
    }
  },
  {
    "type": "mapgen",
    "method": "json",
    "om_terrain": "garden_house_1_basement",
    "//": "Unfinished basement",
    "object": {
      "fill_ter": "t_thconc_floor",
      "rows": [
        "^^^^^^^^^^^^^^^^^^^^^^^^",
        "^^^^^^^^^^^^^^^^^^^^^^^^",
        "^^^^###############^^^^^",
        "^^^^#.............#^^^^^",
        "^^^^#.............#^^^^^",
        "^^^^#.............#^^^^^",
        "^^^^#.............#^^^^^",
        "^^^^#Z......sss...#^^^^^",
        "^^^^#W............#^^^^^",
        "^^^^#!<|...|NNUUUU#^^^^^",
        "^^^^###############^^^^^",
        "^^^^^^^^^^^^^^^^^^^^^^^^",
        "^^^^^^^^^^^^^^^^^^^^^^^^",
        "^^^^^^^^^^^^^^^^^^^^^^^^",
        "^^^^^^^^^^^^^^^^^^^^^^^^",
        "^^^^^^^^^^^^^^^^^^^^^^^^",
        "^^^^^^^^^^^^^^^^^^^^^^^^",
        "^^^^^^^^^^^^^^^^^^^^^^^^",
        "^^^^^^^^^^^^^^^^^^^^^^^^",
        "^^^^^^^^^^^^^^^^^^^^^^^^",
        "^^^^^^^^^^^^^^^^^^^^^^^^",
        "^^^^^^^^^^^^^^^^^^^^^^^^",
        "^^^^^^^^^^^^^^^^^^^^^^^^",
        "^^^^^^^^^^^^^^^^^^^^^^^^"
      ],
      "palettes": [ "standard_domestic_palette", "standard_domestic_basement_palette" ],
      "place_nested": [
        { "chunks": [ "utility_3x3_S" ], "x": 8, "y": 7 },
        { "chunks": [ "basement_storage_1x1" ], "x": [ 5, 17 ], "y": [ 3, 6 ], "repeat": [ 4, 16 ] }
      ]
    }
  },
  {
    "type": "mapgen",
    "method": "json",
    "om_terrain": "garden_house_1_basement",
    "//": "rec room basement",
    "object": {
      "fill_ter": "t_thconc_floor",
      "rows": [
        "^^^^^^^^^^^^^^^^^^^^^^^^",
        "^^^^^^^^^^^^^^^^^^^^^^^^",
        "^^^^###############^^^^^",
        "^^^^#.............#^^^^^",
        "^^^^#.............#^^^^^",
        "^^^^#.............#^^^^^",
        "^^^^#.............#^^^^^",
        "^^^^#Z............#^^^^^",
        "^^^^#W............#^^^^^",
        "^^^^#s<|...|......#^^^^^",
        "^^^^###############^^^^^",
        "^^^^^^^^^^^^^^^^^^^^^^^^",
        "^^^^^^^^^^^^^^^^^^^^^^^^",
        "^^^^^^^^^^^^^^^^^^^^^^^^",
        "^^^^^^^^^^^^^^^^^^^^^^^^",
        "^^^^^^^^^^^^^^^^^^^^^^^^",
        "^^^^^^^^^^^^^^^^^^^^^^^^",
        "^^^^^^^^^^^^^^^^^^^^^^^^",
        "^^^^^^^^^^^^^^^^^^^^^^^^",
        "^^^^^^^^^^^^^^^^^^^^^^^^",
        "^^^^^^^^^^^^^^^^^^^^^^^^",
        "^^^^^^^^^^^^^^^^^^^^^^^^",
        "^^^^^^^^^^^^^^^^^^^^^^^^",
        "^^^^^^^^^^^^^^^^^^^^^^^^"
      ],
      "palettes": [ "standard_domestic_palette", "standard_domestic_basement_palette" ],
      "place_nested": [
        { "chunks": [ "utility_3x3_S" ], "x": 8, "y": 7 },
        { "chunks": [ "livingroom_5x5_S_1" ], "x": [ 7, 12 ], "y": 3 },
        { "chunks": [ "basement_storage_1x1" ], "x": [ 12, 17 ], "y": 9, "repeat": [ 3, 6 ] }
      ]
    }
  },
  {
    "type": "mapgen",
    "method": "json",
    "om_terrain": "garden_house_1_roof",
    "object": {
      "fill_ter": "t_shingle_flat_roof",
      "rows": [
        "                        ",
        "                        ",
        "    ---------------     ",
        "    -.............-     ",
        "    -.............-     ",
        "    -.............-     ",
        "    -.....1.......-     ",
        "    -.............-     ",
        "    -.............-     ",
        "    -.............-     ",
        "    ---5..........-     ",
        "       -..........-     ",
        "       -..........-     ",
        "       -----......-     ",
        "           -......-     ",
        "           --------     ",
        "                        ",
        "                        ",
        "                        ",
        "                        ",
        "                        ",
        "                        ",
        "                        ",
        "                        "
      ],
      "palettes": [ "roof_palette" ],
      "terrain": { ".": "t_shingle_flat_roof" }
    }
  }
]
