[
  {
    "type": "mapgen",
    "method": "json",
    "om_terrain": [ "house_41" ],
    "object": {
      "fill_ter": "t_floor_roofed",
      "rows": [
        "......p_____!_____p.....",
        "......._____!_____......",
        "......._____!_____......",
        "...X..._____!_____..[...",
        "......._____!_____......",
        "..jjj.._____!_____......",
        ".##o##._____!_____``....",
        "^#I@I#!_____._____%`....",
        ".# @ ##*#o##.##o##%`....",
        ".o   |L Exx#.#  R##*o##.",
        ".#Dd +   l o.oI  |L  y#^",
        ".#||||  HHH#.#@@ |   To.",
        ".o8;;+     o.#@@ |x  H#.",
        ".#9tS|  sRR#.o   +   H#.",
        ".#||||  ####.#DdE|  Es#.",
        ".#17F  h#^...##|||    o.",
        ".#O;;  fo%.`YY#WZ;   R#.",
        ".o5;;  h#%.```*;;;||+|#.",
        ".#42;|;;#..``G#7;3|S;8#.",
        ".###*#WZ#..``KoO;F|t;9#.",
        "..G``####..```#42S##o##.",
        "..```.........##o##^%%..",
        ".......u..[....%%%......",
        "..[....................."
      ],
      "palettes": [ "standard_domestic_palette" ],
      "terrain": {
        "%": [ "t_region_shrub", "t_region_shrub_fruit", "t_region_shrub_decorative" ],
        "[": [ [ "t_region_tree_fruit", 2 ], [ "t_region_tree_nut", 2 ], "t_region_tree_shade" ],
        "!": "t_region_groundcover_urban",
        "#": "t_adobe_brick_wall",
        "`": "t_concrete",
        "K": "t_concrete",
        "G": "t_concrete",
        "Y": "t_concrete",
        "_": "t_pavement",
        "Z": "t_linoleum_white_roofed",
        "W": "t_linoleum_white_roofed",
        "1": "t_linoleum_white_roofed",
        "2": "t_linoleum_white_roofed",
        "3": "t_linoleum_white_roofed",
        "4": "t_linoleum_white_roofed",
        "5": "t_linoleum_white_roofed",
        "7": "t_linoleum_white_roofed",
        "8": "t_linoleum_white_roofed",
        "9": "t_linoleum_white_roofed",
        "O": "t_linoleum_white_roofed",
        "F": "t_linoleum_white_roofed",
        "S": "t_linoleum_white_roofed",
        "t": "t_linoleum_white_roofed",
        ";": "t_linoleum_white_roofed"
      },
      "furniture": { "!": "f_region_flower" },
      "place_loot": [ { "item": "television", "x": 10, "y": 9 }, { "item": "television", "x": 18, "y": 12 } ],
      "place_vehicles": [
        { "vehicle": "car", "x": 8, "y": 3, "chance": 35, "rotation": 270 },
        { "vehicle": "motorcycle_sidecart", "x": 14, "y": 2, "chance": 35, "rotation": 270 }
      ]
    }
  },
  {
    "type": "mapgen",
    "method": "json",
    "om_terrain": "house_41_roof",
    "object": {
      "fill_ter": "t_shingle_flat_roof",
      "rows": [
        "                        ",
        "                        ",
        "                        ",
        "                        ",
        "                        ",
        "                        ",
        " |2223                  ",
        " 5...3                  ",
        " |...3222223 |2223      ",
        " |.........3 |...322223 ",
        " |.=.......3 |........5 ",
        " |....X....3 |.....=..3 ",
        " |.........3 |........3 ",
        " |..N......3 |........3 ",
        " |......5--3 |...N....3 ",
        " |......3    |-.......3 ",
        " |......3     |.......3 ",
        " |...&..3     |...&...3 ",
        " |......3     |.......3 ",
        " |---|..3     |.......3 ",
        "     |--3     |...5---3 ",
        "              |---3     ",
        "                        ",
        "                        "
      ],
      "palettes": [ "roof_palette" ],
      "terrain": { ".": "t_shingle_flat_roof" }
    }
  }
]
