[
  {
    "type": "mapgen",
    "method": "json",
    "om_terrain": [ "house_42" ],
    "weight": 100,
    "object": {
      "fill_ter": "t_floor",
      "rows": [
        "............``p.........",
        "............``....[.....",
        "..##oo##o##.``..........",
        "..#REII| d#.``..%%%%%%^.",
        "..oy h + D#!``!##oooo##.",
        "..#    |||##o*##x  Es #.",
        "..# @@ |y     L|x    Ho.",
        "..#I@@ +           llH#.",
        "..#||||| hfh      HHHs#.",
        "..o8tS|  hfh          o.",
        "..#9;;+       T|  yRRR#.",
        "..#||||;;;###&##  ||||#.",
        "..#F;JJ;AJ#jj~~#  + dD#.",
        "..o5;;;;AJ#j~~~#|+|   o.",
        "..#1;;;;;J#j~~~#S;|  I#.",
        "..#23O47;Y#~~~~ot;| @@o.",
        "..##o##|;|#$$/$#BB|b I#.",
        ".....^#W;6#````#####o##.",
        "......#Z;6#.............",
        "......##*##.............",
        "...[...............[....",
        "........................",
        ".............[.....[....",
        "........................"
      ],
      "palettes": [ "standard_domestic_palette" ],
      "terrain": {
        "%": [ "t_region_shrub", "t_region_shrub_fruit", "t_region_shrub_decorative" ],
        "[": [ [ "t_region_tree_fruit", 2 ], [ "t_region_tree_nut", 2 ], "t_region_tree_shade" ],
        "!": "t_region_groundcover_urban",
        "#": "t_brick_wall",
        "&": "t_door_glass_c",
        "~": "t_thconc_floor",
        "j": "t_thconc_floor",
        "`": "t_concrete",
        "_": "t_pavement",
        ";": "t_linoleum_white",
        "J": "t_linoleum_white",
        "1": "t_linoleum_white",
        "2": "t_linoleum_white",
        "3": "t_linoleum_white",
        "4": "t_linoleum_white",
        "5": "t_linoleum_white",
        "7": "t_linoleum_white",
        "8": "t_linoleum_white",
        "O": "t_linoleum_white",
        "F": "t_linoleum_white",
        "B": "t_linoleum_white",
        "S": "t_linoleum_white",
        "t": "t_linoleum_white",
        "A": "t_linoleum_white",
        "6": "t_linoleum_white",
        "Z": "t_linoleum_white",
        "W": "t_linoleum_white",
        "9": "t_linoleum_white",
        "Y": "t_linoleum_white",
        "$": "t_screened_porch_wall",
        "/": "t_screen_door_c"
      },
      "furniture": { "!": "f_region_flower", ":": [ "f_indoor_plant", "f_indoor_plant_y" ] },
      "place_loot": [
        { "item": "hose", "x": 19, "y": 18, "chance": 35 },
        { "item": "television", "x": 16, "y": 5, "chance": 35 },
        { "item": "stereo", "x": 16, "y": 6, "chance": 35 }
      ],
      "place_vehicles": [ { "vehicle": "tricycle", "x": 13, "y": 14, "chance": 35, "rotation": 270 } ]
    }
  },
  {
    "type": "mapgen",
    "method": "json",
    "om_terrain": [ "house_42" ],
    "//": "hoarder variant",
    "weight": 1,
    "object": {
      "fill_ter": "t_floor",
      "rows": [
        "............``p.........",
        "............``....[.....",
        "..##oo##o##.``..........",
        "..#REII|!d#.``..%%%%%%^.",
        "..oy~h!+~D#0``0##oooo##.",
        "..#!!~!|||##o*##x~!Es!#.",
        "..#!@@~|y!!!!~L|x!!~!!o.",
        "..#I@@!+~!~!!~!~~!~llH#.",
        "..#|||||!hf!!!~!!~HHHs#.",
        "..o8tS|!~!fh!~~!~!!!!~o.",
        "..#9;;+~!!~~~!T|!~yRRR#.",
        "..#||||___###&##!~||||#.",
        "..#F_JJ_AJ#jj=?#!~+~dD#.",
        "..o5____AJ#j?=?#|+|!~!o.",
        "..#1_____J#?=?=#S;|!~I#.",
        "..#23O47_Y#===?ot;|!@@o.",
        "..##o##|_|#$$/$#BB|b!I#.",
        ".....^#W_6#````#####o##.",
        "......#Z_6#.............",
        "......##*##.............",
        "...[...............[....",
        "........................",
        ".............[.....[....",
        "........................"
      ],
      "palettes": [ "house_hoarder_palette" ],
      "terrain": {
        "%": [ "t_region_shrub", "t_region_shrub_fruit", "t_region_shrub_decorative" ],
        "[": [ [ "t_region_tree_fruit", 2 ], [ "t_region_tree_nut", 2 ], "t_region_tree_shade" ],
        "0": "t_region_groundcover_urban",
        "#": "t_brick_wall",
        "&": "t_door_glass_c",
        "=": "t_thconc_floor",
        "?": "t_thconc_floor",
        "j": "t_thconc_floor",
        "`": "t_concrete",
        ";": "t_linoleum_white",
        "J": "t_linoleum_white",
        "1": "t_linoleum_white",
        "2": "t_linoleum_white",
        "3": "t_linoleum_white",
        "4": "t_linoleum_white",
        "5": "t_linoleum_white",
        "7": "t_linoleum_white",
        "8": "t_linoleum_white",
        "O": "t_linoleum_white",
        "F": "t_linoleum_white",
        "B": "t_linoleum_white",
        "S": "t_linoleum_white",
        "t": "t_linoleum_white",
        "A": "t_linoleum_white",
        "6": "t_linoleum_white",
        "Z": "t_linoleum_white",
        "W": "t_linoleum_white",
        "9": "t_linoleum_white",
        "Y": "t_linoleum_white",
        "$": "t_screened_porch_wall",
        "/": "t_screen_door_c"
      },
      "furniture": { "0": "f_region_flower", ":": [ "f_indoor_plant", "f_indoor_plant_y" ] },
      "place_loot": [
        { "item": "hose", "x": 19, "y": 18, "chance": 35 },
        { "item": "television", "x": 16, "y": 5, "chance": 35 },
        { "item": "stereo", "x": 16, "y": 6, "chance": 35 }
      ],
      "place_monster": [
        { "monster": "mon_large_cockroach", "x": [ 3, 21 ], "y": [ 6, 15 ], "chance": 100, "repeat": 8 },
        { "monster": "mon_giant_cockroach", "x": [ 3, 21 ], "y": [ 6, 15 ], "chance": 50, "repeat": 2 },
        { "monster": "mon_plague_vector", "x": [ 3, 21 ], "y": [ 6, 15 ], "chance": 20 }
      ]
    }
  },
  {
    "type": "mapgen",
    "method": "json",
    "om_terrain": "house_42_roof",
    "object": {
      "fill_ter": "t_shingle_flat_roof",
      "rows": [
        "                        ",
        "                        ",
        "  |22222223             ",
        "  |.......3             ",
        "  |.......3    |2222253 ",
        "  |.......32222|......3 ",
        "  |..............X....3 ",
        "  |...................3 ",
        "  |...................3 ",
        "  |...................3 ",
        "  |...........N.......3 ",
        "  |...................3 ",
        "  |.....=.........&...3 ",
        "  |...................3 ",
        "  |...................3 ",
        "  |...................3 ",
        "  |---5...3----|......3 ",
        "      |...3    |------3 ",
        "      |...3             ",
        "      |---3             ",
        "                        ",
        "                        ",
        "                        ",
        "                        "
      ],
      "palettes": [ "roof_palette" ],
      "terrain": { ".": "t_shingle_flat_roof" }
    }
  }
]
