[
  {
    "type": "mapgen",
    "method": "json",
    "om_terrain": [ "house_15" ],
    "weight": 200,
    "object": {
      "fill_ter": "t_floor",
      "rows": [
        "......%%p------%%%......",
        ".....%''''''''''''%.....",
        "....%''''''''''''''%....",
        "...%''''''''''''''''%...",
        "..%'''''%%%%%%%%'''''%..",
        ".%'''''%!!!!!!!!%'''''%.",
        ".%''''%%#oooooo#%%''''%.",
        ".%'''%%##HHHHHH##%%'''%.",
        ".^'''%##E      E##%'''%.",
        ".#o*o##Es llll sE##*oo#.",
        ".#I  y|          34 12#.",
        ".#h @@|R  yaay       5#.",
        ".#  @@|R |||||| hffh O#.",
        ".#   d|  |L>qq| hffh F#.",
        ".# y  +             Y6#.",
        ".#+||+|||+|+||+|||+|||#.",
        ".#D|9 |   | S|   |  + #.",
        ".#v|St| @ | t| @ |WZ|$o.",
        ".###o##y@d|89|d@y##o###.",
        "......##o##o###o##...^..",
        "........................",
        "........................",
        "........................",
        "........................"
      ],
      "palettes": [ "standard_domestic_palette" ],
      "terrain": { "%": "t_region_shrub_fruit", "!": "t_region_groundcover_urban", "'": "t_concrete" },
      "furniture": { "!": "f_bluebell", "$": "f_treadmill" },
      "place_loot": [ { "group": "livingroom", "x": [ 7, 16 ], "y": [ 7, 9 ], "chance": 90, "repeat": [ 1, 6 ] } ],
      "place_monsters": [ { "monster": "GROUP_ZOMBIE", "x": [ 1, 22 ], "y": [ 2, 21 ], "chance": 5 } ]
    }
  },
  {
    "type": "mapgen",
    "method": "json",
    "om_terrain": "house_15_roof",
    "object": {
      "fill_ter": "t_shingle_flat_roof",
      "rows": [
        "                        ",
        "                        ",
        "                        ",
        "                        ",
        "                        ",
        "                        ",
        "        22222222        ",
        "       22......22       ",
        "      22........22      ",
        " 522222..........222223 ",
        " |....................3 ",
        " |.......X............3 ",
        " |....................3 ",
        " |....................3 ",
        " |.................&..3 ",
        " |....................3 ",
        " |.....=..............3 ",
        " |....................3 ",
        " |-----..........3---53 ",
        "      |----------3      ",
        "                        ",
        "                        ",
        "                        ",
        "                        "
      ],
      "palettes": [ "roof_palette" ],
      "terrain": { ".": "t_shingle_flat_roof" }
    }
  }
]
