[
  {
    "method": "json",
    "om_terrain": "house_31",
    "//": "used by lab basements.",
    "type": "mapgen",
    "weight": 100,
    "object": {
      "fill_ter": "t_floor",
      "rows": [
        "######....``.....`````..",
        "#Tii #..[.``..X..`````..",
        "#    *``````.....`````..",
        "#y  L#..%%%%..^..`````..",
        "#)]])####))))####=====##",
        "#y   EsE  s   y#~~~~~~&#",
        "#r        H   x#~~~~~~~#",
        "#r        Hl  x#~~~~~~~#",
        "#         H   x#~~~~~~~#",
        ")  hhhh        #~~~~~~~#",
        ")  ffff        +~~~~~~~#",
        ")  hhhh        #U~NN~~q#",
        "#       >RRT   #########",
        "#6  Y||||||||   | I@@I #",
        "#6  J|RIII  +   +  @@  o",
        "o7  J|  h   ||+||     b#",
        "#O  J|y    d|--t|d yE  o",
        "o3  4|@@   T|B--||+||  #",
        "#F152|I  E d|B8S|S-t|DD#",
        "###o###o##o###o#########",
        "..%%%........%%%...^....",
        "........[...............",
        ".....[......[...........",
        "...................%...."
      ],
      "palettes": [ "standard_domestic_palette" ],
      "terrain": {
        "%": [ "t_region_shrub", "t_region_shrub_fruit", "t_region_shrub_decorative" ],
        "[": [ [ "t_region_tree_fruit", 2 ], [ "t_region_tree_nut", 2 ], "t_region_tree_shade" ],
        "!": "t_region_groundcover_urban",
        "`": "t_concrete",
        "$": "t_privacy_fence",
        ";": "t_privacy_fencegate_c",
        ")": "t_wall_glass",
        "]": "t_door_glass_c",
        "-": "t_linoleum_white",
        "Q": "t_linoleum_white",
        "8": "t_linoleum_white",
        "B": "t_linoleum_white",
        "S": "t_linoleum_white",
        "9": "t_linoleum_white",
        "t": "t_linoleum_white",
        "=": "t_door_metal_locked",
        "&": "t_gates_control_brick",
        "U": "t_thconc_floor",
        "q": "t_thconc_floor",
        "N": "t_thconc_floor",
        "~": "t_thconc_floor"
      },
      "furniture": { "!": "f_region_flower" }
    }
  },
  {
    "type": "mapgen",
    "method": "json",
    "om_terrain": "house_31_roof",
    "object": {
      "fill_ter": "t_shingle_flat_roof",
      "rows": [
        "|22223                  ",
        "|....3                  ",
        "|....3                  ",
        "|....3                  ",
        "|....2222222225222222222",
        "|......................3",
        "|......................3",
        "|......................3",
        "|......................3",
        "|......................3",
        "|......................3",
        "|....X......N..........3",
        "|......................3",
        "|......................3",
        "|....................=.3",
        "|............&.........3",
        "|......................3",
        "|......................3",
        "|......................3",
        "-------------------5----",
        "                        ",
        "                        ",
        "                        ",
        "                        "
      ],
      "palettes": [ "roof_palette" ],
      "terrain": { ".": "t_shingle_flat_roof" }
    }
  }
]
