[
  {
    "type": "mapgen",
    "method": "json",
    "om_terrain": [ "house_35" ],
    "object": {
      "fill_ter": "t_floor",
      "rows": [
        "........p`..............",
        "....%%%%.`.%%%..........",
        "...##oo##`##o##````````.",
        ".###R  ¤|*|rrR#````````.",
        ".#D+  @@|÷+ h *````````.",
        ".#||d   | |E T##oo##```.",
        ".#D|||+|| |||||O152#```.",
        ".#+| +     II|F___3#```.",
        "!# d ||+|     J___7#*##.",
        "!o   |S'|H  E ____6|~~#.",
        "!#@@ |t'|H     hfh |ANo!",
        ".#¤  |BB|H     hfh |~N#!",
        ".#|||||||sHH       +~~o!",
        "!#tS|D|U|RRR |y   Y|qq#.",
        "!o''+ |+|    ||xx |####.",
        "!#BB| | +         T#^...",
        ".#|||+| ##oo###  lHo!...",
        ".#dbd   #Gyy~~*÷ lHo!...",
        ".#      o~~~~~#sHH¤#!...",
        ".o  @@ ÷*~~~~~##oo##....",
        ".# ¤@@¤ #~~y~~y$........",
        "^##o##o##$$$=$$$........",
        "...%%%%%...```.......u..",
        "........................"
      ],
      "palettes": [
        "domestic_general_and_variant_palette",
        "standard_domestic_lino_kitchen",
        "standard_domestic_lino_bathroom",
        "standard_domestic_landscaping_palette"
      ],
      "terrain": {
        "$": "t_screened_porch_wall",
        "=": "t_screen_door_c",
        "~": "t_thconc_floor",
        "A": "t_thconc_floor",
        "N": "t_thconc_floor",
        "K": "t_thconc_floor",
        "G": "t_thconc_floor",
        "y": "t_thconc_floor",
        "q": "t_thconc_floor",
        "_": { "param": "linoleum_color_kitchen", "fallback": "t_linoleum_gray" },
        "'": { "param": "linoleum_color_bathroom", "fallback": "t_linoleum_gray" }
      },
      "place_nested": [ { "chunks": [ "rolling_trash_can_1x1" ], "x": 5, "y": 0 } ],
      "place_loot": [
        { "item": "hose", "x": 9, "y": 22 },
        { "item": "television", "x": 16, "y": 14 },
        { "item": "stereo", "x": 15, "y": 14, "chance": 20 }
      ]
    }
  },
  {
    "type": "mapgen",
    "method": "json",
    "om_terrain": "house_35_roof",
    "object": {
      "fill_ter": "t_shingle_flat_roof",
      "rows": [
        "                        ",
        "                        ",
        "   ------ -----         ",
        " ---....---...-         ",
        " -............-         ",
        " -............------    ",
        " -.................-    ",
        " -.................-    ",
        " -.................---- ",
        " -....................- ",
        " -....................- ",
        " -......&.............- ",
        " -....................- ",
        " -....................- ",
        " -..........N......5--- ",
        " -.................-    ",
        " -.......=.........-    ",
        " -.................-    ",
        " -.................-    ",
        " -.............-----    ",
        " -.............-        ",
        " 5--------------        ",
        "                        ",
        "                        "
      ],
      "palettes": [ "roof_palette" ],
      "terrain": { ".": "t_shingle_flat_roof" }
    }
  }
]
