[
  {
    "type": "mapgen",
    "method": "json",
    "om_terrain": [ "house_38" ],
    "object": {
      "fill_ter": "t_floor",
      "rows": [
        "........p`!.....&`````%.",
        "....%%%.!`!..[.##=====#.",
        "...##o##!`!....#&~~~~~#.",
        "...#D d#$;$#$$$#~~~~~~#.",
        "...#D d#~~~~G::#~~~~~~#.",
        "..##|+|#*o##oo##~~~~~~#^",
        "..#BB'S|÷L| hhh#~~~~~~##",
        "..oBB't|    fff#~~~~~~U#",
        "..#BB'8|    hhh#~~~~~~~o",
        "..#||+||       #q~~~~~No",
        "..#D| R|  | RRy#q~~~~AN#",
        "..#+|  +  |||||###*#####",
        "..#    |    rrT |6'''1#.",
        "..o   d|     h   ''''O#.",
        "..#b   |   EsE   ''''2#.",
        "..o @@ |H      y|F'453#.",
        "..#¤@@¤|H  l   x##*#o##.",
        "..##oo##H  l   a#~~~~~$.",
        "....%%^#H   E  x#~~~::$.",
        ".......##oo##oo##$;$$$$.",
        ".........%%..%%..```!!!.",
        ".................`````..",
        "........................",
        "........................"
      ],
      "palettes": [
        "domestic_general_and_variant_palette",
        "standard_domestic_lino_kitchen",
        "standard_domestic_lino_bathroom",
        "standard_domestic_landscaping_palette"
      ],
      "terrain": {
        "=": "t_door_metal_locked",
        "&": "t_gates_control_concrete_lab",
        "~": "t_thconc_floor",
        "q": "t_thconc_floor",
        "U": "t_thconc_floor",
        "A": "t_thconc_floor",
        "G": "t_thconc_floor",
        "N": "t_thconc_floor",
        ":": "t_thconc_floor",
        "'": "t_linoleum_gray",
        "$": "t_screened_porch_wall",
        ";": "t_screen_door_c"
      },
      "furniture": { ":": [ "f_indoor_plant", "f_indoor_plant_y" ] },
      "place_loot": [
        { "item": "hose", "x": 19, "y": 20, "chance": 35 },
        { "item": "lawnmower", "x": 22, "y": 8, "chance": 35 },
        { "item": "television", "x": 15, "y": 16 },
        { "item": "stereo", "x": 15, "y": 18, "chance": 35 }
      ],
      "place_vehicles": [ { "vehicle": "car", "x": 19, "y": 5, "chance": 35, "rotation": 270 } ]
    }
  },
  {
    "type": "mapgen",
    "method": "json",
    "om_terrain": "house_38_roof",
    "object": {
      "fill_ter": "t_shingle_flat_roof",
      "rows": [
        "                        ",
        "               -------- ",
        "   -----       -......- ",
        "   -...---------......- ",
        "   -..................- ",
        "  --..................- ",
        "  -...................5-",
        "  -....................-",
        "  -....................-",
        "  -......X.......N.....-",
        "  -....................-",
        "  -...................--",
        "  -...................- ",
        "  -.......=.&.........- ",
        "  -...................- ",
        "  -...................- ",
        "  -...................- ",
        "  -----5..............- ",
        "       -..............- ",
        "       ---------------- ",
        "                        ",
        "                        ",
        "                        ",
        "                        "
      ],
      "palettes": [ "roof_palette" ],
      "terrain": { ".": "t_shingle_flat_roof" }
    }
  }
]
