[
  {
    "type": "mapgen",
    "method": "json",
    "om_terrain": [ "house_garage2" ],
    "weight": 300,
    "object": {
      "fill_ter": "t_floor",
      "rows": [
        "............p._______%..",
        ".$$$$$$$??$$$#=======##.",
        ".$.[...!``!..#~~~~~~~&#.",
        ".$..X..!``![.#~~~~~~~~#.",
        ".$.....!``!..#~~~~~~~~#.",
        ".$.....!``!..#~~~~~~~~#.",
        ".$.....!``!..*~~~~~~~~#.",
        ".$...[.!``!..#~~~~~~~A#.",
        ".$.....!``!..#~~~~~~~~#.",
        ".$.....!``!..#~~~~~~~q#.",
        ".$.[...!``!..#||~~~~~q#.",
        ".$.....!``!.^#>+~~~NNq#.",
        ".######o**o###||+|||||#.",
        ".#B  S|L      y   YF47#.",
        ".#B  t|  hhh         Oo.",
        ".#    +  fff         5o.",
        ".#b88Y|  hhh    66n321#.",
        ".##oo##|     |||||||||#.",
        ".....^#y      +      s#.",
        ".[....#x   H R|d    @@#.",
        "....[.#x   H R|D    @@#.",
        "..u...# EsET R|y     s#.",
        "......##oo#######oo####.",
        "........................"
      ],
      "palettes": [ "standard_domestic_palette" ],
      "terrain": {
        "%": [ "t_region_shrub", "t_region_shrub_fruit", "t_region_shrub_decorative" ],
        "[": [ [ "t_region_tree_fruit", 2 ], [ "t_region_tree_nut", 2 ], "t_region_tree_shade" ],
        "!": "t_region_groundcover_urban",
        "=": "t_door_metal_locked",
        "_": "t_pavement",
        "&": "t_gates_control_brick",
        "G": "t_sidewalk",
        "K": "t_sidewalk",
        "~": "t_thconc_floor",
        "q": "t_thconc_floor",
        "A": "t_thconc_floor",
        "N": "t_thconc_floor",
        "`": "t_concrete",
        "?": "t_fencegate_c",
        "$": "t_fence"
      },
      "furniture": { "!": "f_region_flower" },
      "place_loot": [
        { "group": "mischw", "x": [ 13, 20 ], "y": [ 2, 11 ], "chance": 80, "repeat": [ 1, 4 ] },
        { "item": "television", "x": 7, "y": 19, "chance": 100 },
        { "group": "home_hw", "x": [ 13, 20 ], "y": [ 2, 11 ], "chance": 65, "repeat": [ 1, 4 ] },
        { "group": "home_hw", "x": [ 21, 21 ], "y": [ 9, 11 ], "chance": 85, "repeat": [ 1, 2 ] }
      ],
      "place_monsters": [ { "monster": "GROUP_ZOMBIE", "x": [ 2, 21 ], "y": [ 2, 21 ], "chance": 2 } ],
      "place_vehicles": [ { "vehicle": "suburban_home", "x": 17, "y": 6, "chance": 15, "fuel": 80, "status": 0, "rotation": 90 } ]
    }
  },
  {
    "type": "mapgen",
    "method": "json",
    "om_terrain": "house_garage2_roof",
    "object": {
      "fill_ter": "t_shingle_flat_roof",
      "rows": [
        "                        ",
        "             |222222223 ",
        "             |........3 ",
        "             |........3 ",
        "             |........3 ",
        "             |........3 ",
        "             |........3 ",
        "             |........3 ",
        "             |........3 ",
        "             |........3 ",
        "             |........3 ",
        "             |........3 ",
        " |222222222225........3 ",
        " |....................3 ",
        " |....................3 ",
        " |.......&............3 ",
        " |.................=..3 ",
        " |----5...............3 ",
        "      |...............3 ",
        "      |...............3 ",
        "      |...............3 ",
        "      |...............3 ",
        "      |---------------3 ",
        "                        "
      ],
      "palettes": [ "roof_palette" ],
      "terrain": { ".": "t_shingle_flat_roof" }
    }
  }
]
