[
  {
    "type": "mapgen",
    "method": "json",
    "om_terrain": [ "house_modern_1" ],
    "weight": 200,
    "object": {
      "fill_ter": "t_floor",
      "rows": [
        "...........%....&-&....%",
        "........:..%....p-&..:.%",
        "..:........%.:..&-&....%",
        ".......:...%....&-&....%",
        "...:.......###$$#*#$$###",
        ".....jjj...#HHHHL H   a#",
        ".~~~~~~~~~~$      H  l $",
        ".~~~~~~~~~~$      H    $",
        ".~~~~~~~~~~#   H       $",
        ".~~~~~~~~~~#HHHH   sHHH$",
        ".~~______~^#M          $",
        ".####[######           #",
        ".#R     R#y    AAAAAA  #",
        ".$  eee R#     ffffff  #",
        ".$  eee  #  ############",
        ".$       #      +    y#^",
        ".#          l   #6 J y$.",
        ".#RE hE   sHHH#>#6 J 7#.",
        ".#######++#######4   3$.",
        ".#T d@@    bIIIy#1FO52#.",
        ".#D  @@      h  #######.",
        ".#E             +!tS!B#.",
        ".###$$$$$$$$$$###8!!!B#.",
        "................##$#$##."
      ],
      "palettes": [ "standard_domestic_palette" ],
      "terrain": {
        "%": [ "t_region_shrub", "t_region_shrub_fruit", "t_region_shrub_decorative" ],
        ":": [ [ "t_region_tree_fruit", 2 ], [ "t_region_tree_nut", 2 ], "t_region_tree_shade" ],
        "&": "t_region_groundcover_urban",
        "j": "t_region_groundcover_urban",
        "#": "t_rock_wall",
        "_": "t_concrete",
        "~": "t_water_pool_shallow_outdoors",
        "!": "t_linoleum_gray",
        "8": "t_linoleum_gray",
        "t": "t_linoleum_gray",
        "B": "t_linoleum_gray",
        "S": "t_linoleum_gray",
        "Q": "t_linoleum_gray",
        "$": "t_wall_glass",
        "[": "t_door_glass_c"
      },
      "furniture": { "&": "f_region_flower" },
      "place_loot": [
        { "group": "textbooks", "x": [ 2, 2 ], "y": [ 17, 17 ], "chance": 40, "repeat": [ 1, 2 ] },
        { "group": "alcohol", "x": [ 2, 2 ], "y": [ 12, 12 ], "chance": 65, "repeat": [ 1, 2 ] },
        { "group": "alcohol", "x": [ 8, 8 ], "y": [ 12, 13 ], "chance": 80, "repeat": [ 1, 3 ] },
        { "item": "katana", "x": [ 12, 12 ], "y": [ 10, 10 ], "chance": 2 },
        { "item": "katana_inferior", "x": [ 12, 12 ], "y": [ 10, 10 ], "chance": 8 },
        { "item": "spiral_stone", "x": [ 12, 12 ], "y": [ 10, 10 ], "chance": 25 }
      ],
      "place_monsters": [ { "monster": "GROUP_ZOMBIE", "x": [ 2, 21 ], "y": [ 2, 21 ], "chance": 2 } ]
    }
  },
  {
    "type": "mapgen",
    "method": "json",
    "om_terrain": "house_modern_1_roof",
    "object": {
      "fill_ter": "t_shingle_flat_roof",
      "rows": [
        "                        ",
        "                        ",
        "                        ",
        "                        ",
        "           |222222222223",
        "           |..........~3",
        "           |..oo...oo..3",
        "           |...........3",
        "           |...........3",
        "           |...........3",
        "           |...........3",
        " |2222222225......X....3",
        " |.....................3",
        " |...oooo..............3",
        " |...oooo.............53",
        " |....................3 ",
        " |....................3 ",
        " |.................=..3 ",
        " |....................3 ",
        " |.................&..3 ",
        " |....................3 ",
        " |....................3 ",
        " |--------------|.....3 ",
        "                |-----3 "
      ],
      "palettes": [ "roof_palette" ],
      "terrain": { ".": "t_shingle_flat_roof" }
    }
  },
  {
    "type": "mapgen",
    "method": "json",
    "om_terrain": "house_modern_1_basement",
    "object": {
      "fill_ter": "t_thconc_floor",
      "rows": [
        "                        ",
        "                        ",
        "                        ",
        "                        ",
        "           |||||||||||||",
        "           |2......%8.9|",
        "           |.......%S..|",
        "           |.......%8.t|",
        "           |.......%%+%|",
        "           |.......%z.U|",
        "           |.......%z.U|",
        " |||||||||||.......%%+%|",
        " |1....................|",
        " |.....................|",
        " |....................||",
        " |....................| ",
        " |...................J| ",
        " |.............<.....J| ",
        " |...................J| ",
        " |...................Z| ",
        " |...................W| ",
        " |....................| ",
        " ||||||||||||||||.F.g.| ",
        "                ||||||| "
      ],
      "palettes": [ "basement_empty" ],
      "nested": {
        "1": {
          "chunks": [
            [ "null", 60 ],
            [ "room_10x10_woodworker_E", 30 ],
            [ "room_10x10_recording_studio_E", 30 ],
            [ "room_10x10_guns_E", 10 ],
            [ "room_10x10_pool_E", 10 ]
          ]
        },
        "2": {
          "chunks": [
            [ "null", 50 ],
            [ "room_6x6_brewer_N", 10 ],
            [ "room_6x6_junk", 30 ],
            [ "room_6x6_office_N", 30 ],
            [ "6x6_sewing_open", 20 ],
            [ "6x6_electronics_open", 10 ],
            [ "room_6x6_brewer_W", 10 ],
            [ "room_6x6_junk_W", 30 ],
            [ "room_6x6_office_W", 30 ]
          ]
        }
      }
    }
  }
]
