[
  {
    "type": "mapgen",
    "method": "json",
    "om_terrain": [ "house_09" ],
    "//": "uses bionic_basement",
    "weight": 300,
    "object": {
      "fill_ter": "t_floor",
      "rows": [
        "............%%%...-p%%%.",
        "...........####oo#*####.",
        "...........#H  E     r#.",
        "...........#H       Er#.",
        "...%%%%%%.^#H  l    ||#.",
        ".####oo#####H  l     Y#.",
        ".#         |s         #.",
        ".# sHHHHs  |      h   o.",
        ".#R        +    fffh  o.",
        ".#R        |   hfff   o.",
        ".#R        |     h    o.",
        ".#v xxxx   |       y11#.",
        ".#||||||||||+|||||||||#.",
        ".o52FO    A| |Yt y  BB#.",
        ".o         + +      BBo.",
        ".o 3417 666| |8S8   BB#.",
        ".#|||||||||| |||||+|||#.",
        ".#d     IID|         so.",
        ".#@@    h  +   y     so.",
        ".#@@       | y|||+||||#.",
        ".#d       E|+||Q      #.",
        ".#     R  T|>q|UUdA ZW#.",
        ".####oo################.",
        "...................^...."
      ],
      "palettes": [ "domestic_general_and_variant_palette" ],
      "terrain": { "#": "t_adobe_brick_wall", "%": [ "t_region_shrub", "t_region_shrub_fruit", "t_region_shrub_decorative" ] },
      "place_vehicles": [ { "vehicle": "rolling_trash_can", "x": 12, "y": 1, "chance": 80, "status": 0 } ],
      "place_monsters": [
        { "monster": "GROUP_ZOMBIE", "x": [ 2, 21 ], "y": [ 2, 21 ], "chance": 2 },
        { "monster": "GROUP_PLAGUE_ROACH", "x": [ 2, 21 ], "y": [ 2, 21 ], "chance": 6 },
        { "monster": "GROUP_ROACH", "x": [ 2, 21 ], "y": [ 2, 21 ], "chance": 6 }
      ]
    }
  },
  {
    "type": "mapgen",
    "method": "json",
    "om_terrain": "house_09_roof",
    "object": {
      "fill_ter": "t_shingle_flat_roof",
      "rows": [
        "                        ",
        "           ------------ ",
        "           -..........- ",
        "           -..........- ",
        "           -..........- ",
        " ----------5..........- ",
        " -....................- ",
        " -....................- ",
        " -....................- ",
        " -....X...............- ",
        " -....................- ",
        " -....................- ",
        " -....................- ",
        " -....................- ",
        " -....................- ",
        " -....................- ",
        " -....................- ",
        " -....................- ",
        " -...&.............=..- ",
        " -....................- ",
        " -....................- ",
        " -....................- ",
        " ------------------5--- ",
        "                        "
      ],
      "palettes": [ "roof_palette" ],
      "terrain": { ".": "t_shingle_flat_roof" }
    }
  }
]
