[
  {
    "method": "json",
    "om_terrain": "house_25",
    "type": "mapgen",
    "weight": 100,
    "object": {
      "fill_ter": "t_floor",
      "rows": [
        "````````````````````````",
        "````````````````````````",
        ".........p.``...........",
        "..##oo#oo##``##oo#oo##..",
        "..#  RR r #``#hfffffy#..",
        "..oH ~~~ E#*o# h h  ho..",
        "..oH ~~~ T|  |     hho..",
        "..oH ~~~  +  +      ho..",
        "..#s ,a, y|  |y     T#..",
        "..#||||||||  ||||||||#..",
        "..# @ |I@T|  |tYS|66y#..",
        "..od@ | @ |  +  8|  Oo..",
        "..oD  |   |  |||||  no..",
        "..#   |d b|  |1234  5o..",
        "..#|+|||+||         7o..",
        ".^#          |Y JJJ F#..",
        "..#|||||+||  ||||||||#..",
        "..#      %|     |QY8B#..",
        "..o@@     ||+|| +   B#..",
        "..#@@EddDD|U q| |t8S8#..",
        "..##oo#oo######*######..",
        "...........```````.^....",
        "...........```````......",
        "........................"
      ],
      "palettes": [ "domestic_general_and_variant_palette", "standard_domestic_landscaping_palette" ],
      "terrain": { "~": "t_carpet_yellow", ",": "t_thconc_floor" },
      "place_nested": [ { "chunks": [ "rolling_trash_can_1x1" ], "x": 12, "y": 1 } ],
      "furniture": { "%": "f_safe_o" },
      "place_items": [
        { "chance": 10, "item": "ammo_rifle_common", "x": 9, "y": 17 },
        { "chance": 20, "item": "camping", "x": 13, "y": 19 },
        { "chance": 40, "item": "tools_home", "x": 13, "y": 19 },
        { "chance": 25, "item": "book_gunref", "x": 5, "y": 4 },
        { "chance": 35, "repeat": 2, "item": "book_school", "x": 6, "y": 4 },
        { "chance": 50, "item": "stash_water", "x": 11, "y": 19 },
        { "chance": 75, "item": "supplies_metal_precious", "x": 9, "y": 17 },
        { "chance": 35, "item": "child_items", "x": 5, "y": 13 },
        { "chance": 35, "item": "child_items", "x": 8, "y": 11 },
        { "chance": 55, "item": "survivor_knife", "x": 4, "y": 18 },
        { "chance": 10, "item": "gear_survival", "x": 6, "y": 17 }
      ]
    }
  },
  {
    "method": "json",
    "om_terrain": "house_25",
    "type": "mapgen",
    "weight": 20,
    "object": {
      "fill_ter": "t_floor",
      "rows": [
        "````````````````````````",
        "````````````````````````",
        ".........p.``...........",
        "..##__#__##``##__#__##..",
        "..# sHHHs #``#R     y#..",
        ".._E ~~~ E#=_#R hffh _..",
        ".._T ~~~ R#  #  hffh _..",
        ".._  ~~~  +  +  hffh _..",
        "..#M ,a, M#  #y     T#..",
        "..#########  #########..",
        "..#@@y#T@@#  #tYS#66y#..",
        ".._E  #I  #  +  8#  O_..",
        ".._   #Ih #  #####  n_..",
        "..#T d#d b#  #1234  5_..",
        "..##+###+##         7_..",
        ".^#          #Y JJJ F#..",
        "..######+##  #########..",
        "..#@@    d#     #QY8B#..",
        ".._@@    R##+## +   B#..",
        "..#s     D#U q# #t8S8#..",
        "..##__#__######/######..",
        "...........```````.^....",
        "...........```````......",
        "........................"
      ],
      "palettes": [ "standard_domestic_palette", "standard_domestic_landscaping_palette" ],
      "terrain": {
        "~": "t_carpet_yellow",
        "_": "t_window_domestic_taped",
        "=": "t_door_b_peep",
        "/": "t_door_boarded_damaged_peep",
        ",": "t_thconc_floor"
      },
      "place_items": [
        { "chance": 20, "item": "stash_wood", "x": 5, "y": 8 },
        { "chance": 20, "item": "camping", "x": 13, "y": 19 },
        { "chance": 30, "item": "tools_home", "x": 11, "y": 19 },
        { "chance": 35, "repeat": 2, "item": "book_school", "x": 14, "y": 4 },
        { "chance": 90, "item": "corpse_female", "x": 3, "y": 18 },
        { "chance": 90, "item": "corpse_female", "x": 3, "y": 10 },
        { "chance": 99, "item": "guns_rifle_milspec", "x": 3, "y": 8 },
        { "chance": 50, "item": "book_martial", "x": 14, "y": 5 },
        { "chance": 90, "item": "clothing_soldier_set", "x": 9, "y": 8 },
        { "chance": 90, "item": "corpse_male", "x": 3, "y": 17 },
        { "chance": 90, "item": "corpse_male", "x": 9, "y": 10 },
        { "chance": 55, "item": "toy_box", "x": 9, "y": 11 },
        { "chance": 25, "item": "clutter_bedroom", "x": 19, "y": 17 }
      ]
    }
  },
  {
    "type": "mapgen",
    "method": "json",
    "om_terrain": "house_25_roof",
    "object": {
      "fill_ter": "t_shingle_flat_roof",
      "rows": [
        "                        ",
        "                        ",
        "                        ",
        "  ---------  ---------  ",
        "  -.......-  -.......-  ",
        "  -.......----.......-  ",
        "  -..................-  ",
        "  -..................-  ",
        "  -..................-  ",
        "  -..................-  ",
        "  -..................-  ",
        "  -.....=.........&..-  ",
        "  -..................-  ",
        "  -..................-  ",
        "  -..................-  ",
        "  5..................-  ",
        "  -..................-  ",
        "  -....N.............-  ",
        "  -..................-  ",
        "  -..................-  ",
        "  -----------------5--  ",
        "                        ",
        "                        ",
        "                        "
      ],
      "palettes": [ "roof_palette" ],
      "terrain": { ".": "t_shingle_flat_roof" }
    }
  }
]
