[
  {
    "type": "mapgen",
    "method": "json",
    "om_terrain": [ "house_08" ],
    "weight": 300,
    "object": {
      "fill_ter": "t_floor",
      "rows": [
        ".%%%.....p.-....%%%.....",
        ".%###o####o*o##########.",
        ".%#hr E | RRRR       ho.",
        ".^# r E +HHH    lll  ho.",
        ".%#y    |            h#.",
        ".##||||+|             o.",
        ".o      |         h   o.",
        ".#E @@  |       A   A #.",
        ".o d@@s | hfh | ||JJJ|#.",
        ".#|||||+| hfh |  Y   4#.",
        ".#g|d                Oo.",
        ".#>+          |6 31F52#.",
        ".#||+|##[###[###o######.",
        ".oB8 S#%-----........^=.",
        ".#B  t#.-----.........=.",
        ".######...............=.",
        ".=....................=.",
        ".=....................=.",
        ".=....................=.",
        ".=....................=.",
        ".=....................=.",
        ".=....................=.",
        ".======================.",
        "........................"
      ],
      "palettes": [ "standard_domestic_palette" ],
      "set": [
        { "point": "terrain", "id": "t_tree_apple", "x": [ 0, 14 ], "y": [ 0, 0 ], "repeat": [ 1, 2 ] },
        { "point": "terrain", "id": "t_tree", "x": [ 2, 11 ], "y": [ 16, 21 ], "repeat": [ 2, 6 ] },
        { "point": "terrain", "id": "t_tree_young", "x": [ 2, 11 ], "y": [ 16, 21 ], "repeat": [ 3, 5 ] }
      ],
      "terrain": {
        "#": "t_rock_wall",
        "[": "t_door_glass_c",
        "=": "t_fence",
        "%": [ "t_region_shrub", "t_region_shrub_fruit", "t_region_shrub_decorative" ]
      },
      "place_loot": [
        { "group": "livingroom", "x": [ 9, 21 ], "y": [ 2, 7 ], "chance": 90, "repeat": [ 1, 4 ] },
        { "group": "guns_pistol_common", "x": 4, "y": 10, "chance": 10, "ammo": 90, "magazine": 100 }
      ],
      "place_nested": [
        {
          "chunks": [
            [ "null", 50 ],
            [ "roof_6x6_garden_4", 15 ],
            [ "roof_6x6_garden_1", 15 ],
            [ "greenhouse_6x6_herbal", 25 ],
            [ "greenhouse_6x6_vegetable", 25 ],
            [ "pond_6x6", 25 ],
            [ "shed_6x6_junk", 25 ],
            [ "shed_6x6_bike", 25 ],
            [ "shed_6x6_woodworker", 25 ]
          ],
          "x": 15,
          "y": 15
        }
      ],
      "place_monsters": [ { "monster": "GROUP_ZOMBIE", "x": [ 2, 21 ], "y": [ 2, 21 ], "chance": 2 } ]
    }
  },
  {
    "type": "mapgen",
    "method": "json",
    "om_terrain": "house_08_roof",
    "object": {
      "fill_ter": "t_shingle_flat_roof",
      "rows": [
        "                        ",
        "  |22222222222222222223 ",
        "  |...................3 ",
        "  5..............:....3 ",
        "  |...................3 ",
        " ||...................3 ",
        " |....................3 ",
        " |....................3 ",
        " |....................3 ",
        " |....................3 ",
        " |..............&.....3 ",
        " |....................3 ",
        " |....3--------------53 ",
        " |.=..3                 ",
        " |....3                 ",
        " |22223                 ",
        "                        ",
        "                        ",
        "                        ",
        "                        ",
        "                        ",
        "                        ",
        "                        ",
        "                        "
      ],
      "palettes": [ "roof_palette" ],
      "terrain": { ".": "t_shingle_flat_roof" }
    }
  },
  {
    "type": "mapgen",
    "method": "json",
    "om_terrain": "house_08_basement",
    "object": {
      "fill_ter": "t_thconc_floor",
      "rows": [
        "                        ",
        "  ||||||||||||||||||||| ",
        "  |2........1.........| ",
        "  |...................| ",
        "  |...................| ",
        " ||...................| ",
        " |z...................| ",
        " |%...................| ",
        " |g...................| ",
        " |....................| ",
        " |.....z..............| ",
        " |<..zFz..............| ",
        " |%%+%||||||||||||||||| ",
        " |....|                 ",
        " |JWZJ|                 ",
        " ||||||                 ",
        "                        ",
        "                        ",
        "                        ",
        "                        ",
        "                        ",
        "                        ",
        "                        ",
        "                        "
      ],
      "palettes": [ "basement_empty" ],
      "nested": {
        "2": {
          "chunks": [
            [ "null", 70 ],
            [ "room_6x6_guns_E", 2 ],
            [ "room_6x6_guns_S", 2 ],
            [ "room_6x6_junk_E", 30 ],
            [ "room_6x6_junk_S", 30 ],
            [ "room_6x6_office_E", 30 ],
            [ "room_6x6_office_S", 30 ],
            [ "room_6x6_brewer_E", 10 ],
            [ "room_6x6_brewer_S", 10 ]
          ]
        },
        "1": {
          "chunks": [
            [ "null", 70 ],
            [ "room_10x10_woodworker_W", 20 ],
            [ "room_10x10_guns_W", 7 ],
            [ "room_10x10_pool_W", 2 ],
            [ "room_10x10_junk_W", 30 ],
            [ "room_10x10_recording_studio_W", 20 ]
          ]
        }
      }
    }
  }
]
