[
  {
    "method": "json",
    "om_terrain": "house_duplex5",
    "type": "mapgen",
    "weight": 200,
    "object": {
      "fill_ter": "t_floor",
      "rows": [
        "....`..............`....",
        "....`..[......[....`..[.",
        ".[..`p.%%%%[.%%%%.p`....",
        "..##*###oo####oo###*##..",
        "..#y |1FO527|1O5F2| L#..",
        "..#L |3    Y|7   3| y#..",
        "..#  |4    6|4   Y|  #..",
        "..or       6|JJJ     o..",
        "..#rh    hh||AA      #..",
        "..#H     ff|         #..",
        "..oH x   hh| HHH    Eo..",
        "..oH x     |        so..",
        "..#H   TRRy|Tycry   E#..",
        ".^#y   ||||||||||   B#^.",
        "###||  |   y|@II|  ||###",
        "#8S8|  + @  |@ A+  |Q-9#",
        "#t--+ y|s@dT|d y|  +--t#",
        "#9-Q| |||||||||||| |8S8#",
        "###|| +   D|     + ||###",
        "..#U+ | @@ | @@ d| +U#..",
        "..#v| |s@@d|s@@ D| |v#..",
        "..###*##oo####oo##*###..",
        "....``GG!!....!!GK``..u.",
        "....````........````...."
      ],
      "palettes": [ "standard_domestic_palette" ],
      "terrain": {
        "%": [ "t_region_shrub", "t_region_shrub_fruit", "t_region_shrub_decorative" ],
        "[": [ [ "t_region_tree_fruit", 2 ], [ "t_region_tree_nut", 2 ], "t_region_tree_shade" ],
        "!": "t_region_groundcover_urban",
        "`": "t_concrete",
        "K": "t_concrete",
        "G": "t_concrete",
        "t": "t_linoleum_gray",
        "S": "t_linoleum_gray",
        "Q": "t_linoleum_gray",
        "8": "t_linoleum_gray",
        "9": "t_linoleum_gray",
        "-": "t_linoleum_gray"
      },
      "furniture": { "!": "f_region_flower" },
      "place_item": [
        { "item": "television", "x": 5, "y": 10 },
        { "item": "stereo", "x": 20, "y": 11 },
        { "item": "holybook_bible3", "x": 15, "y": 12 }
      ],
      "place_items": [
        { "chance": 35, "item": "bags_trip", "x": 3, "y": 20 },
        { "chance": 30, "item": "light_reading", "x": 20, "y": 11 },
        { "chance": 30, "item": "light_reading", "x": 5, "y": [ 10, 11 ] },
        { "chance": 35, "item": "tools_home", "x": 20, "y": 20 }
      ]
    }
  },
  {
    "type": "mapgen",
    "method": "json",
    "om_terrain": "house_duplex5_roof",
    "object": {
      "fill_ter": "t_shingle_flat_roof",
      "rows": [
        "                        ",
        "                        ",
        "                        ",
        "  |2222222222222222223  ",
        "  |..................3  ",
        "  |...&..............3  ",
        "  |..................3  ",
        "  |...............&..3  ",
        "  |..................3  ",
        "  |..................3  ",
        "  |..................3  ",
        "  |.....N............3  ",
        "  |...............=..3  ",
        "  |..................3  ",
        "|25..................523",
        "|......=...............3",
        "|......................3",
        "|......................3",
        "|--..................--3",
        "  |..................3  ",
        "  |..................3  ",
        "  |------------------3  ",
        "                        ",
        "                        "
      ],
      "palettes": [ "roof_palette" ],
      "terrain": { ".": "t_shingle_flat_roof" }
    }
  }
]
