[
  {
    "method": "json",
    "om_terrain": "house_03",
    "//": "normal variant",
    "type": "mapgen",
    "weight": 100,
    "object": {
      "fill_ter": "t_floor",
      "rows": [
        "....[.[.[..%`%p.[.......",
        "...........%`%........[.",
        "....X......%`%..........",
        "..........%```%.......[.",
        "....!!!..%`````%.!!!....",
        ".[##ooo###o#*####ooo##..",
        "..#457Y6|y  ÷ L|RNNNR#.[",
        "..#F   6|      +  A  o..",
        "..oO J    hfh r|Ey TP#..",
        "..o3 J    hfh  ||||||#.[",
        "[.#2 J y| |||| +----9#..",
        ".[#1   U|  k~ T|8S8tQ#..",
        ".[#||||||E l  E||||||#..",
        "..#s    + HHH  + dbDT#..",
        "..o@@  I|     R|     o..",
        "..o@@ hI###++### @@ Eo.[",
        ".^#d   D#!````!#y@@I #^.",
        "..##ooo##!`G`G!##ooo##..",
        "..........````...jjj.%..",
        "........................",
        ".................[......",
        "........................",
        "................[...[...",
        "[......................."
      ],
      "palettes": [ "domestic_general_and_variant_palette", "standard_domestic_lino_bathroom", "standard_domestic_landscaping_palette" ],
      "terrain": {
        "G": "t_concrete",
        "-": { "param": "linoleum_color_bathroom", "fallback": "t_linoleum_gray" },
        "k": "t_thconc_floor",
        "~": "t_thconc_floor"
      },
      "place_items": [ { "item": "stash_wood", "x": 12, "y": 11, "chance": 100, "repeat": [ 2, 6 ] } ],
      "place_nested": [
        {
          "chunks": [ [ "null", 25 ], [ "playset_4x4_2", 25 ], [ "firepit_5x5_1", 25 ], [ "firepit_5x5_2", 25 ], [ "playset_4x4_1", 25 ] ],
          "x": 3,
          "y": 19
        },
        { "chunks": [ "rolling_trash_can_1x1" ], "x": 3, "y": 1 }
      ]
    }
  },
  {
    "method": "json",
    "om_terrain": "house_03",
    "type": "mapgen",
    "weight": 20,
    "object": {
      "fill_ter": "t_floor",
      "rows": [
        "............-.M.........",
        "............-...........",
        ".....{{.....-...........",
        "...........---..........",
        "...C...CCC-----CC....C..",
        "..##ooo###o#*####ooo##..",
        "..#8S7,8|,,,,,,|,,,,,#..",
        "..#F,,,,|,,,,,,+,,,,,o..",
        "..oO,,,,,,,,,,,|,,XX,#..",
        "..o8,,,,,,,,,,,||||||#..",
        "..#8,,,X|,XXXX,+~~~~9#..",
        "..#8,,,X|,||||,|6s6t~#..",
        "..#||||||,,kx,,||||||#..",
        "..#,X,,,+,,,,,,+,,X,,#..",
        "..o,,,,,|,,,,,,|,,,,,o..",
        "..o,,,,,###**###,,,,,o..",
        ".^#,,,,,#cccccc#,,,,,#^.",
        "..##ooo##cccccc##ooo##..",
        ".........cccccc.........",
        "........................",
        "........................",
        "........................",
        "........................",
        "........................"
      ],
      "palettes": [ "construction_general_palette" ],
      "terrain": { "C": "t_region_groundcover_urban", "{": "t_region_groundcover_urban", "M": "t_region_groundcover_urban" }
    }
  },
  {
    "type": "mapgen",
    "method": "json",
    "om_terrain": "house_03_roof",
    "object": {
      "fill_ter": "t_shingle_flat_roof",
      "rows": [
        "                        ",
        "                        ",
        "                        ",
        "                        ",
        "                        ",
        "  --------------------  ",
        "  -..................-  ",
        "  -..................-  ",
        "  -...N........=.....-  ",
        "  -..................-  ",
        "  -..................-  ",
        "  -...........&......-  ",
        "  -..................-  ",
        "  -..................-  ",
        "  -..................-  ",
        "  -.....--------.....-  ",
        "  5.....-      -.....5  ",
        "  -------      -------  ",
        "                        ",
        "                        ",
        "                        ",
        "                        ",
        "                        ",
        "                        "
      ],
      "palettes": [ "roof_palette" ],
      "terrain": { ".": "t_shingle_flat_roof" }
    }
  }
]
