[
  {
    "type": "mapgen",
    "method": "json",
    "om_terrain": [ "house_17" ],
    "weight": 200,
    "object": {
      "fill_ter": "t_floor",
      "rows": [
        "......p..%--%...........",
        ".........%--%...........",
        ".........%--%...........",
        ".........%--%...........",
        ".........%--%...........",
        ".........%--%...........",
        ".##o#o##.%--%.##o#o##...",
        ".# @@d #.%--%.# d@@ #^..",
        ".o @@  o.%--%.o  @@ o...",
        ".#     o.%--%.o     #...",
        ".o     o.%--%.o     o...",
        ".#     #.%--%.#     #...",
        ".#+|I  ##o**o##  I|+#...",
        ".#D|I y|y    y|y I|D#...",
        ".###|+||R    R||+|||#...",
        "..^#6 6Y          |>#...",
        "...#1       HHHHH + #...",
        "...oO  CJA sH   H |q#...",
        "...o2  5JA sH l H ||#o#.",
        "...#3F47JA        +  8#.",
        "...###oo###+++##o##S Bo.",
        "..........#UZW#...#t B#.",
        "..........#####...##o##.",
        "........................"
      ],
      "palettes": [ "standard_domestic_palette" ],
      "terrain": { "%": "t_region_shrub_decorative", "#": "t_adobe_brick_wall" },
      "place_monsters": [ { "monster": "GROUP_ZOMBIE", "x": [ 2, 21 ], "y": [ 2, 21 ], "chance": 6 } ]
    }
  },
  {
    "type": "mapgen",
    "method": "json",
    "om_terrain": "house_17_roof",
    "object": {
      "fill_ter": "t_shingle_flat_roof",
      "rows": [
        "                        ",
        "                        ",
        "                        ",
        "                        ",
        "                        ",
        "                        ",
        " |222223      |222223   ",
        " |.....3      |.....5   ",
        " |..:..3      |.....3   ",
        " |.....3      |.....3   ",
        " |.....3      |..X..3   ",
        " |.....3      |.....3   ",
        " |.....3222222|.....3   ",
        " |..................3   ",
        " |-5................3   ",
        "   |................3   ",
        "   |................3   ",
        "   |....&.=.........3   ",
        "   |................323 ",
        "   |..................3 ",
        "   |------|...3---|...3 ",
        "          |...3   |...3 ",
        "          |---3   |---3 ",
        "                        "
      ],
      "palettes": [ "roof_palette" ],
      "terrain": { ".": "t_shingle_flat_roof" }
    }
  }
]
