[
  {
    "method": "json",
    "om_terrain": "house_detatched10",
    "type": "mapgen",
    "weight": 200,
    "object": {
      "fill_ter": "t_floor",
      "rows": [
        ".........``..p..........",
        "........%``.............",
        "........%``...%...[.....",
        ".[...%...``%...[...!.[..",
        ".........``%.....%......",
        "....[.!.%``...!.[.......",
        "..%......``.%......%..%.",
        ".....%.%#~~#~~#...%[%...",
        "...%%[%%~~~~~~~%........",
        "....%%%%~~~G~G~%%..%!...",
        "...######*##&###&###&##.",
        ".%.#247|   y @@   |  d#.",
        "...&O             ?   #%",
        "...#F        ss   |   #%",
        "...#153|  E       | @@#.",
        "..%#||||    HHH   | @@#.",
        "..%#B--?    ||||  ||||#.",
        ".%.#BSt|  @@|r r    rr#.",
        "..%#####/####r r     h#.",
        "....%.%%..%%#         =.",
        "..!..%%%%[..#rr       #.",
        ".....%[%!%..#######=###.",
        "..%...%........%%...%^..",
        "........................"
      ],
      "palettes": [ "standard_domestic_palette" ],
      "terrain": {
        "%": [ "t_region_shrub", "t_region_shrub_fruit", "t_region_shrub_decorative" ],
        "[": [ [ "t_region_tree_fruit", 2 ], [ "t_region_tree_nut", 2 ], "t_region_tree_shade" ],
        "!": "t_region_groundcover_urban",
        "`": "t_concrete",
        "t": "t_linoleum_gray",
        "S": "t_linoleum_gray",
        "B": "t_linoleum_gray",
        "-": "t_linoleum_gray",
        "~": "t_thconc_floor",
        "G": "t_thconc_floor",
        "&": "t_window_domestic_taped",
        "/": "t_door_boarded_damaged",
        "=": "t_window_boarded_noglass"
      },
      "furniture": { "?": "f_beaded_door", "!": "f_region_flower" },
      "place_item": [
        { "item": "splinter", "repeat": 1, "x": 2, "y": 4 },
        { "item": "splinter", "repeat": 1, "x": 17, "y": 9 },
        { "item": "television", "repeat": 1, "x": 13, "y": 13 },
        { "item": "television", "repeat": 1, "x": 20, "y": 17 },
        { "item": "splinter", "repeat": 1, "x": 1, "y": 19 },
        { "item": "splinter", "repeat": 1, "x": 10, "y": 22 }
      ],
      "place_items": [
        { "chance": 25, "item": "harddrugs", "x": 12, "y": 15 },
        { "chance": 25, "item": "harddrugs", "x": 10, "y": 14 },
        { "chance": 75, "item": "methchef", "x": [ 13, 14 ], "y": 20 },
        { "chance": 75, "item": "methchef", "x": 15, "y": [ 17, 18 ] },
        { "chance": 75, "item": "methchef", "x": 13, "y": [ 17, 18 ] },
        { "chance": 65, "item": "floor_trash", "x": 16, "y": 20 },
        { "chance": 65, "item": "floor_trash", "x": 16, "y": 17 },
        { "chance": 65, "item": "floor_trash", "x": 9, "y": 17 },
        { "chance": 65, "item": "floor_trash", "x": 15, "y": 15 },
        { "chance": 65, "item": "floor_trash", "x": 19, "y": 13 },
        { "chance": 65, "item": "floor_trash", "x": 11, "y": 13 },
        { "chance": 65, "item": "floor_trash", "x": 6, "y": 12 },
        { "chance": 65, "item": "floor_trash", "x": 17, "y": 11 },
        { "chance": 75, "item": "bed", "x": [ 10, 11 ], "y": 17 },
        { "chance": 75, "item": "bed", "x": [ 20, 21 ], "y": [ 14, 15 ] },
        { "chance": 75, "item": "bed", "x": [ 13, 14 ], "y": 11 },
        { "chance": 35, "item": "alcohol", "x": 4, "y": 11 },
        { "chance": 65, "item": "dresser_stack", "x": 21, "y": 11 },
        { "chance": 75, "item": "magazines", "x": 13, "y": 15 },
        { "chance": 65, "item": "cannedfood", "x": 4, "y": 14 }
      ],
      "place_monsters": [ { "chance": 6, "density": 0.05, "monster": "GROUP_ZOMBIE", "x": 13, "y": 4 } ]
    }
  },
  {
    "type": "mapgen",
    "method": "json",
    "om_terrain": "house_detatched10_roof",
    "object": {
      "fill_ter": "t_shingle_flat_roof",
      "rows": [
        "                        ",
        "                        ",
        "                        ",
        "                        ",
        "                        ",
        "                        ",
        "                        ",
        "        |222223         ",
        "        |.....3         ",
        "        |.....3         ",
        "   |2222|.....322222223 ",
        "   |..................3 ",
        "   |......N...........3 ",
        "   |..................3 ",
        "   |..........X.......3 ",
        "   |..................3 ",
        "   |..............&...3 ",
        "   |..................3 ",
        "   |---------....=....3 ",
        "            |.........3 ",
        "            |.........3 ",
        "            |--------53 ",
        "                        ",
        "                        "
      ],
      "palettes": [ "roof_palette" ],
      "terrain": { ".": "t_shingle_flat_roof" }
    }
  }
]
