[
  {
    "method": "json",
    "om_terrain": "house_02",
    "//": "normal variant",
    "type": "mapgen",
    "weight": 100,
    "object": {
      "fill_ter": "t_floor",
      "rows": [
        "............!`!.........",
        "...........p!`!.........",
        "..$$$$$$$$$$!`!$$$$$$$..",
        "..$.........!`!......$..",
        "..$...[.....!`!...X..$..",
        "..$......[..```......$..",
        "..##oo##oo##)*)##ooo##..",
        "..#147FO5JJ|y L|D  @@#^.",
        "..#2       |   |b  @@o%.",
        "..#3  66  Y|   |d   Io%.",
        "..#|+||||+||   +  E T#%.",
        "..#            ||||||#..",
        "..o hfh    sss +  ETR#..",
        "..o hfh   ||||||     o..",
        "..o hfh   +----| h  @o..",
        "..#      y|9S8t|II d@#..",
        "..#||   ||#######ooo##..",
        "..#y    RR#GKG/.........",
        "..#x  H   ]~~~/.........",
        "..#x  H E )~~~=.........",
        ".^#THHs rr#~~~/.........",
        "..###ooo###////.........",
        "........................",
        "........................"
      ],
      "palettes": [ "standard_domestic_palette" ],
      "terrain": {
        "%": [ "t_region_shrub", "t_region_shrub_fruit", "t_region_shrub_decorative" ],
        "[": [ [ "t_region_tree_fruit", 2 ], [ "t_region_tree_nut", 2 ], "t_region_tree_shade" ],
        "!": "t_region_groundcover_urban",
        "`": "t_concrete",
        "$": "t_fence",
        ";": "t_fencegate_c",
        "/": "t_screened_porch_wall",
        "=": "t_screen_door_c",
        "#": "t_wall_wood",
        "-": "t_linoleum_white",
        "Q": "t_linoleum_white",
        "8": "t_linoleum_white",
        "9": "t_linoleum_white",
        "S": "t_linoleum_white",
        "t": "t_linoleum_white",
        ")": "t_wall_glass",
        "]": "t_door_glass_c",
        "G": "t_thconc_floor",
        "K": "t_thconc_floor",
        "~": "t_thconc_floor"
      },
      "furniture": { "!": "f_region_flower" },
      "place_loot": [ { "item": "television", "x": 11, "y": 9 }, { "item": "stereo", "x": 10, "y": 9 } ],
      "place_nested": [
        {
          "chunks": [ [ "playset_4x4_2", 25 ], [ "firepit_5x5_1", 25 ], [ "firepit_5x5_2", 25 ], [ "playset_4x4_1", 25 ] ],
          "x": 17,
          "y": 18
        }
      ]
    }
  },
  {
    "method": "json",
    "om_terrain": "house_02",
    "//": "abandoned variant",
    "type": "mapgen",
    "weight": 20,
    "object": {
      "fill_ter": "t_floor",
      "rows": [
        "...gc.c.c...psp.c......g",
        "gc.......c.APsp.....g.c.",
        "...p.p..cppcPsp.p..pcp..",
        "...........cpsPc..c...c.",
        "...c..c..c..psp.c...g...",
        "gc.....c.g..sss.........",
        "..||00||00||0m0||000||.c",
        "..|________|___|_____|.g",
        ".c|________|___|_____0..",
        "..|________|___|_____0.c",
        "c.||dwwwwd||___d_____|g.",
        "gc|____________|wwwww|..",
        ".c0____________d_____|c.",
        "..0_______wwwww|_____0cg",
        "g.0_______d____|_____0..",
        "..|_______w____|_____|c.",
        "g.|ww___ww|||||||000||..",
        "..|_______|tttt.p.c.....",
        ".c0_______dtttt.....{c..",
        ".g0_______|tttt.........",
        "..|_______|tttt..c...gc.",
        "g.|||000|||tttt....p...g",
        "....c..g..c..c..c..cc.c.",
        "cgc.......gc.......g..g."
      ],
      "terrain": {
        ".": "t_dirt",
        "0": "t_window_frame",
        "A": "t_dirt",
        "P": "t_pit",
        "_": "t_floor",
        "c": "t_dirt",
        "d": "t_door_frame",
        "g": "t_grass",
        "m": "t_door_c",
        "p": "t_pit_shallow",
        "s": "t_sidewalk",
        "w": "t_wall_half",
        "t": "t_thconc_floor",
        "{": "t_dirt",
        "|": "t_wall_wood"
      },
      "furniture": { "A": "f_mailbox", "{": "f_dumpster" },
      "place_item": [
        { "chance": 30, "item": "2x4", "repeat": 1, "x": 4, "y": 3 },
        { "chance": 30, "item": "2x4", "repeat": 1, "x": 8, "y": 3 },
        { "chance": 30, "item": "2x4", "repeat": 1, "x": 9, "y": 3 },
        { "chance": 30, "item": "2x4", "repeat": 1, "x": 11, "y": 3 },
        { "chance": 30, "item": "2x4", "repeat": 2, "x": 17, "y": 3 },
        { "chance": 30, "item": "glass_sheet", "repeat": 4, "x": 17, "y": 7 },
        { "chance": 30, "item": "glass_sheet", "repeat": 4, "x": 19, "y": 7 },
        { "chance": 30, "item": "glass_sheet", "repeat": 1, "x": 19, "y": 13 },
        { "chance": 30, "item": "glass_sheet", "repeat": 1, "x": 17, "y": 14 },
        { "chance": 30, "item": "glass_sheet", "repeat": 3, "x": 18, "y": 14 },
        { "chance": 30, "item": "glass_sheet", "repeat": 2, "x": 19, "y": 14 },
        { "chance": 30, "item": "manual_carpentry", "repeat": 1, "x": 8, "y": 17 }
      ],
      "place_items": [
        { "chance": 30, "item": "coffee_trash", "x": 8, "y": 20 },
        { "chance": 35, "item": "building_rubble", "x": 20, "y": 17 },
        { "chance": 20, "item": "tools_common", "x": 4, "y": 20 },
        { "chance": 10, "item": "tools_common", "x": 6, "y": 8 },
        { "chance": 10, "item": "bar_trash", "x": 19, "y": 18 },
        { "chance": 10, "item": "snacks", "x": 7, "y": 20 },
        { "chance": 10, "item": "pizza_trash", "x": 16, "y": 17 },
        { "chance": 20, "item": "power_tools", "x": 11, "y": 21 },
        { "chance": 20, "item": "tools_carpentry", "x": 3, "y": 8 },
        { "chance": 10, "item": "tools_carpentry", "x": 7, "y": 7 },
        { "chance": 10, "item": "trash", "x": 20, "y": 19 },
        { "chance": 10, "item": "trash", "x": 13, "y": 19 },
        { "chance": 10, "item": "trash", "x": 21, "y": 17 },
        { "chance": 10, "item": "trash", "x": 9, "y": 4 },
        { "chance": 20, "item": "hand_tools", "x": 16, "y": 4 },
        { "chance": 20, "item": "hardware_trash", "x": 20, "y": 18 },
        { "chance": 10, "item": "hardware_trash", "x": 7, "y": 9 },
        { "chance": 35, "item": "floor_trash", "x": 19, "y": 17 },
        { "chance": 25, "item": "hardware_bulk", "x": 13, "y": 20 },
        { "chance": 25, "item": "hardware_bulk", "x": 14, "y": 21 },
        { "chance": 15, "item": "hardware_bulk", "x": 6, "y": 19 },
        { "chance": 15, "item": "hardware_bulk", "x": 13, "y": 17 },
        { "chance": 15, "item": "hardware_bulk", "x": 10, "y": 4 },
        { "chance": 15, "item": "hardware_bulk", "x": 11, "y": 4 },
        { "chance": 10, "item": "beer_selection", "x": 19, "y": 21 },
        { "chance": 25, "item": "plumbing_bulk", "x": 12, "y": 15 },
        { "chance": 15, "item": "plumbing_bulk", "x": 14, "y": 15 },
        { "chance": 15, "item": "plumbing_bulk", "x": 8, "y": 7 },
        { "chance": 20, "item": "hand_tools", "x": 11, "y": 19 },
        { "chance": 10, "item": "hand_tools", "x": 3, "y": 9 },
        { "chance": 20, "item": "tools_construction", "x": 12, "y": 21 },
        { "chance": 10, "item": "tools_construction", "x": [ 11, 12 ], "y": 17 }
      ]
    }
  },
  {
    "method": "json",
    "om_terrain": "house_02",
    "//": "empty variant",
    "type": "mapgen",
    "weight": 40,
    "object": {
      "fill_ter": "t_floor",
      "rows": [
        "...gc.c.cg.gfsfgc.g...gg",
        "g.....g..c.Pbsb..g..g.c.",
        "..----------fsf-------.g",
        ".g.c..g...gcbsbc.....gc.",
        "...cg....c..fsfgc.g.g...",
        "gc.....c.g.gsss........g",
        "g.||ww||ww||W+W||www||.c",
        "..|#CC{o&C#|___|_____|.g",
        "gc|#______#|___|_____wg.",
        ".g|#______#|___|_____w.c",
        "c.||d||||d||___d_____|gg",
        "gc|____________|||||||.g",
        ".gw____________d_____|c.",
        "..w_______||||||_____w.g",
        "g.w_______d____|_____w..",
        ".g|_______|_&_T|_____|cg",
        "g.|||___|||||||||www||g.",
        "..|_______|tttt.c.c.....",
        "gcw_______Dttttg....ac..",
        "ggw_______|tttt..g.g...g",
        "..|_______|tttt..c...gc.",
        "g.|||www|||tttt........g",
        "..g.c..g.....c.gc..cg.c.",
        "cgc.gg.g.ggc....g..g..g."
      ],
      "terrain": {
        "#": "t_floor",
        "&": "t_floor",
        "+": [ [ "t_door_locked_peep", 2 ], "t_door_locked_alarm", [ "t_door_locked", 10 ], "t_door_c" ],
        "-": "t_fence_v",
        ".": "t_dirt",
        "C": "t_floor",
        "D": "t_door_c",
        "P": "t_grass",
        "T": "t_floor",
        "W": "t_wall_glass_alarm",
        "_": "t_floor",
        "a": "t_dirt",
        "b": "t_shrub",
        "c": "t_grass",
        "d": "t_door_o",
        "f": "t_shrub",
        "g": "t_grass",
        "o": "t_floor",
        "s": "t_sidewalk",
        "t": "t_thconc_floor",
        "w": "t_window",
        "{": "t_floor",
        "|": "t_wall_wood"
      },
      "furniture": {
        "#": "f_cupboard",
        "&": "f_sink",
        "C": "f_counter",
        "P": "f_mailbox",
        "T": "f_toilet",
        "a": "f_dumpster",
        "b": "f_bluebell",
        "f": "f_dahlia",
        "o": "f_oven",
        "{": "f_fridge"
      },
      "place_item": [
        { "chance": 50, "item": "2x4", "repeat": 1, "x": 9, "y": 19 },
        { "chance": 30, "item": "101_carpentry", "repeat": 1, "x": 9, "y": 17 },
        { "chance": 50, "item": "2x4", "repeat": 4, "x": 9, "y": 20 }
      ],
      "place_items": [
        { "chance": 40, "item": "coffee_trash", "x": 19, "y": 17 },
        { "chance": 20, "item": "tools_common", "x": 8, "y": 14 },
        { "chance": 25, "item": "hardware_trash", "x": 20, "y": 17 },
        { "chance": 15, "item": "hardware_trash", "x": 16, "y": 22 },
        { "chance": 20, "item": "pizza_trash", "x": 21, "y": 18 },
        { "chance": 30, "item": "paint", "x": 3, "y": 18 },
        { "chance": 30, "item": "paint", "x": 3, "y": 19 },
        { "chance": 20, "item": "paint", "x": 3, "y": 20 },
        { "chance": 20, "item": "paint", "x": 4, "y": 19 },
        { "chance": 10, "item": "power_tools", "x": 12, "y": 17 },
        { "chance": 15, "item": "tools_carpentry", "x": 16, "y": 17 },
        { "chance": 10, "item": "hardware_trash", "x": 19, "y": 21 },
        { "chance": 10, "item": "hardware_trash", "x": 15, "y": 21 },
        { "chance": 15, "item": "bar_trash", "x": 20, "y": 18 },
        { "chance": 10, "item": "plumbing_bulk", "x": 9, "y": 15 },
        { "chance": 20, "item": "hardware_trash", "x": 22, "y": 18 },
        { "chance": 25, "item": "floor_trash", "x": 19, "y": 18 },
        { "chance": 15, "item": "hardware_bulk", "x": 11, "y": 17 },
        { "chance": 20, "item": "hand_tools", "x": 8, "y": 15 },
        { "chance": 20, "item": "tools_construction", "x": 11, "y": 20 },
        { "chance": 10, "item": "tools_construction", "x": [ 13, 15 ], "y": 17 },
        { "chance": 25, "item": "hardware", "x": 11, "y": 19 },
        { "chance": 20, "item": "hardware_plumbing", "x": 11, "y": 15 }
      ]
    }
  },
  {
    "type": "mapgen",
    "method": "json",
    "om_terrain": "house_02_roof",
    "object": {
      "fill_ter": "t_shingle_flat_roof",
      "rows": [
        "                        ",
        "                        ",
        "                        ",
        "                        ",
        "                        ",
        "                        ",
        "  |2222222222222222223  ",
        "  |..................5  ",
        "  |..................3  ",
        "  |..................3  ",
        "  |....=......N......3  ",
        "  |..................3  ",
        "  |..................3  ",
        "  |..................3  ",
        "  |..................3  ",
        "  |..................3  ",
        "  |.....&.....3------3  ",
        "  |...........3         ",
        "  |...........3         ",
        "  |...........3         ",
        "  5...........3         ",
        "  |-----------3         ",
        "                        ",
        "                        "
      ],
      "palettes": [ "roof_palette" ],
      "terrain": { ".": "t_shingle_flat_roof" }
    }
  }
]
