[
  {
    "method": "json",
    "om_terrain": "house_vacant",
    "//": "no roof, just foundation pits",
    "type": "mapgen",
    "weight": 80,
    "object": {
      "fill_ter": "t_region_soil",
      "rows": [
        "   --  --      --  --   ",
        "                  c     ",
        "  XX XX         cTTc    ",
        "- XX XX           c    -",
        "-             ||##||   -",
        "      {{      |....| 22 ",
        "  |..||||##||||....| 22 ",
        "- |................|   -",
        "- |...........|....|   -",
        "  |...........|||||| 22 ",
        "  |...........|....| 22 ",
        "  |................#   -",
        "- ||.|........|....|   -",
        "- |..|........|||||| 11 ",
        "  |..|........|....| 11 ",
        "  ||||.............#   -",
        "-    .........|....#   -",
        "-    |........|....|    ",
        "     ||||##|||||||||    ",
        "-  @@@                 -",
        "-  @@@@  sss           -",
        "  @@@@  ssss            ",
        "   @@@   ss             ",
        "   --  --  --  --  --   "
      ],
      "palettes": [ "construction_site_palette" ],
      "place_loot": [ { "item": "con_mix_foldable", "x": [ 12, 22 ], "y": [ 19, 22 ] } ],
      "place_vehicles": [ { "vehicle": "small_utility_vehicles", "x": 11, "y": 2, "chance": 70, "rotation": 0 } ]
    }
  },
  {
    "method": "json",
    "om_terrain": "house_vacant1",
    "//": "no roof, just foundation pits",
    "type": "mapgen",
    "weight": 80,
    "object": {
      "fill_ter": "t_region_soil",
      "rows": [
        "  XX  c c               ",
        "- XX  TTT              -",
        "-     c c              -",
        "  ||##|||##||           ",
        "  |.........|....||#||  ",
        "  |.........|....|...|  ",
        "- |.........|||.||...| -",
        "- #..................# -",
        "  #..................#  ",
        "  |..................|  ",
        "  |..................|  ",
        "- |||||..............| -",
        "- |..................| -",
        "  |...|..............|{ ",
        "  ||||||.|||||.||.||||{ ",
        "          |.....|....|{ ",
        "-         #.....|....# -",
        "-         #.....|....# -",
        "          #.....|....#  ",
        "          |.....|....|  ",
        "   @@     ||###|||##||  ",
        "- @@@@ sss             -",
        "- @@@@ sss   11 22 22  -",
        "   @@  sss   11 22 22   "
      ],
      "palettes": [ "construction_site_palette" ],
      "place_loot": [ { "item": "con_mix_foldable", "x": [ 1, 9 ], "y": [ 16, 19 ] } ],
      "place_vehicles": [ { "vehicle": "small_utility_vehicles", "x": 20, "y": 2, "chance": 70, "rotation": 0 } ]
    }
  },
  {
    "method": "json",
    "om_terrain": "house_vacant2",
    "//": "no roof, just foundation pits",
    "type": "mapgen",
    "weight": 80,
    "object": {
      "fill_ter": "t_region_soil",
      "rows": [
        "       .         @@     ",
        " -     . c  c   @@@@ {{ ",
        " -     . TTT    @@@  {{ ",
        "       .   c  ||##|| {{ ",
        " XX    .      |....|    ",
        " XX |||.||##|||....#    ",
        "    |..............#  - ",
        "-   |.........|....|  - ",
        "- |||.........|||||| @@ ",
        "  |...........|...| @@@@",
        "  #...............# @@@@",
        "  |...........|...|  @@ ",
        "  |||.........||.||||  -",
        "-   |.........|.....|  -",
        "-   ||..............|   ",
        "    ..........|.....|   ",
        "    .|........|.....|   ",
        "    .|........|.....|   ",
        " -  .|||||##||||###||   ",
        " -                    - ",
        "           22 22 11   - ",
        " ss        22 22 11     ",
        "ssss--            --    ",
        " ss      --   --        "
      ],
      "palettes": [ "construction_site_palette" ],
      "place_loot": [ { "item": "con_mix_foldable", "x": [ 2, 8 ], "y": [ 19, 21 ] } ],
      "place_vehicles": [ { "vehicle": "small_utility_vehicles", "x": 5, "y": 2, "chance": 70, "rotation": 0 } ]
    }
  },
  {
    "method": "json",
    "om_terrain": "house_vacant3",
    "//": "no roof, just foundation pits",
    "type": "mapgen",
    "weight": 80,
    "object": {
      "fill_ter": "t_region_soil",
      "rows": [
        "         --  --  --  -- ",
        "               c      X ",
        "               TTc   X  ",
        "              cTT  @   X",
        "                c @@@   ",
        "     ss            @    ",
        " 11 sss |||||||..||##|| ",
        " 11 ss  |.....|..|....| ",
        "        |.....|..|....| ",
        " 22 22  #........|....# ",
        " 22 22  |.....|.......| ",
        "        |.....|..|....| ",
        " |......||##|.|..|||||| ",
        " |......|........|....| ",
        "{|......|.............| ",
        "{|......|........|....# ",
        "{|......|........|....| ",
        " |......|........|....| ",
        " |...............|||||| ",
        " |......|........|....| ",
        " |......|.............| ",
        " |......|........|....| ",
        " ||||||||||####|||||||| ",
        "                        "
      ],
      "palettes": [ "construction_site_palette" ],
      "place_loot": [ { "item": "con_mix_foldable", "x": [ 7, 13 ], "y": [ 1, 5 ] } ],
      "place_vehicles": [ { "vehicle": "small_utility_vehicles", "x": 4, "y": 4, "chance": 70, "rotation": 90 } ]
    }
  }
]
