[
  {
    "type": "mapgen",
    "method": "json",
    "om_terrain": [ [ "house_44_0_0", "house_44_0_1" ] ],
    "object": {
      "fill_ter": "t_floor",
      "rows": [
        "..%.p``......%......%..................[........",
        ".....``........[......%.........%...........%...",
        "%....``....%..............[.......%.......[.....",
        "..%..`````````````````````````````````````^.....",
        "##o##**#####o####ooo###oo###´´´´´´´´##oo##*##oo#",
        "#R R|÷÷|tS|Q~~Q|n   F|P Trro´´´´´´´´#NNNN|÷ |rr#",
        "#R H|  +~~|Q~~B|2   Y|P  hro´´´´´´´´#N h |  |hr#",
        "#a H|  ||||~~~B|3   O|P  rr#´´´´´´´´#Nh  |  | T#",
        "#T H| L|~~~~~~~|4   C|R  ||#´´´´´´´´#P  U|  | P#",
        "#R H| L|9~8SS~~|1   C|R  +Z#´´´´´´´´#P  U|  | y#",
        "#R R|+||||||||+|7   C|R  |W#´´´´´´´´#C   + <|  #",
        "#   k               y|||+||#´´´´´´´´#C   ||||  #",
        "#y          hhhhh   y|D  66#´´´´´´´´#C   +  |  #",
        "oH  ||||V   sssss   <|D   6#´´´´´´´´#y   |St|  #",
        "oHf x|v|V   sssss    |D   6#´´´´´´´´:    |||| R#",
        "oH  x|6|y   hhhhh    |é   ÷*´´´´´´´´¶÷        R#",
        "#HHTy| + ÷           +     #´´´´´´´´:y        y#",
        "#########*#ooo###ooo###ooo##´´´´´´´´###:¶::::::#",
        "Ŧ^...```````````````````````````````.........[.Ŧ",
        "Ŧ....```````````````````````````````.....%.....Ŧ",
        "Ŧ.[..```````````....................[..........Ŧ",
        "Ŧ....```````````.....[...........%.............Ŧ",
        "Ŧ....[.................%....[..................Ŧ",
        "ŦŦŦŦŦŦŦŦŦŦŦŦŦŦŦŦŦŦŦŦŦŦŦŦŦŦŦŦŦŦŦŦŦŦŦŦŦŦŦŦŦŦŦŦŦŦŦŦ"
      ],
      "palettes": [
        "standard_domestic_landscaping_palette",
        "standard_domestic_lino_bathroom",
        "domestic_general_construction_and_variant_palette"
      ],
      "terrain": { "´": "t_thconc_floor" }
    }
  },
  {
    "type": "mapgen",
    "method": "json",
    "om_terrain": [ [ "house_44_1_0", "house_44_1_1" ] ],
    "object": {
      "fill_ter": "t_floor",
      "rows": [
        ",,,,,,,,,,,,,,,,,,,,,,,,,,,,,,,,,,,,,,,,,,,,,,,,",
        ",,,,,,,,,,,,,,,,,,,,,,,,,,,,,,,,,,,,,,,,,,,,,,,,",
        ",,,,,,,,,,,,,,,,,,,,,,,,,,,,,,,,,,,,,,,,,,,,,,,,",
        ",,,,,,,,,,,,,,,,,,,,,,,,,,,,,,,,,,,,,,,,,,,,^,,,",
        "######oo#######oo#########oo#####oo#####ooooooo#",
        "#¤@@¤yrP|DD|~S88SB|St|Pr_¤@@TRRRRyyVVVVVRRETEy_#",
        "#_@@__rh|_D|~~~~~B|~~|hr__@@___________________#",
        "#____Yr_+_D|~~~~~9|~~|_________________________#",
        "o_______||||+|||||||+|||||||||||||+||||||||||||#",
        "o_______|___________________________________+_q#",
        "#CCCCC__+__________________________________>|_q#",
        "#||||||||+|||||||____|||+|||||||||+||||||||||_q#",
        "oyrrT_DD__|DDD@@|+||_|y___DDD____|___MMM___y|_q#",
        "o_________|___@@¤__|>|x_________¤|_________E|_6#",
        "#_________|R_______|_|x________@@|___eee___T|_6#",
        "#_@@__Yrrr|Rhr___ET|_|x_____h__@@|___eee___E|_6#",
        "#¤@@¤___h_|Y_r_yRRR|y|y____rrr__¤|y________y|_g#",
        "####oo########oo###########ooo##########oo######",
        "^,,,,,,,,,,,,,,,,,,,,,,,,,,,,,,,,,,,,,,,,,,,,,,,",
        ",,,,,,,,,,,,,,,,,,,,,,,,,,,,,,,,,,,,,,,,,,,,,,,,",
        ",,,,,,,,,,,,,,,,,,,,,,,,,,,,,,,,,,,,,,,,,,,,,,,,",
        ",,,,,,,,,,,,,,,,,,,,,,,,,,,,,,,,,,,,,,,,,,,,,,,,",
        ",,,,,,,,,,,,,,,,,,,,,,,,,,,,,,,,,,,,,,,,,,,,,,,,",
        ",,,,,,,,,,,,,,,,,,,,,,,,,,,,,,,,,,,,,,,,,,,,,,,,"
      ],
      "palettes": [ "standard_domestic_lino_bathroom", "domestic_general_construction_and_variant_palette" ],
      "terrain": { "_": "t_floor", ",": "t_open_air" }
    }
  },
  {
    "type": "mapgen",
    "method": "json",
    "om_terrain": [ [ "house_44_roof_0", "house_44_roof_1" ] ],
    "object": {
      "fill_ter": "t_flat_roof",
      "rows": [
        "                                                ",
        "                                                ",
        "                                                ",
        "                                                ",
        "--------------------------------------------5---",
        "-..............................................-",
        "-..............................................-",
        "-........................................3.....-",
        "-~...1..........................8..............-",
        "-..............................................-",
        "-..............................................-",
        "-........~A..........................1.........-",
        "-..............................................-",
        "-..............................................-",
        "-..............................................-",
        "-..............................................-",
        "-..............................................-",
        "5-----------------------------------------------",
        "                                                ",
        "                                                ",
        "                                                ",
        "                                                ",
        "                                                ",
        "                                                "
      ],
      "palettes": [ "roof_palette" ]
    }
  }
]
