[
  {
    "type": "mapgen",
    "method": "json",
    "om_terrain": [ "house" ],
    "weight": 175,
    "object": {
      "fill_ter": "t_floor",
      "rows": [
        "..................%.....",
        ".%.....%.............%..",
        "........................",
        "...(((....1111..$.(((...",
        ".|((6((|||1111|||((e((|.",
        ".|666K66S||~~||RRg999b|.",
        ".|N6666mm|C  z|RR99e9a|.",
        ".(66666mm|C   |g999e9c|.",
        ".(666666S|C   | 999e9d(.",
        ".|Dnnn666|      99999U(.",
        ".||||||/||      99999p|.",
        ".|x          q|F      |.",
        ".|x          q|F     x|.",
        ".||/|||||||  |||||888x|.",
        ".|77ooZZ|W| f|k0B|888x|.",
        ".(777777/7| z|l0B|q888(.",
        ".(G77777|||_(||00/8888(.",
        ".|w777VVV|#11#|X0|YYY8|.",
        ".|wQ77VVV|#11#|i0|uuu8|.",
        ".|w77777T|#11#|hh|8888|.",
        ".||777||||#11#||||fff||.",
        "..((7((....11....((q((..",
        "...(((..%..11..%..(((...",
        "...........11A.........."
      ],
      "palettes": [ "lsm_singlestory_urban" ],
      "terrain": {
        "6": "t_carpet_purple",
        "7": "t_carpet_red",
        "8": "t_null",
        "9": "t_null",
        "o": "t_carpet_red",
        "Q": "t_carpet_red",
        "w": "t_carpet_red",
        "T": "t_carpet_red",
        "B": "t_linoleum_gray",
        "V": "t_carpet_red",
        "G": "t_carpet_red",
        "Z": "t_carpet_red",
        "S": "t_carpet_purple",
        "K": "t_carpet_purple",
        "m": "t_carpet_purple",
        "n": "t_carpet_purple",
        "D": "t_carpet_purple",
        "N": "t_carpet_purple",
        "X": "t_linoleum_gray",
        "k": "t_linoleum_gray",
        "l": "t_linoleum_gray",
        "W": "t_carpet_red"
      },
      "furniture": {
        "Q": "f_chair",
        "R": "f_table",
        "S": "f_table",
        "T": "f_table",
        "U": "f_cupboard",
        "V": "f_bed",
        "W": "f_gunsafe_ml",
        "X": "f_cupboard",
        "Y": "f_table",
        "Z": "f_dresser"
      },
      "toilets": { "t": {  } },
      "items": {
        "X": { "item": "bathroom_medicine_cabinet", "chance": 50 },
        "Y": { "item": "livingroom_table_LSM", "chance": 30 },
        "R": { "item": "diningroom_table", "chance": 30 },
        "d": { "item": "kitchen_cupboard_food", "chance": 30 },
        "U": { "item": "kitchen_misc_drawers", "chance": 30 },
        "T": { "item": "nightstand", "chance": 30 },
        "6": { "item": "clutter_bedroom", "chance": 5 },
        "B": { "item": "tools_homerepair_junk", "chance": 20 },
        "8": { "item": "livingroom_table_LSM", "chance": 5 },
        "9": { "item": "kitchen", "chance": 5 },
        "S": { "item": "nightstand", "chance": 30 },
        "V": { "item": "bed", "chance": 30 },
        "Z": { "item": "dresser", "chance": 30 },
        "7": { "item": "clutter_bedroom", "chance": 5 }
      },
      "place_loot": [
        { "item": "mp3", "x": [ 8, 8 ], "y": [ 5, 5 ], "chance": 100 },
        { "group": "boxing_books", "x": [ 3, 5 ], "y": [ 9, 9 ], "chance": 20, "repeat": [ 1, 2 ] },
        { "item": "mag_porn", "x": [ 3, 5 ], "y": [ 9, 9 ], "chance": 80 },
        { "group": "stoner", "x": [ 3, 5 ], "y": [ 9, 9 ], "chance": 30, "repeat": [ 1, 3 ] },
        { "group": "table_foyer", "x": [ 12, 12 ], "y": [ 14, 14 ], "chance": 25 },
        { "group": "book_gunref", "x": [ 2, 2 ], "y": [ 11, 12 ], "chance": 20 },
        { "item": "glock_17", "x": [ 15, 15 ], "y": [ 11, 12 ], "chance": 100 },
        { "item": "9mm", "x": [ 15, 15 ], "y": [ 11, 12 ], "chance": 100 },
        { "item": "glockmag", "x": [ 15, 15 ], "y": [ 11, 12 ], "chance": 100 },
        { "group": "guns_pistol_obscure", "x": 9, "y": 14, "chance": 10 },
        { "item": "file", "x": [ 2, 2 ], "y": [ 16, 19 ], "chance": 30, "repeat": [ 2, 4 ] },
        { "item": "pills_sleep", "x": [ 8, 8 ], "y": [ 19, 19 ], "chance": 60 },
        { "item": "television", "x": [ 19, 19 ], "y": [ 20, 20 ], "chance": 100 }
      ],
      "rotation": [ 2 ]
    }
  },
  {
    "type": "mapgen",
    "method": "json",
    "om_terrain": [ "house" ],
    "weight": 25,
    "object": {
      "fill_ter": "t_floor",
      "rows": [
        "..................%.....",
        ".%.....%.............%..",
        "........................",
        "...(((....1111..$.(((...",
        ".|((6((|||1111|||((e((|.",
        ".|666K66S||~~||RRg999b|.",
        ".|N6666mm|C  z|RR99e9a|.",
        ".(66666mm|C   |g999e9c|.",
        ".(666666S|C   | 999e9d(.",
        ".|Dnnn666|      99999U(.",
        ".||||||`||      99999p|.",
        ".|x          q|F      |.",
        ".|x          q|F     x|.",
        ".||`|||||||  |||||888x|.",
        ".|77ooZZ|W| f|k0B|888x|.",
        ".(777777/7| z|l0B|q888(.",
        ".(G77777|||-(||00-8888(.",
        ".|w777VVV|#11#|X0|YYY8|.",
        ".|wQ77VVV|#11#|i0|uuu8|.",
        ".|w77777T|#11#|hh|8888|.",
        ".||777||||#11#||||fff||.",
        "..((7((....11....((q((..",
        "...(((..%..11..%..(((...",
        "...........11A.........."
      ],
      "palettes": [ "lsm_singlestory_urban" ],
      "terrain": {
        "6": "t_carpet_purple",
        "7": "t_carpet_red",
        "8": "t_null",
        "9": "t_null",
        "o": "t_carpet_red",
        "Q": "t_carpet_red",
        "w": "t_carpet_red",
        "T": "t_carpet_red",
        "B": "t_linoleum_gray",
        "V": "t_carpet_red",
        "G": "t_carpet_red",
        "Z": "t_carpet_red",
        "S": "t_carpet_purple",
        "K": "t_carpet_purple",
        "m": "t_carpet_purple",
        "n": "t_carpet_purple",
        "D": "t_carpet_purple",
        "N": "t_carpet_purple",
        "X": "t_linoleum_gray",
        "k": "t_linoleum_gray",
        "l": "t_linoleum_gray",
        "-": "t_door_frame",
        "`": [ "t_door_b", "t_door_o" ]
      },
      "furniture": {
        "Q": "f_table",
        "R": "f_table",
        "S": "f_table",
        "T": "f_table",
        "U": "f_cupboard",
        "V": "f_bed",
        "W": "f_gunsafe_ml",
        "X": "f_cupboard",
        "Y": "f_table",
        "Z": "f_dresser"
      },
      "toilets": { "t": {  } },
      "items": {
        "X": { "item": "bathroom_medicine_cabinet", "chance": 50 },
        "Y": { "item": "livingroom_table_LSM", "chance": 30 },
        "R": { "item": "diningroom_table", "chance": 30 },
        "d": { "item": "kitchen_cupboard_food", "chance": 30 },
        "U": { "item": "kitchen_misc_drawers", "chance": 30 },
        "T": { "item": "nightstand", "chance": 30 },
        "6": { "item": "clutter_bedroom", "chance": 5 },
        "B": { "item": "tools_homerepair_junk", "chance": 20 },
        "8": { "item": "livingroom_table_LSM", "chance": 5 },
        "9": { "item": "kitchen", "chance": 5 },
        "S": { "item": "nightstand", "chance": 30 },
        "V": { "item": "bed", "chance": 30 },
        "Z": { "item": "dresser", "chance": 30 },
        "7": { "item": "clutter_bedroom", "chance": 5 }
      },
      "place_loot": [
        { "item": "mp3", "x": [ 8, 8 ], "y": [ 5, 5 ], "chance": 100 },
        { "group": "boxing_books", "x": [ 3, 5 ], "y": [ 9, 9 ], "chance": 20, "repeat": [ 1, 2 ] },
        { "item": "mag_porn", "x": [ 3, 5 ], "y": [ 9, 9 ], "chance": 80 },
        { "group": "stoner", "x": [ 3, 5 ], "y": [ 9, 9 ], "chance": 30, "repeat": [ 1, 3 ] },
        { "group": "table_foyer", "x": [ 12, 12 ], "y": [ 14, 14 ], "chance": 25 },
        { "group": "book_gunref", "x": [ 2, 2 ], "y": [ 11, 12 ], "chance": 20 },
        { "item": "glock_17", "x": [ 15, 15 ], "y": [ 11, 12 ], "chance": 100 },
        { "item": "9mm", "x": [ 15, 15 ], "y": [ 11, 12 ], "chance": 100 },
        { "item": "glockmag", "x": [ 15, 15 ], "y": [ 11, 12 ], "chance": 100 },
        { "group": "guns_pistol_obscure", "x": 9, "y": 14, "chance": 10 },
        { "item": "file", "x": [ 2, 2 ], "y": [ 16, 19 ], "chance": 30, "repeat": [ 2, 4 ] },
        { "item": "pills_sleep", "x": [ 8, 8 ], "y": [ 19, 19 ], "chance": 60 },
        { "item": "television", "x": [ 19, 19 ], "y": [ 20, 20 ], "chance": 100 },
        { "item": "9mm_casing", "x": [ 9, 14 ], "y": [ 17, 21 ], "chance": 50, "repeat": [ 8, 13 ] },
        { "item": "2x4", "x": 11, "y": [ 15, 17 ], "chance": 75, "repeat": [ 2, 3 ] },
        { "item": "hinge", "x": 11, "y": 15, "chance": 100, "repeat": [ 1 ] },
        { "item": "splinter", "x": 11, "y": 15, "chance": 100, "repeat": [ 1 ] },
        { "item": "corpse", "x": 16, "y": 19, "chance": 100 },
        { "item": "rag_bloody", "x": 16, "y": 19, "chance": 75, "repeat": [ 4, 5 ] },
        { "group": "clothing_outdoor_set", "x": 16, "y": 16, "chance": 100 },
        { "item": "9mm_casing", "x": [ 14, 16 ], "y": [ 16, 17 ], "chance": 50, "repeat": [ 8, 13 ] },
        { "item": "2x4", "x": 17, "y": 16, "chance": 75, "repeat": [ 2, 3 ] },
        { "item": "hinge", "x": 17, "y": 16, "chance": 100 },
        { "item": "splinter", "x": 17, "y": 16, "chance": 100 },
        { "item": "2x4", "x": [ 18, 20 ], "y": 17, "chance": 100, "repeat": [ 3, 4 ] },
        { "item": "splinter", "x": [ 18, 20 ], "y": 17, "chance": 50, "repeat": [ 4, 5 ] }
      ],
      "place_monsters": [ { "monster": "GROUP_ZOMBIE", "x": [ 10, 10 ], "y": [ 21, 21 ], "chance": 100 } ],
      "rotation": [ 2 ]
    }
  }
]
