[
  {
    "type": "mapgen",
    "method": "json",
    "om_terrain": [ "house_11" ],
    "weight": 300,
    "object": {
      "fill_ter": "t_floor",
      "rows": [
        "ŦŦŦŦŦŦŦŦŦŦŦ--ŦŦ______ŦŦŦ",
        "Ŧ..........--.p______..Ŧ",
        "Ŧ...%%%....--..______..Ŧ",
        "Ŧ.##o#o##..--..______..Ŧ",
        "Ŧ.#T   y#%.--..______..Ŧ",
        "Ŧ.#@@  I#%.----______..Ŧ",
        "Ŧ.#@@ AI#%.--##======#.Ŧ",
        "Ŧ.#    d#%.--#&~~~~~~#.Ŧ",
        "Ŧ.#d    #^.--#q~~~~~~#.Ŧ",
        "Ŧ.#|+|+|#o#**##~~~~~~#.Ŧ",
        "Ŧ.#Dz| HHH   y|~~~~~~#.Ŧ",
        "Ŧ.#|||       R|~~~~~~#.Ŧ",
        "Ŧ.#S |       R|~~~~~~#.Ŧ",
        "Ŧ.#8 +        |~~~~~~#.Ŧ",
        "Ŧ.#t |    hh  +~~~~~~#.Ŧ",
        "Ŧ.#BB| xx ff  |+|~~~~#.Ŧ",
        "Ŧ.#||| || ff  |>|qqqq#.Ŧ",
        "Ŧ.#1   6| hh  ########.Ŧ",
        "Ŧ.o5   A|     *------..Ŧ",
        "Ŧ.o3    ##:::##------..Ŧ",
        "Ŧ.#74O2F#^.....-GKG--..Ŧ",
        "Ŧ.###oo##......------..Ŧ",
        "Ŧ......................Ŧ",
        "ŦŦŦŦŦŦŦŦŦŦŦŦŦŦŦŦŦŦŦŦŦŦŦŦ"
      ],
      "palettes": [ "domestic_general_and_variant_palette", "standard_domestic_landscaping_palette" ],
      "terrain": {
        "=": "t_door_metal_locked",
        "&": "t_gates_control_brick",
        "G": "t_sidewalk",
        "K": "t_sidewalk",
        "~": "t_thconc_floor",
        "q": "t_thconc_floor"
      },
      "place_loot": [
        { "group": "livingroom", "x": [ 6, 12 ], "y": [ 10, 15 ], "chance": 90, "repeat": [ 1, 4 ] },
        { "group": "guns_pistol_common", "x": [ 3, 3 ], "y": [ 8, 8 ], "chance": 5, "ammo": 90, "magazine": 100 }
      ],
      "place_monsters": [ { "monster": "GROUP_ZOMBIE", "x": [ 2, 21 ], "y": [ 2, 21 ], "chance": 2 } ],
      "place_vehicles": [ { "vehicle": "suburban_home", "x": 17, "y": 10, "chance": 15, "rotation": 270 } ],
      "place_nested": [ { "chunks": [ "rolling_trash_can_1x1" ], "x": 5, "y": 1 } ]
    }
  },
  {
    "type": "mapgen",
    "method": "json",
    "om_terrain": "house_11_roof",
    "object": {
      "fill_ter": "t_shingle_flat_roof",
      "rows": [
        "                        ",
        "                        ",
        "                        ",
        "  -------               ",
        "  -.....-               ",
        "  -.....-               ",
        "  -.....-    ---------  ",
        "  -.....-    -.......-  ",
        "  -.....-    -.......-  ",
        "  -.....5-----.......-  ",
        "  -..................-  ",
        "  -..................-  ",
        "  -..................-  ",
        "  -..................-  ",
        "  -..................-  ",
        "  -.............&....-  ",
        "  -..................-  ",
        "  -...........--------  ",
        "  -...........-         ",
        "  -..=..5------         ",
        "  -.....-               ",
        "  -------               ",
        "                        ",
        "                        "
      ],
      "palettes": [ "roof_palette" ],
      "terrain": { ".": "t_shingle_flat_roof" }
    }
  },
  {
    "type": "mapgen",
    "method": "json",
    "om_terrain": "house_11_basement",
    "object": {
      "fill_ter": "t_thconc_floor",
      "rows": [
        "                        ",
        "                        ",
        "                        ",
        "  |||||||               ",
        "  |.....|               ",
        "  |.....|               ",
        "  |.....|    |||||||||  ",
        "  |.....|    |1......|  ",
        "  |.....|    |.......|  ",
        "  |.....||||||.......|  ",
        "  |2.................|  ",
        "  |..................|  ",
        "  |..................|  ",
        "  |..................|  ",
        "  |..............A..W|  ",
        "  |...........%.....Z|  ",
        "  |..........z%<.zJJJ|  ",
        "  |..........z||||||||  ",
        "  |.........gF|         ",
        "  |.....|||||||         ",
        "  |.....|               ",
        "  |||||||               ",
        "                        ",
        "                        "
      ],
      "palettes": [ "basement_empty" ],
      "nested": {
        "1": {
          "chunks": [
            [ "null", 60 ],
            [ "room_7x7_wine_cellar_S", 10 ],
            [ "room_7x7_recroom_S", 30 ],
            [ "7x7_tent_indoors", 5 ],
            [ "6x6_sewing_open", 20 ],
            [ "6x6_electronics_open", 10 ]
          ]
        },
        "2": { "chunks": [ [ "null", 80 ], [ "room_9x9_cellar_E", 20 ], [ "room_9x9_weed_E", 5 ], [ "room_9x9_recroom_E", 20 ] ] }
      }
    }
  }
]
