[
  {
    "type": "mapgen",
    "method": "json",
    "om_terrain": "house_w_5",
    "object": {
      "fill_ter": "t_floor",
      "rows": [
        "...[....``G......``.``..",
        ".[...%µ````µ%..[.``.``..",
        "....%````````%...``.``u.",
        "..##oo##*####o###£££££##",
        "..#è      |yà  #~~~~~~u#",
        "..#            #~~~~~~U#",
        "..#        Y   #~~~~~~~o",
        "..#       |||||#~~~~~~U#",
        "..#       +w|>w#~~~~~~~o",
        "..#|||||  |||+|#~~~~~~U#",
        "..#é           *~~~~~UU#",
        ".%o      ||||||##~#o####",
        ".po      | &   #```````.",
        ".%o      |     o%`p[p``.",
        ".^#      |     op``````.",
        "### |||  |     #........",
        "#F1      |+|||+#........",
        "o2   1|    |D|D#........",
        "o5   O||+|+|+||#........",
        "#3 4y |t |ç    #........",
        "#| || |B |   § o........",
        "#6s6| |Bi|     #........",
        "##o##*##o###o###........",
        "..%.````................"
      ],
      "palettes": [ "domestic_general_and_variant_palette", "standard_domestic_landscaping_palette" ],
      "terrain": {
        "µ": "t_column",
        "£": "t_door_metal_locked",
        "U": "t_thconc_floor",
        "~": "t_thconc_floor",
        "ù": "t_region_groundcover_urban"
      },
      "furniture": { "ù": "f_region_weed" },
      "place_vehicles": [
        { "vehicle": "showroom_small_vehicles", "x": 17, "y": 7, "rotation": 270, "chance": 20, "status": 0 },
        { "vehicle": "showroom_small_vehicles", "x": 19, "y": 7, "rotation": 270, "chance": 20, "status": 0 }
      ],
      "nested": {
        "&": {
          "chunks": [
            [ "bedroom_4x4_adult_1_E", 20 ],
            [ "bedroom_4x4_adult_1_N", 20 ],
            [ "bedroom_4x4_adult_2_E", 20 ],
            [ "bedroom_4x4_adult_2_N", 20 ]
          ]
        },
        "é": { "chunks": [ [ "diningroom_5x5_N_S", 50 ], [ "diningroom_5x5_E_W", 50 ] ] },
        "§": {
          "chunks": [ [ "bonus_room_2x2_2", 50 ], [ "bonus_room_2x2_3", 50 ], [ "bonus_room_2x2_4_S", 50 ], [ "bonus_room_2x2_4_E", 50 ] ]
        },
        "è": {
          "chunks": [
            [ "livingroom_5x5_N_1", 20 ],
            [ "livingroom_5x5_S_1", 20 ],
            [ "livingroom_5x5_E_1", 20 ],
            [ "livingroom_5x5_W_1", 20 ]
          ]
        },
        "ç": {
          "chunks": [ [ "bonus_room_3x3_1", 40 ], [ "bonus_room_3x3_S_5", 20 ], [ "bonus_room_3x3_E_7", 40 ], [ "bonus_room_3x3_S_7", 40 ] ]
        },
        "à": {
          "chunks": [
            [ "bonus_room_3x3_4", 20 ],
            [ "bonus_room_3x3_E_6", 20 ],
            [ "bonus_room_3x3_S_6", 20 ],
            [ "bonus_room_3x3_E_8", 30 ],
            [ "bonus_room_3x3_S_8", 30 ]
          ]
        }
      },
      "place_nested": [
        {
          "chunks": [
            [ "null", 50 ],
            [ "roof_6x6_garden_4", 15 ],
            [ "roof_6x6_garden_1", 15 ],
            [ "greenhouse_6x6_herbal", 25 ],
            [ "greenhouse_6x6_vegetable", 25 ],
            [ "pond_6x6", 25 ],
            [ "shed_6x6_junk", 25 ],
            [ "shed_6x6_woodworker", 25 ]
          ],
          "x": 17,
          "y": 15
        }
      ]
    }
  },
  {
    "type": "mapgen",
    "method": "json",
    "om_terrain": "house_w_5_roof",
    "object": {
      "fill_ter": "t_shingle_flat_roof",
      "rows": [
        "                        ",
        "      ......            ",
        "      ......            ",
        "  ----------------------",
        "  -....................-",
        "  -.X..................-",
        "  -....................-",
        "  -.........&..........-",
        "  -....................-",
        "  -....................-",
        "  -....................-",
        "  -............---------",
        "  -............-        ",
        "  -............-        ",
        "  -............-        ",
        "--5............-        ",
        "-..............-        ",
        "-..............-        ",
        "-..............-        ",
        "-..............-        ",
        "-......=.......-        ",
        "-..............-        ",
        "----------------        ",
        "                        "
      ],
      "palettes": [ "roof_palette" ],
      "terrain": { ".": "t_shingle_flat_roof" }
    }
  },
  {
    "type": "mapgen",
    "method": "json",
    "om_terrain": "house_w_5_basement",
    "object": {
      "fill_ter": "t_thconc_floor",
      "rows": [
        "                        ",
        "                        ",
        "                        ",
        "  ||||||||||||||||||||||",
        "  |2..............|8S89|",
        "  |.............z.|t...|",
        "  |...............||+|||",
        "  |....................|",
        "  |..........<.....A..J|",
        "  |...................Z|",
        "  |1............â.g..WU|",
        "  |............|||||||||",
        "  |............|        ",
        "  |............|        ",
        "  |............|        ",
        "|||............|        ",
        "|..............|        ",
        "|..............|        ",
        "|..............|        ",
        "|..............|        ",
        "|..............|        ",
        "|..............|        ",
        "||||||||||||||||        ",
        "                        "
      ],
      "palettes": [ "standard_domestic_basement_palette" ],
      "nested": {
        "1": { "chunks": [ [ "null", 70 ], [ "recroom_12x12", 30 ], [ "tvroom_12x12", 30 ], [ "workoutroom_12x12", 30 ] ] },
        "2": {
          "chunks": [
            [ "null", 70 ],
            [ "room_6x6_guns_E", 2 ],
            [ "room_6x6_junk_E", 30 ],
            [ "room_6x6_office_E", 30 ],
            [ "6x6_sewing_open", 10 ],
            [ "6x6_electronics_open", 10 ]
          ]
        }
      }
    }
  }
]
