[
  {
    "type": "mapgen",
    "method": "json",
    "om_terrain": [ "house_11" ],
    "weight": 300,
    "object": {
      "fill_ter": "t_floor",
      "rows": [
        "$$$$$$$$$$$--$$______$$$",
        "$..........--.p______..$",
        "$...%%%....--..______..$",
        "$.##o#o##..--..______..$",
        "$.#T   y#%.--..______..$",
        "$.#@@  I#%.----______..$",
        "$.#@@ AI#%.--##======#.$",
        "$.#    d#%.--#&~~~~~~#.$",
        "$.#d    #^.--#q~~~~~~#.$",
        "$.#|+|+|#o#**##~~~~~~#.$",
        "$.#Dz| HHH   y|~~~~~~#.$",
        "$.#|||       R|~~~~~~#.$",
        "$.#S |       R|~~~~~~#.$",
        "$.#8 +        |~~~~~~#.$",
        "$.#t |    hh  +~~~~~~#.$",
        "$.#BB| xx ff  |+|~~~~#.$",
        "$.#||| || ff  |>|qqqq#.$",
        "$.#1   6| hh  ########.$",
        "$.o5   A|     *------..$",
        "$.o3    ##!!!##------..$",
        "$.#74O2F#^.....-GKG--..$",
        "$.###oo##......------..$",
        "$......................$",
        "$$$$$$$$$$$$$$$$$$$$$$$$"
      ],
      "palettes": [ "standard_domestic_palette" ],
      "terrain": {
        "%": [ "t_region_shrub", "t_region_shrub_fruit", "t_region_shrub_decorative" ],
        "=": "t_door_metal_locked",
        "!": "t_wall_glass",
        "_": "t_pavement",
        "&": "t_gates_control_brick",
        "$": "t_fence",
        "G": "t_sidewalk",
        "K": "t_sidewalk",
        "~": "t_thconc_floor",
        "q": "t_thconc_floor"
      },
      "furniture": { "?": "f_rack" },
      "place_loot": [
        { "group": "livingroom", "x": [ 6, 12 ], "y": [ 10, 15 ], "chance": 90, "repeat": [ 1, 4 ] },
        { "group": "guns_pistol_common", "x": [ 3, 3 ], "y": [ 8, 8 ], "chance": 5, "ammo": 90, "magazine": 100 }
      ],
      "place_monsters": [ { "monster": "GROUP_ZOMBIE", "x": [ 2, 21 ], "y": [ 2, 21 ], "chance": 2 } ],
      "place_vehicles": [ { "vehicle": "suburban_home", "x": 17, "y": 10, "chance": 15, "rotation": 270 } ]
    }
  },
  {
    "type": "mapgen",
    "method": "json",
    "om_terrain": "house_11_roof",
    "object": {
      "fill_ter": "t_shingle_flat_roof",
      "rows": [
        "                        ",
        "                        ",
        "                        ",
        "  |222223               ",
        "  |.....3               ",
        "  |.....3               ",
        "  |.....3    |22222223  ",
        "  |.....3    |.......3  ",
        "  |.....3    |.......3  ",
        "  |.....52222|.......3  ",
        "  |..................3  ",
        "  |..................3  ",
        "  |..................3  ",
        "  |..................3  ",
        "  |..................3  ",
        "  |.............&....3  ",
        "  |..................3  ",
        "  |...........3------3  ",
        "  |...........3         ",
        "  |..=..5-----3         ",
        "  |.....3               ",
        "  |-----3               ",
        "                        ",
        "                        "
      ],
      "palettes": [ "roof_palette" ],
      "terrain": { ".": "t_shingle_flat_roof" }
    }
  }
]
