[
  {
    "type": "mapgen",
    "method": "json",
    "om_terrain": "house_w_6",
    "object": {
      "fill_ter": "t_floor",
      "rows": [
        "..........p``%..........",
        "...[..%%%%%``%%%%%......",
        "......µ~~~~~~~~~~µ..[...",
        ".[..[.~~~~~~~~~~~~....[.",
        "....%%~~~~~~~~jjj~%%....",
        "....##oo##o**##ooo##....",
        "....#é  R|L  |§    #....",
        "....#   R|s  |     #....",
        "....#    ||++|     #....",
        "....#Yv      |    a#....",
        "..%##|||||         #....",
        "..%o<              #....",
        "..%o>RRT y|+||||  |#....",
        "..%##||| ||St|&   y#....",
        "...^#1O2 l||||     #....",
        "...%o5   Y|66|     o%...",
        "...%o3             o%...",
        "...%#4 y23|66|T   y#....",
        "....##*o#######o#o##....",
        ".....%`%................",
        ".....```................",
        ".....```................",
        "........................",
        "........................"
      ],
      "palettes": [ "domestic_general_and_variant_palette", "standard_domestic_landscaping_palette" ],
      "terrain": { "µ": "t_column", "~": "t_thconc_floor", "j": "t_thconc_floor", "ù": "t_region_groundcover_urban" },
      "furniture": { "ù": "f_region_weed" },
      "nested": {
        "&": { "chunks": [ [ "diningroom_5x5_N_S", 50 ], [ "diningroom_5x5_E_W", 50 ] ] },
        "é": {
          "chunks": [
            [ "bonus_room_3x3_2", 50 ],
            [ "bonus_room_3x3_3", 50 ],
            [ "bonus_room_3x3_4", 50 ],
            [ "bonus_room_3x3_5", 50 ],
            [ "bonus_room_3x3_N_6", 50 ],
            [ "bonus_room_3x3_W_6", 50 ]
          ]
        },
        "§": {
          "chunks": [
            [ "livingroom_5x5_N_1", 10 ],
            [ "livingroom_5x5_S_1", 10 ],
            [ "livingroom_5x5_N_2", 200 ],
            [ "livingroom_5x5_S_2", 200 ],
            [ "livingroom_5x5_E_2", 200 ],
            [ "livingroom_5x5_W_2", 200 ]
          ]
        }
      },
      "place_nested": [
        {
          "chunks": [ [ "null", 50 ], [ "firepit_5x5_2", 15 ], [ "reflecting_pool_5x5_1", 15 ], [ "reflecting_pool_5x5_2", 25 ] ],
          "x": [ 9, 13 ],
          "y": 19
        }
      ]
    }
  },
  {
    "type": "mapgen",
    "method": "json",
    "om_terrain": "house_w_6_2ndfloor",
    "object": {
      "fill_ter": "t_floor",
      "rows": [
        "------------------------",
        "------------------------",
        "------%%%%%%%%%%%%------",
        "------%%%%%%%%%%%%------",
        "------%%%%%%%%%%%%------",
        "----##oo########oo##----",
        "----#&    +D| +é  s#----",
        "----#    H|||D|    #----",
        "----#    s|w|||    #----",
        "----#s    |+| +   h#----",
        "---##||||+|   |||||#----",
        "---o>         +w|vD#----",
        "---oRR|||+||| ||||+#----",
        "---##||Ry +D| + rr #----",
        "----#§    |||+|è A #----",
        "---^#     |t  |    o----",
        "----o     |S  |    o----",
        "----#s    |BBB|y  s#----",
        "----###o####o####o##----",
        "------------------------",
        "------------------------",
        "------------------------",
        "------------------------",
        "------------------------"
      ],
      "palettes": [ "domestic_general_and_variant_palette" ],
      "terrain": { "-": "t_open_air", "%": "t_shingle_flat_roof" },
      "nested": {
        "&": {
          "chunks": [
            [ "bedroom_4x4_adult_1_N", 20 ],
            [ "bedroom_4x4_adult_1_S", 20 ],
            [ "bedroom_4x4_adult_2_N", 20 ],
            [ "bedroom_4x4_adult_3_S", 200 ],
            [ "bedroom_4x4_adult_3_N", 200 ]
          ]
        },
        "é": {
          "chunks": [
            [ "bedroom_4x4_adult_1_S", 20 ],
            [ "bedroom_4x4_adult_3_S", 200 ],
            [ "bedroom_4x4_adult_3_N", 200 ],
            [ "bedroom_4x4_adult_3_E", 200 ],
            [ "bedroom_4x4_adult_3_W", 200 ]
          ]
        },
        "§": {
          "chunks": [
            [ "bedroom_4x4_adult_1_S", 20 ],
            [ "bedroom_4x4_adult_2_W", 20 ],
            [ "bedroom_4x4_adult_2_S", 20 ],
            [ "bedroom_4x4_adult_3_S", 200 ],
            [ "bedroom_4x4_adult_3_W", 200 ]
          ]
        },
        "è": {
          "chunks": [
            [ "bedroom_4x4_adult_1_E", 20 ],
            [ "bedroom_4x4_adult_2_W", 20 ],
            [ "bedroom_4x4_adult_2_W", 20 ],
            [ "bedroom_4x4_adult_3_E", 200 ],
            [ "bedroom_4x4_adult_3_W", 200 ]
          ]
        }
      }
    }
  },
  {
    "type": "mapgen",
    "method": "json",
    "om_terrain": "house_w_6_roof",
    "object": {
      "fill_ter": "t_shingle_flat_roof",
      "rows": [
        "                        ",
        "                        ",
        "                        ",
        "                        ",
        "                        ",
        "    ----------------    ",
        "    -..............-    ",
        "    -..............-    ",
        "    -..............-    ",
        "    -..............-    ",
        "   --..............-    ",
        "   -...............-    ",
        "   -...............-    ",
        "   --..............-    ",
        "    -......&.......-    ",
        "    5..............-    ",
        "    -..............-    ",
        "    -..............-    ",
        "    ----------------    ",
        "                        ",
        "                        ",
        "                        ",
        "                        ",
        "                        "
      ],
      "palettes": [ "roof_palette" ],
      "terrain": { ".": "t_shingle_flat_roof" }
    }
  },
  {
    "type": "mapgen",
    "method": "json",
    "om_terrain": "house_w_6_basement",
    "object": {
      "fill_ter": "t_thconc_floor",
      "rows": [
        "                        ",
        "                        ",
        "                        ",
        "                        ",
        "                        ",
        "    ||||||||||||||||    ",
        "    |Z.1...........|    ",
        "    |J.............|    ",
        "    |J.............|    ",
        "    |W.............|    ",
        "   ||..............|    ",
        "   |U..............|    ",
        "   |<..............|    ",
        "   ||..............|    ",
        "    |..............|    ",
        "    |g.............|    ",
        "    |..............|    ",
        "    |â.............|    ",
        "    ||||||||||||||||    ",
        "                        ",
        "                        ",
        "                        ",
        "                        ",
        "                        "
      ],
      "palettes": [ "standard_domestic_basement_palette" ],
      "nested": { "1": { "chunks": [ [ "null", 70 ], [ "recroom_12x12", 30 ], [ "tvroom_12x12", 30 ], [ "workoutroom_12x12", 30 ] ] } }
    }
  }
]
