[
  {
    "type": "mapgen",
    "method": "json",
    "om_terrain": [ "house_13" ],
    "weight": 200,
    "object": {
      "fill_ter": "t_floor",
      "rows": [
        ".......---..............",
        ".......---..............",
        ".......---p.............",
        ".......---..............",
        ".......-------------....",
        ".......-------------....",
        "..................--....",
        "...%%%%%%..%%%%%..--....",
        "..%#oooo#%%#ooo##.--....",
        ".###HHHH####HHH###--ŦŦŦ.",
        ".#R              *````Ŧ.",
        "^#RE l H  hffh 34#```jŦ.",
        ".#a  l H  hffh  F#```jŦ.",
        ".#RE l H        5o````Ŧ.",
        ".#R       L 6 1O2#`GKGŦ.",
        ".#|+|||||||+|+|||#ŦŦŦŦŦ.",
        ".#I y + 8|8 |   I#^.....",
        ".o    | t|t +  @@o......",
        ".o @@ | S|S |  @@o......",
        ".#d@@d|BB|BB|   d#......",
        ".#######o#o##+|###......",
        "......-----* z>#........",
        "....u.--...#ZWU#........",
        "...........#####........"
      ],
      "palettes": [ "domestic_general_and_variant_palette", "standard_domestic_landscaping_palette" ],
      "terrain": { "G": "t_concrete", "K": "t_concrete", "j": "t_concrete" },
      "place_loot": [ { "group": "livingroom", "x": [ 2, 8 ], "y": [ 10, 14 ], "chance": 90, "repeat": [ 1, 6 ] } ],
      "place_nested": [ { "chunks": [ "rolling_trash_can_1x1" ], "x": 12, "y": 1 } ],
      "place_monsters": [
        { "monster": "GROUP_ZOMBIE", "x": [ 2, 21 ], "y": [ 2, 21 ], "chance": 5 },
        { "monster": "GROUP_PLAGUE_ROACH", "x": [ 2, 21 ], "y": [ 2, 21 ], "chance": 5 },
        { "monster": "GROUP_ROACH", "x": [ 2, 21 ], "y": [ 2, 21 ], "chance": 5 }
      ]
    }
  },
  {
    "type": "mapgen",
    "method": "json",
    "om_terrain": "house_13_roof",
    "object": {
      "fill_ter": "t_shingle_flat_roof",
      "rows": [
        "                        ",
        "                        ",
        "                        ",
        "                        ",
        "                        ",
        "                        ",
        "                        ",
        "                        ",
        "   ------  ------       ",
        " ---....----....--      ",
        " -...............-      ",
        " -...............-      ",
        " -...........X...-      ",
        " -...............-      ",
        " -......&........-      ",
        " -...............5      ",
        " -...............-      ",
        " -..........=....-      ",
        " -...............-      ",
        " -...............-      ",
        " -----------...---      ",
        "           -...-        ",
        "           -...-        ",
        "           -----        "
      ],
      "palettes": [ "roof_palette" ],
      "terrain": { ".": "t_shingle_flat_roof" }
    }
  },
  {
    "type": "mapgen",
    "method": "json",
    "om_terrain": "house_13_basement",
    "object": {
      "fill_ter": "t_thconc_floor",
      "rows": [
        "                        ",
        "                        ",
        "                        ",
        "                        ",
        "                        ",
        "                        ",
        "                        ",
        "                        ",
        "   ||||||  ||||||       ",
        " |||....||||....||      ",
        " |2..............|      ",
        " |..........1....|      ",
        " |...............|      ",
        " |...............|      ",
        " |...............|      ",
        " |...............|      ",
        " |...............|      ",
        " |...............|      ",
        " |.............z.|      ",
        " |............z.z|      ",
        " |||||||||||%+%|||      ",
        "           |g.<|        ",
        "           |F.U|        ",
        "           |||||        "
      ],
      "palettes": [ "basement_empty" ],
      "nested": {
        "1": {
          "chunks": [
            [ "null", 60 ],
            [ "5x5_holdout_E", 2 ],
            [ "livingroom_5x5_S_1", 30 ],
            [ "livingroom_5x5_E_1", 30 ],
            [ "livingroom_5x5_N_1", 30 ],
            [ "livingroom_5x5_W_1", 30 ],
            [ "livingroom_5x5_S_2", 30 ],
            [ "livingroom_5x5_E_2", 30 ],
            [ "livingroom_5x5_N_2", 30 ],
            [ "livingroom_5x5_W_2", 30 ],
            [ "home_office_4x4_N", 20 ],
            [ "home_office_4x4_S", 20 ]
          ]
        },
        "2": {
          "chunks": [
            [ "null", 70 ],
            [ "room_10x10_woodworker_E", 20 ],
            [ "room_10x10_guns_E", 5 ],
            [ "room_10x10_pool_E", 5 ],
            [ "room_10x10_recording_studio_E", 20 ]
          ]
        }
      }
    }
  }
]
