[
  {
    "type": "mapgen",
    "method": "json",
    "om_terrain": [ "house_04" ],
    "weight": 300,
    "object": {
      "fill_ter": "t_floor",
      "rows": [
        ".###..########Ps##..###.",
        ".|||vv||||v||||*||vvv||.",
        ".|  nn o%B  %r%   ~~~~|.",
        ".|d    o%B t% %       |.",
        ".vd     %B  % +   $$$0|.",
        ".v      %c c% %  ?$$$ |.",
        ".|  @@  %Q S%r%  ?$$$ |^",
        ".| n@@n %Q %%%%  n??? |.",
        ".|%%%%%+%%+%>>%       |.",
        ".|@@ d%    %%+%       v.",
        ".|d   % $$$$$$$$      |.",
        ".v    + $$$$$$$$      v.",
        ".|y @@%o$$$$$$$$  % h |.",
        ".|%%%%%o$$$$$$$$  %kkk|.",
        ".|@@  +     y     %%%%|.",
        ".|@@  %%%%+%%      DlY|s",
        ".vy   +E%Q S%   h     *s",
        ".|dnd %%%  c% hnn     |s",
        ".|%%% +    c%  nnh   4|.",
        ".|k D %%%   %6 h     f|.",
        ".vkh  +E%  t%6       2|.",
        ".|kkky%r%BBB%6  1D53O7|.",
        ".||vv|||||v|||*|||vv|||.",
        "............^sss........"
      ],
      "set": [
        { "point": "terrain", "id": "t_dirt", "x": [ 0, 14 ], "y": 0, "repeat": [ 5, 8 ] },
        { "point": "terrain", "id": "t_tree_young", "x": [ 0, 14 ], "y": 0, "chance": 5 },
        { "point": "terrain", "id": "t_tree_apple", "x": [ 0, 14 ], "y": 0, "chance": 10, "repeat": [ 1, 2 ] }
      ],
      "terrain": {
        "$": "t_carpet_green",
        "#": "t_shrub",
        ">": "t_stairs_down",
        ".": [ [ "t_region_groundcover_urban", 10 ], "t_region_shrub_decorative" ],
        "P": "t_grass",
        "s": "t_sidewalk",
        "v": [
          [ "t_window_domestic", 10 ],
          "t_window_no_curtains",
          "t_window_open",
          "t_window_no_curtains_open",
          [ "t_curtains", 5 ]
        ],
        "+": [ [ "t_door_c", 10 ], [ "t_door_o", 5 ], [ "t_door_locked_interior", 3 ] ],
        "*": [ [ "t_door_locked_peep", 2 ], "t_door_locked_alarm", [ "t_door_locked", 10 ], "t_door_c" ],
        "^": "t_gutter_downspout",
        "%": "t_wall_w",
        "|": "t_brick_wall"
      },
      "furniture": {
        "0": "f_fireplace",
        "~": "f_entertainment_center",
        "?": "f_sofa",
        "@": "f_bed",
        "l": "f_stool",
        "Y": "f_rack_coat",
        "B": "f_bathtub",
        "C": "f_cupboard",
        "1": "f_cupboard",
        "2": "f_cupboard",
        "3": "f_cupboard",
        "4": "f_cupboard",
        "5": "f_sink",
        "6": "f_rack_wood",
        "7": "f_cupboard",
        "I": "f_dishwasher",
        "D": "f_trashcan",
        "O": "f_oven",
        "P": "f_mailbox",
        "S": "f_sink",
        "c": "f_counter",
        "d": "f_dresser",
        "E": "f_wardrobe",
        "f": "f_fridge",
        "h": "f_chair",
        "k": "f_desk",
        "n": "f_table",
        "o": "f_bookcase",
        "r": "f_rack",
        "Q": "f_rack_wood",
        "y": [ "f_indoor_plant", "f_indoor_plant_y" ]
      },
      "toilets": { "t": {  } },
      "items": {
        "Q": [
          { "item": "shower", "chance": 20 },
          { "item": "cleaning", "chance": 30, "repeat": [ 1, 2 ] },
          { "item": "bed", "chance": 30, "repeat": [ 1, 2 ] }
        ],
        "Y": { "item": "unisex_coat_rack", "chance": 30, "repeat": [ 1, 4 ] },
        "o": { "item": "homebooks", "chance": 30, "repeat": [ 1, 4 ] },
        "D": { "item": "trash", "chance": 30, "repeat": [ 1, 4 ] },
        "P": { "item": "mail", "chance": 30, "repeat": [ 2, 5 ] },
        "1": [ { "item": "SUS_dishes", "chance": 100 }, { "item": "SUS_silverware", "chance": 100 } ],
        "2": [ { "item": "SUS_cookware", "chance": 100 }, { "item": "SUS_spice_collection", "chance": 100 } ],
        "3": [ { "item": "SUS_utensils", "chance": 100 }, { "item": "SUS_knife_drawer", "chance": 100 } ],
        "4": [ { "item": "SUS_junk_drawer", "chance": 100 }, { "item": "SUS_appliances_cupboard", "chance": 100 } ],
        "~": [ { "item": "elecsto_persele", "chance": 10, "repeat": [ 1, 3 ] } ],
        "5": { "item": "SUS_kitchen_sink", "chance": 100 },
        "6": { "item": "SUS_pantry", "chance": 25, "repeat": [ 1, 2 ] },
        "7": [ { "item": "SUS_breakfast_cupboard", "chance": 100 }, { "item": "SUS_coffee_cupboard", "chance": 100 } ],
        "f": { "item": "SUS_fridge", "chance": 100 },
        "O": { "item": "SUS_oven", "chance": 100 },
        "I": { "item": "SUS_dishwasher", "chance": 100 },
        "C": { "item": "kitchen_counters", "chance": 5 },
        "k": [ { "item": "desks_bedroom_unisex", "chance": 5 }, { "item": "office", "chance": 25 } ],
        "n": [ { "item": "SUS_desks_bedroom_unisex", "chance": 5 }, { "item": "office", "chance": 25 } ],
        "d": [
          { "item": "SUS_dresser_mens", "chance": 50, "repeat": [ 1, 2 ] },
          { "item": "SUS_dresser_womens", "chance": 50, "repeat": [ 1, 2 ] }
        ],
        "E": [
          { "item": "SUS_wardrobe_mens", "chance": 50, "repeat": [ 1, 2 ] },
          { "item": "SUS_wardrobe_womens", "chance": 50, "repeat": [ 1, 2 ] }
        ],
        "c": [
          { "item": "SUS_hair_drawer", "chance": 50 },
          { "item": "SUS_bathroom_cabinet", "chance": 50 },
          { "item": "softdrugs", "chance": 20, "repeat": [ 1, 2 ] }
        ],
        "@": { "item": "bed", "chance": 50 },
        "S": { "item": "SUS_bathroom_sink", "chance": 75 }
      },
      "place_loot": [
        { "group": "cleaning", "x": 13, "y": 6, "chance": 90, "repeat": [ 1, 2 ] },
        { "group": "guns_pistol_common", "x": 2, "y": 13, "chance": 5, "ammo": 90, "magazine": 100 },
        { "group": "livingroom", "x": [ 10, 18 ], "y": [ 10, 11 ], "chance": 90, "repeat": [ 1, 5 ] },
        { "group": "magazines", "x": 17, "y": 7, "chance": 80, "repeat": [ 1, 3 ] },
        { "group": "mischw", "x": 13, "y": 2, "chance": 60, "repeat": [ 1, 3 ] },
        { "group": "novels", "x": 7, "y": [ 2, 3 ], "chance": 85, "repeat": [ 1, 4 ] },
        { "group": "trash", "x": 19, "y": 15, "chance": 80, "repeat": [ 1, 3 ] },
        { "item": "television", "x": 21, "y": 2, "chance": 85 },
        { "item": "laptop", "x": 2, "y": 20, "chance": 3 }
      ],
      "place_monsters": [ { "monster": "GROUP_ZOMBIE", "x": [ 2, 21 ], "y": [ 2, 21 ], "chance": 2 } ]
    }
  },
  {
    "type": "mapgen",
    "method": "json",
    "om_terrain": "house_04_roof",
    "object": {
      "fill_ter": "t_shingle_flat_roof",
      "rows": [
        "                        ",
        " |222222222222222222223.",
        " |....................3 ",
        " |......=........X....3 ",
        " |...................~3 ",
        " |....................3 ",
        " |....................5 ",
        " |....................3 ",
        " |....................3 ",
        " |....................3 ",
        " |....................3 ",
        " |....................3 ",
        " |....................3 ",
        " |....................3 ",
        " |....................3 ",
        " |....................3 ",
        " |....................3 ",
        " |....................3 ",
        " |....................3 ",
        " |................&...3 ",
        " |......=.............3 ",
        " |....................3 ",
        " |----------5---------3 ",
        "                        "
      ],
      "palettes": [ "roof_palette" ],
      "terrain": { ".": "t_shingle_flat_roof" }
    }
  }
]
