[
  {
    "method": "json",
    "om_terrain": "house_24",
    "//": "normal variant",
    "type": "mapgen",
    "weight": 100,
    "object": {
      "fill_ter": "t_floor",
      "rows": [
        "...``````..p............",
        "...``````....%.%%.%.%%..",
        "...````````##ooo##ooo##.",
        "..%````````#c  y  hhh #.",
        "...````````*      fff o.",
        "...``````!!# rr   hhhT#.",
        ".%.``````!%#||||+|||||#.",
        "...``````.##23F| |@@sd#.",
        "...``````%#1   | |@@  #.",
        ".%.``````.o5     |E   o.",
        "...``````%#O  7| +  h o.",
        "...``````.#J  4| |yDII#.",
        "..#~~~~~~##|| || |||||#.",
        "..#~~~~~~#TE     | bdy#.",
        "..#~~~~~~#x  H   +    o.",
        "..#~~~~~~#x lH   |    o.",
        "..#~~~~~Y#x  H   |@@ E#.",
        "..#U~~~~Y#     hr|@@ D#.",
        "..#U~~~~~*      r|||||#.",
        ".^#~A~~~~#       +---B#^",
        "..#NNNqq~#RyHHHsR|t8SB#.",
        "..##########ooo########.",
        "...........!!!!!........",
        "........................"
      ],
      "palettes": [ "domestic_general_and_variant_palette" ],
      "terrain": {
        "%": [ "t_region_shrub", "t_region_shrub_fruit", "t_region_shrub_decorative" ],
        "[": [ [ "t_region_tree_fruit", 2 ], [ "t_region_tree_nut", 2 ], "t_region_tree_shade" ],
        "!": "t_region_groundcover_urban",
        "`": "t_concrete",
        "#": "t_adobe_brick_wall",
        "-": "t_linoleum_white",
        "Q": "t_linoleum_white",
        "8": "t_linoleum_white",
        "B": "t_linoleum_white",
        "S": "t_linoleum_white",
        "t": "t_linoleum_white",
        "N": "t_thconc_floor",
        "Y": "t_thconc_floor",
        "U": "t_thconc_floor",
        "q": "t_thconc_floor",
        "A": "t_thconc_floor",
        "~": "t_thconc_floor"
      },
      "furniture": { "!": "f_region_flower" },
      "place_vehicles": [ { "vehicle": "rolling_trash_can", "x": 2, "y": 1, "chance": 80, "status": 0 } ],
      "place_item": [ { "item": "stereo", "x": 15, "y": 20, "chance": 100 }, { "item": "television", "x": 10, "y": 15, "chance": 100 } ]
    }
  },
  {
    "method": "json",
    "om_terrain": "house_24",
    "type": "mapgen",
    "weight": 40,
    "object": {
      "fill_ter": "t_floor",
      "rows": [
        "..pcccccc...............",
        "...ccccccP..............",
        "...ccccccss||www||www||.",
        "...ccccccss|__________|.",
        "...cTTTTcss+__________w.",
        "...cccccc..|_XXX______|.",
        "...TcTcTc..|HHHH+HHHHH|.",
        "...TcTcTc.||CCfH_H____|.",
        "...TcTcTc.|&___H_H____|.",
        "...TcTcTc.wC_____H____w.",
        "...cccccc.|o__aH_+____w.",
        "...cccccc.|C__aH_H____|.",
        "..|#t##t#||HH_HH_HHHHH|.",
        "..|#t##t#|_______H____|.",
        "..|#t##t#|_X_____+____w.",
        ".{|#t##t#|_X_____H____w.",
        ".{|#t##t#|_X____XH____|.",
        "..|tttttt|______XH____|.",
        ".^|tttttt+_______HHHHH|^",
        "..|tttttd|_______+&Ceg|.",
        "..|tttbb#|_______H____|.",
        "..||||||||||www||||||||.",
        "........................",
        "........................"
      ],
      "terrain": {
        "#": "t_thconc_floor",
        "+": [ "t_door_c", "t_door_o", "t_door_o" ],
        ".": [ "t_grass", "t_grass", "t_grass", "t_grass", "t_dirt" ],
        "P": "t_grass",
        "T": "t_concrete",
        "_": "t_floor",
        "b": "t_thconc_floor",
        "c": "t_concrete",
        "d": "t_thconc_floor",
        "p": "t_grass",
        "s": "t_sidewalk",
        "t": "t_thconc_floor",
        "^": "t_gutter_downspout",
        "w": "t_window_domestic",
        "{": "t_grass",
        "|": "t_adobe_brick_wall",
        "H": "t_wall_w"
      },
      "furniture": {
        "#": "f_table",
        "&": "f_sink",
        "C": "f_counter",
        "P": "f_sign",
        "T": "f_table",
        "X": "f_crate_c",
        "a": "f_cupboard",
        "b": "f_crate_c",
        "d": "f_chair",
        "e": "f_trashcan",
        "f": "f_fridge",
        "g": "f_toilet",
        "o": [ "f_oven", "f_gas_oven_microwave_combo" ],
        "p": "f_mailbox",
        "{": "f_dumpster"
      },
      "place_items": [
        { "chance": 5, "item": "ammo_shotgun_rare", "x": 8, "y": 15 },
        { "chance": 50, "item": "camping", "x": 6, "y": 12 },
        { "chance": 50, "item": "glass_set", "x": 6, "y": 14 },
        { "chance": 25, "item": "clothing_work_boots", "x": 7, "y": 9 },
        { "chance": 80, "item": "crate_toys", "x": 16, "y": 16 },
        { "chance": 20, "item": "book_survival", "x": 5, "y": 16 },
        { "chance": 25, "item": "fancyfurs", "x": 3, "y": 7 },
        { "chance": 80, "item": "crate_sports", "x": 16, "y": 17 },
        { "chance": 80, "item": "crate_cleaning", "x": 6, "y": 20 },
        { "chance": 25, "item": "clothing_work_gloves", "x": 7, "y": 8 },
        { "chance": 50, "item": "clothing_male", "x": 4, "y": 4 },
        { "chance": 50, "item": "clothing_male", "x": 5, "y": 4 },
        { "chance": 35, "repeat": 2, "item": "toy_box", "x": 3, "y": 12 },
        { "chance": 50, "item": "clothing_watch", "x": 3, "y": 15 },
        { "chance": 20, "item": "tools_construction", "x": 5, "y": 8 },
        { "chance": 20, "repeat": 2, "item": "sports", "x": 5, "y": 6 },
        { "chance": 20, "repeat": 2, "item": "sports", "x": 5, "y": 7 },
        { "chance": 50, "item": "dress_shoes", "x": 7, "y": 6 },
        { "chance": 15, "item": "book_military", "x": 5, "y": 15 },
        { "chance": 50, "item": "clothing_female", "x": 6, "y": 4 },
        { "chance": 50, "item": "clothing_female", "x": 7, "y": 4 },
        { "chance": 30, "item": "clothing_glasses", "x": 3, "y": 14 },
        { "chance": 10, "item": "guns_pistol_rare", "x": 8, "y": 16 },
        { "chance": 70, "item": "crate_winter", "x": 14, "y": 5 },
        { "chance": 20, "repeat": 2, "item": "book_school", "x": 5, "y": 14 },
        { "chance": 80, "item": "crate_kitchen", "x": 11, "y": 14 },
        { "chance": 70, "item": "crate_kitchen", "x": 13, "y": 5 },
        { "chance": 22, "item": "kitchen_nonfood", "x": 3, "y": 9 },
        { "chance": 80, "item": "crate_clothes", "x": 11, "y": 15 },
        { "chance": 70, "item": "crate_clothes", "x": 15, "y": 5 },
        { "chance": 80, "item": "crate_linens", "x": 7, "y": 20 },
        { "chance": 80, "item": "crate_linens", "x": 11, "y": 16 }
      ],
      "place_toilets": [ { "x": 21, "y": 19 } ],
      "place_signs": [ { "signage": "Moving away sale!", "x": 9, "y": 1 } ]
    }
  },
  {
    "method": "json",
    "om_terrain": "house_24",
    "type": "mapgen",
    "weight": 40,
    "object": {
      "fill_ter": "t_floor",
      "rows": [
        "...cccccc..p............",
        "...cccccc...............",
        "..Pccccccss||www||www||.",
        "...ccccccss|_________a|.",
        "...ccccccss+_________Tw.",
        "...cccccc..|_TT___HH_a|.",
        "...cccccc..|%%%%+%%%%%|.",
        "...cccccc.||CCf%_%bb_{|.",
        "...cccccc.|&___%_%bb_{|.",
        "...cccccc.wC_____%____w.",
        "...cccccc.|o__d%_+____w.",
        "...cccccc.|C__d%_%___T|.",
        "..|tttttt||%%_%%_%%%%%|.",
        "..|tttttt|T_T____%___e|.",
        "..|ttttt#|__H____+____w.",
        "..|ttttt#|__H____%____w.",
        "..|tt##t#|__H____%bb_{|.",
        "..|tt##tt|__H____%bb_{|.",
        "..|tt##tt+_______%%%%%|.",
        ".^|tttttt|B______+&Cgh|^",
        "..|t####i|B____aT%____|.",
        "..||||||||||www||||||||.",
        "........................",
        "........................"
      ],
      "terrain": {
        "#": "t_thconc_floor",
        "+": [ "t_door_c", "t_door_o", "t_door_o" ],
        ".": [ "t_grass", "t_grass", "t_grass", "t_grass", "t_dirt" ],
        "P": "t_grass",
        "_": "t_floor",
        "c": "t_concrete",
        "i": "t_thconc_floor",
        "p": "t_grass",
        "s": "t_concrete",
        "t": "t_thconc_floor",
        "^": "t_gutter_downspout",
        "w": "t_window_domestic",
        "%": "t_wall_w",
        "|": "t_adobe_brick_wall"
      },
      "furniture": {
        "#": "f_table",
        "&": "f_sink",
        "B": "f_bookcase",
        "C": "f_counter",
        "H": "f_sofa",
        "P": "f_sign",
        "T": "f_table",
        "a": "f_armchair",
        "b": "f_bed",
        "d": "f_cupboard",
        "e": "f_bigmirror",
        "f": "f_fridge",
        "g": "f_trashcan",
        "h": "f_toilet",
        "i": "f_trashcan",
        "o": [ "f_oven", "f_gas_oven_microwave_combo" ],
        "p": "f_mailbox",
        "{": "f_dresser"
      },
      "place_items": [
        { "chance": 40, "item": "oven", "x": 11, "y": 10 },
        { "chance": 45, "item": "bed", "x": 18, "y": 17 },
        { "chance": 45, "item": "bed", "x": 19, "y": 17 },
        { "chance": 45, "item": "bed", "x": 18, "y": 7 },
        { "chance": 45, "item": "bed", "x": 19, "y": 7 },
        { "chance": 35, "repeat": 2, "item": "homebooks", "x": 5, "y": 16 },
        { "chance": 20, "repeat": 2, "item": "book_survival", "x": 8, "y": 15 },
        { "chance": 25, "item": "barbecue", "x": 3, "y": 16 },
        { "chance": 25, "item": "fancyfurs", "x": [ 6, 7 ], "y": 20 },
        { "chance": 25, "item": "guns_obscure", "x": 21, "y": 7 },
        { "chance": 50, "repeat": 2, "item": "clothing_male", "x": 21, "y": 11 },
        { "chance": 25, "item": "clothing_work_hat", "x": 21, "y": 16 },
        { "chance": 30, "repeat": 2, "item": "female_underwear_top", "x": 5, "y": 18 },
        { "chance": 40, "item": "beauty", "x": 19, "y": 19 },
        { "chance": 25, "repeat": 2, "item": "bags_trip", "x": 6, "y": 13 },
        { "chance": 25, "repeat": 2, "item": "bags_trip", "x": 6, "y": 14 },
        { "chance": 50, "item": "clothing_watch", "x": 21, "y": 17 },
        { "chance": 40, "item": "book_school", "x": 8, "y": 14 },
        { "chance": 35, "repeat": 2, "item": "magazines", "x": 16, "y": 20 },
        { "chance": 25, "repeat": 2, "item": "magazines", "x": 12, "y": 13 },
        { "chance": 45, "item": "kitchen", "x": 11, "y": 11 },
        { "chance": 40, "repeat": 2, "item": "sports", "x": 4, "y": 14 },
        { "chance": 30, "item": "sports", "x": 3, "y": 13 },
        { "chance": 20, "item": "sports", "x": 3, "y": 14 },
        { "chance": 30, "repeat": 2, "item": "kitchen_nonfood", "x": 14, "y": 10 },
        { "chance": 35, "repeat": 2, "item": "kitchen_nonfood", "x": 14, "y": 11 },
        { "chance": 35, "repeat": 2, "item": "kitchen_nonfood", "x": [ 12, 13 ], "y": 7 },
        { "chance": 30, "item": "manuals", "x": 6, "y": 16 },
        { "chance": 40, "item": "pool_table", "x": 4, "y": 13 },
        { "chance": 45, "repeat": 2, "item": "book_gunmags", "x": 8, "y": 16 },
        { "chance": 40, "repeat": 2, "item": "nightstand", "x": 21, "y": 8 },
        { "chance": 45, "repeat": 2, "item": "dresses", "x": 6, "y": 18 },
        { "chance": 35, "item": "garden_shed", "x": 4, "y": 20 },
        { "chance": 35, "item": "garden_shed", "x": 3, "y": 18 },
        { "chance": 35, "item": "garden_shed", "x": 3, "y": 19 },
        { "chance": 35, "item": "garden_shed", "x": 3, "y": 20 }
      ],
      "place_toilets": [ { "x": 21, "y": 19 } ],
      "place_signs": [ { "signage": "Estate sale!", "x": 2, "y": 2 } ]
    }
  },
  {
    "type": "mapgen",
    "method": "json",
    "om_terrain": "house_24_roof",
    "object": {
      "fill_ter": "t_shingle_flat_roof",
      "rows": [
        "                        ",
        "                        ",
        "           ------------ ",
        "           -..........- ",
        "           -..........- ",
        "           -..........- ",
        "           -..N.......- ",
        "          --..........- ",
        "          -...........- ",
        "          -...........- ",
        "          -...........- ",
        "          -...........- ",
        "  ---------...........- ",
        "  -...................- ",
        "  -............&......- ",
        "  -...................- ",
        "  -...................- ",
        "  -......X........=...- ",
        "  -...................- ",
        "  5...................5 ",
        "  -...................- ",
        "  --------------------- ",
        "                        ",
        "                        "
      ],
      "palettes": [ "roof_palette" ],
      "terrain": { ".": "t_shingle_flat_roof" }
    }
  }
]
