[
    {
        "comment" : "two bedroom one bath single garage home.",
        "type" : "mapgen",
        "om_terrain" : ["house"],
        "method" : "json",
        "weight" : 100,
        "object" : {
            "fill_ter" : "t_floor",
            "rows" : [
                "..........sss.ssssss....",
                "...i####i..s.Mssssss#...",
                "..--vvvv--#s#-======--..",
                "..|p((((p|Q9Q|      e|..",
                "..|((HH((|gsg|       |..",
                ".#v((NN((v#s#v       |#.",
                ".#v((HH((v#s#v       ;s.",
                "..|((((((|/s/|      c|D.",
                "..|-<<(((|/s/|      c|..",
                "..|f(((((v#s#v      cv#.",
                ".g|O((<((v#s#v      cv#.",
                ".#vS((<((|isi|L WYccc|..",
                ".g|C(((((|#s#--+------..",
                "..|-<<<((|V;V|o P|S|t|/.",
                ".i|P             +(((v#.",
                ".s;         k|-+-|BB(|/.",
                ".i| k??  ----|   ---+|..",
                ".#v ?    | do| h     |..",
                ".#v ? n  +   |kk   @@v#.",
                "..|      |h  ---   @@v#.",
                "..|P    P|k  @@|d   o|..",
                "..--V[[V---v-v----v---..",
                "...ssssss.g#.#g...#.....",
                "....ssss................"
            ],
            "terrain" : {
                "/" : "t_dirt",
                "<" : "t_linoleum_white",
                "|" : "t_wall",
                "-" : "t_wall",
                "." : "t_grass",
                "9" : "t_fencegate_c",
                "#" : "t_shrub",
                "=" : "t_door_metal_locked",
                "+" : "t_door_c",
                ";" : "t_door_locked",
                "[" : "t_door_glass_c",
                "(" : "t_linoleum_gray",
                "?" : "t_floor",
                "@" : "t_floor",
                "B" : "t_linoleum_white",
                "C" : "t_linoleum_white",
                "c" : "t_floor",
                "D" : "t_grass",
                "d" : "t_floor",
                "e" : "t_gates_mech_control",
                "f" : "t_linoleum_white",
                "g" : "t_dirt",
                "H" : "t_linoleum_white",
                "h" : "t_floor",
                "i" : "t_dirt",
                "k" : "t_floor",
                "L" : "t_floor",
                "M" : "t_grass",
                "N" : "t_linoleum_white",
                "n" : "t_floor",
                "O" : "t_linoleum_white",
                "o" : "t_floor",
                "P" : "t_floor",
                "p" : "t_linoleum_white",
                "Q" : "t_fence_h",
                "S" : "t_linoleum_white",
                "s" : "t_sidewalk",
                "t" : "t_linoleum_white",
                "V" : "t_wall_glass",
                "v" : "t_window_domestic",
                "W" : "t_floor",
                "Y" : "t_floor"
            },
            "furniture" : {
                "/" : "f_dandelion",
                "<" : "f_counter",
                "?" : "f_sofa",
                "@" : "f_bed",
                "B" : "f_bathtub",
                "C" : "f_cupboard",
                "c" : "f_counter",
                "D" : "f_trashcan",
                "d" : "f_dresser",
                "f" : "f_fridge",
                "g" : "f_bluebell",
                "H" : "f_chair",
                "h" : "f_chair",
                "i" : "f_dahlia",
                "k" : "f_desk",
                "L" : "f_locker",
                "M" : "f_sign",
                "N" : "f_table",
                "n" : "f_table",
                "O" : "f_oven",
                "o" : "f_bookcase",
                "P" : "f_indoor_plant",
                "p" : "f_indoor_plant",
                "S" : "f_sink",
                "W" : "f_washer",
                "Y" : "f_dryer"
            },
            "toilets" : {
                "t" : { }
            },
            "place_vehicles" : [
                { "vehicle" : "suburban_home",  "x" : 17, "y" : 7, "rotation" : 90, "chance" : 10 }
            ],
            "place_loot" : [
                { "group" : "bedroom",         "chance" : 80, "x" : [16,20], "y" : [17,20], "repeat" : [1,4] },
                { "group" : "office",          "chance" : 75, "x" : [14,15], "y" : [18,18], "repeat" : [1,3] },
                { "group" : "child_items",     "chance" : 80, "x" : [10,12], "y" : [17,20], "repeat" : [1,3] },
                { "group" : "school",          "chance" : 70, "x" : [10,10], "y" : [20,20], "repeat" : [1,2] },
                { "group" : "bed",             "chance" : 90, "x" : [19,20], "y" : [18,19], "repeat" : [1,3] },
                { "group" : "bed",             "chance" : 90, "x" : [13,14], "y" : [20,20], "repeat" : [1,2] },
                { "group" : "shirts",          "chance" : 60, "x" : [16,17], "y" : [11,11], "repeat" : [1,2] },
                { "group" : "dresser",         "chance" : 85, "x" : [11,11], "y" : [17,17], "repeat" : [1,3] },
                { "group" : "dresser",         "chance" : 85, "x" : [16,16], "y" : [20,20], "repeat" : [1,4] },
                { "group" : "homebooks",       "chance" : 70, "x" : [20,20], "y" : [20,20], "repeat" : [1,2] },
                { "group" : "novels",          "chance" : 80, "x" : [12,12], "y" : [17,17], "repeat" : [1,3] },
                { "group" : "fridge",          "chance" : 90, "x" : [ 3, 3], "y" : [ 9, 9], "repeat" : [1,5] },
                { "group" : "oven",            "chance" : 75, "x" : [ 3, 3], "y" : [10,10], "repeat" : [1,3] },
                { "group" : "cannedfood",      "chance" : 75, "x" : [ 3, 3], "y" : [12,12], "repeat" : [1,3] },
                { "group" : "pasta",           "chance" : 50, "x" : [ 3, 3], "y" : [12,12], "repeat" : [1,2] },
                { "group" : "kitchen",         "chance" : 75, "x" : [ 4, 5], "y" : [ 8, 8], "repeat" : [1,3] },
                { "group" : "trash",           "chance" : 80, "x" : [22,22], "y" : [ 7, 7], "repeat" : [1,3] },
                { "group" : "dining",          "chance" : 80, "x" : [ 5, 6], "y" : [ 5, 5], "repeat" : [1,3] },
                { "group" : "livingroom",      "chance" : 80, "x" : [14,14], "y" : [13,13], "repeat" : [1,2] },
                { "group" : "waitingroom",     "chance" : 75, "x" : [ 4, 4], "y" : [16,16], "repeat" : [1,2] },
                { "group" : "softdrugs",       "chance" : 75, "x" : [18,18], "y" : [13,13], "repeat" : [1,3] },
                { "group" : "cleaning",        "chance" : 90, "x" : [18,20], "y" : [11,11], "repeat" : [1,2] },
                { "group" : "tools_carpentry", "chance" : 30, "x" : [14,14], "y" : [11,11], "repeat" : [1,2] },
                { "group" : "home_hw",         "chance" : 70, "x" : [20,20], "y" : [ 7,10], "repeat" : [1,4] },
                { "item"  : "hose",            "chance" : 75, "x" : [12,12], "y" : [22,22] }
            ],
            "place_monsters" : [
                { "monster" : "GROUP_ZOMBIE", "chance" : 2, "x" : [2,21], "y" : [2,21] }
            ]
        }
    }
]
