[
  {
    "type": "mapgen",
    "method": "json",
    "om_terrain": "house_w_2",
    "object": {
      "fill_ter": "t_floor",
      "rows": [
        "..%%ùù%%%p```%%%ùù%%....",
        "..%µ```µ``````µ```µ%....",
        "...````````````````.....",
        "..##o#o###+###o##o##....",
        "..#0    |  T|§  è  #....",
        "..#     |  r|      #....",
        "..#     |  r|      #....",
        "..#     +  ||||  ||#....",
        "..#|+||||   à      #....",
        "..#D D|>+       ç  o....",
        "..#||||||          o....",
        "..#é               #....",
        "..o     |  |||||####....",
        "..#     |  y| tB#^......",
        "..o     |   +  Bo.......",
        "..#     |   |S  #.......",
        "..#|+|||||+||||+#.......",
        "..#1   3|&    |6#.......",
        "..#2 s 2|     ||#.......",
        "..o5 s O|     |D#.......",
        "..#4   4|     + #.......",
        "..#F31 T|     |D#.......",
        "..##o#+###o######.......",
        "...``````..............."
      ],
      "palettes": [ "domestic_general_and_variant_palette", "standard_domestic_landscaping_palette" ],
      "terrain": { "µ": "t_column", "ù": "t_region_groundcover_urban" },
      "furniture": { "ù": "f_region_weed" },
      "nested": {
        "0": { "chunks": [ [ "bedroom_4x4_adult_1_N", 20 ] ] },
        "&": {
          "chunks": [
            [ "bedroom_5x5_adult_S_1", 50 ],
            [ "bedroom_5x5_adult_W_1", 50 ],
            [ "bedroom_5x5_adult_N_2", 50 ],
            [ "bedroom_5x5_adult_S_2", 50 ],
            [ "bedroom_5x5_adult_E_2", 50 ],
            [ "bedroom_5x5_adult_W_2", 50 ]
          ]
        },
        "é": { "chunks": [ [ "diningroom_5x5_N_S", 50 ], [ "diningroom_5x5_E_W", 50 ] ] },
        "§": {
          "chunks": [
            [ "bonus_room_2x2_1", 50 ],
            [ "bonus_room_2x2_2", 50 ],
            [ "bonus_room_2x2_4_W", 50 ],
            [ "bonus_room_3x3_1", 50 ],
            [ "bonus_room_3x3_2", 50 ]
          ]
        },
        "è": {
          "chunks": [
            [ "bonus_room_3x3_4", 50 ],
            [ "bonus_room_3x3_N_6", 50 ],
            [ "bonus_room_3x3_E_6", 50 ],
            [ "bonus_room_3x3_N_8", 50 ],
            [ "bonus_room_3x3_E_8", 50 ]
          ]
        },
        "ç": { "chunks": [ [ "bonus_room_3x3_S_5", 50 ], [ "bonus_room_3x3_E_5", 50 ] ] },
        "à": { "chunks": [ [ "bonus_room_2x2_1", 50 ], [ "bonus_room_2x2_2", 50 ] ] }
      },
      "place_nested": [
        {
          "chunks": [
            [ "null", 30 ],
            [ "reflecting_pool_5x5_1", 10 ],
            [ "reflecting_pool_5x5_2", 10 ],
            [ "playset_4x4_1", 10 ],
            [ "playset_4x4_2", 10 ],
            [ "firepit_5x5_1", 10 ],
            [ "firepit_5x5_2", 10 ]
          ],
          "x": 18,
          "y": [ 14, 17 ]
        }
      ]
    }
  },
  {
    "type": "mapgen",
    "method": "json",
    "om_terrain": "house_w_2_roof",
    "object": {
      "fill_ter": "t_shingle_flat_roof",
      "rows": [
        "                        ",
        "   ................     ",
        "   ................     ",
        "  ------------------    ",
        "  -................-    ",
        "  -................-    ",
        "  -................-    ",
        "  -................-    ",
        "  -................-    ",
        "  -................-    ",
        "  -................-    ",
        "  -................-    ",
        "  -.............5---    ",
        "  -.............-       ",
        "  -.............-       ",
        "  -.............-       ",
        "  -.............-       ",
        "  -.............-       ",
        "  -.............-       ",
        "  -.............-       ",
        "  -.............-       ",
        "  -.............-       ",
        "  ---------------       ",
        "                        "
      ],
      "palettes": [ "roof_palette" ],
      "terrain": { ".": "t_shingle_flat_roof" }
    }
  },
  {
    "type": "mapgen",
    "method": "json",
    "om_terrain": "house_w_2_basement",
    "object": {
      "fill_ter": "t_thconc_floor",
      "rows": [
        "                        ",
        "                        ",
        "                        ",
        "  ||||||||||||||||||    ",
        "  |â.g.....1.......|    ",
        "  |................|    ",
        "  |................|    ",
        "  |................|    ",
        "  |z.W|............|    ",
        "  |U.J|<...........|    ",
        "  |z.Z|............|    ",
        "  |...|............|    ",
        "  |2............||||    ",
        "  |.............|       ",
        "  |.............|       ",
        "  |.............|       ",
        "  |.............|       ",
        "  |.............|       ",
        "  |.............|       ",
        "  |.............|       ",
        "  |.............|       ",
        "  |.............|       ",
        "  |||||||||||||||       ",
        "                        "
      ],
      "palettes": [ "standard_domestic_basement_palette" ],
      "nested": {
        "1": { "chunks": [ [ "null", 70 ], [ "8x8_gym_W", 20 ], [ "room_8x8_junk_W", 30 ], [ "room_8x8_hobby_W", 10 ] ] },
        "2": {
          "chunks": [
            [ "null", 70 ],
            [ "room_10x10_woodworker_N", 20 ],
            [ "room_10x10_guns_N", 5 ],
            [ "room_10x10_pool_N", 5 ],
            [ "room_10x10_recording_studio_N", 20 ],
            [ "room_10x10_junk_N", 20 ]
          ]
        }
      }
    }
  }
]
