[
  {
    "method": "json",
    "om_terrain": "house_vacant",
    "//": "no roof, just foundation pits",
    "type": "mapgen",
    "weight": 80,
    "object": {
      "fill_ter": "t_dirt",
      "rows": [
        "_......._........_....._",
        ".c_._....__._c_c....c..c",
        "_c.._.c......_.._._...__",
        "__.D{...c{{._........c._",
        "_._..._.......||##||....",
        "...c.......c..|dc.0|.._.",
        ".._.#########||..0.#_.._",
        "_c.d#d.0d..0.0.0...#.c..",
        "._.d#....0.dp.#.0.0|_d._",
        "_..d#0.p......#####|....",
        "_._d#....p.0.0....d|.__.",
        "_.cd#d.0......#.00.|c._.",
        "._.d#.pd.0.d0.#####|.d._",
        "...d#......p..#.d0.|.._.",
        "_...##0.0....0....d#_.c.",
        "..d..#..d.p.d.#.0..#..__",
        "_.c..#.0..d0..#..c0|.__.",
        "_....#######||||##||..._",
        "__.dd._.c........._..c__",
        "_.dddd.._..d.._.c_...d_.",
        "_.ddd..dc.d_..d...d...._",
        "__dddcd_....._.._..._._.",
        "._._._..__._._.._d.___._",
        "_c_._._.._._.c._.._._.__"
      ],
      "terrain": {
        "#": "t_brick_wall_halfway",
        ".": "t_dirt",
        "0": "t_pit_shallow",
        "D": "t_dirt",
        "_": "t_grass",
        "c": "t_grass",
        "d": "t_dirtmound",
        "p": "t_pit",
        "{": "t_dirt",
        "|": "t_brick_wall"
      },
      "furniture": { "D": "f_dumpster", "{": "f_dumpster" },
      "place_item": [
        { "chance": 30, "item": "nail", "repeat": 1, "x": 7, "y": 4 },
        { "chance": 30, "item": "concrete", "repeat": 1, "x": 2, "y": 6 },
        { "chance": 30, "item": "concrete", "repeat": 4, "x": 1, "y": 7 },
        { "chance": 30, "item": "concrete", "repeat": 1, "x": 2, "y": 7 },
        { "chance": 30, "item": "rebar", "repeat": 2, "x": 2, "y": 8 },
        { "chance": 30, "item": "rebar", "repeat": 1, "x": 2, "y": 9 },
        { "chance": 30, "item": "nailgun", "repeat": 1, "x": 15, "y": 11 },
        { "chance": 30, "item": "2x4", "repeat": 1, "x": 4, "y": 15 },
        { "chance": 30, "item": "nailboard", "repeat": 1, "x": 3, "y": 18 }
      ],
      "place_items": [
        { "chance": 20, "item": "hand_tools", "x": 14, "y": 3 },
        { "chance": 10, "item": "power_tools", "x": 13, "y": 11 },
        { "chance": 10, "item": "power_tools", "x": 11, "y": 5 },
        { "chance": 15, "item": "tools_common", "x": 12, "y": 5 },
        { "chance": 25, "item": "trash", "x": 17, "y": 13 },
        { "chance": 30, "item": "trash", "x": 4, "y": 13 },
        { "chance": 25, "item": "trash", "x": 16, "y": 8 },
        { "chance": 30, "item": "trash", "x": 9, "y": 3 },
        { "chance": 30, "item": "floor_trash", "x": 12, "y": 16 },
        { "chance": 20, "item": "floor_trash", "x": 4, "y": 4 },
        { "chance": 10, "item": "floor_trash", "x": 9, "y": 2 },
        { "chance": 20, "item": "tools_carpentry", "x": 13, "y": 12 },
        { "chance": 10, "item": "tools_carpentry", "x": 13, "y": 5 },
        { "chance": 20, "item": "tools_construction", "x": 17, "y": 6 },
        { "chance": 15, "item": "clothing_work_gloves", "x": 4, "y": 3 },
        { "chance": 20, "item": "clothing_work_boots", "x": 8, "y": 14 },
        { "chance": 50, "item": "hardware_bulk", "x": 1, "y": 11 },
        { "chance": 30, "item": "hardware_bulk", "x": 1, "y": 14 },
        { "chance": 30, "item": "hardware_bulk", "x": 1, "y": 15 },
        { "chance": 30, "item": "hardware_bulk", "x": 7, "y": 3 },
        { "chance": 30, "item": "hardware_bulk", "x": 8, "y": 2 },
        { "chance": 30, "item": "hardware_trash", "x": 6, "y": 10 },
        { "chance": 30, "item": "hardware_trash", "x": 18, "y": [ 7, 8 ] },
        { "chance": 30, "item": "hardware_trash", "x": 3, "y": [ 3, 4 ] },
        { "chance": 10, "item": "tools_construction", "x": 12, "y": 4 },
        { "chance": 20, "item": "construction_worker", "x": 15, "y": 8 }
      ]
    }
  },
  {
    "method": "json",
    "om_terrain": "house_vacant2",
    "//": "no roof, just foundation pits",
    "type": "mapgen",
    "weight": 80,
    "object": {
      "fill_ter": "t_dirt",
      "rows": [
        "_......._........_....._",
        ".c.._......._._c....c..c",
        "_##...c........._._...._",
        ".#.d{...c{{._........c._",
        "_._..._.......bbbbbb....",
        "...c.......c..b#p.0b....",
        ".._.bbbbbbbbbbb..0.b_.._",
        "_c.#b#.0#..0.0.0.0.b.c..",
        "...#b..0#0.#p.b.0.0b.#._",
        "_..#b00p.00...bbbbbb....",
        "_.##b...0p.p#0.0p.#..._.",
        "..c#b#.0#.00..b.00..c...",
        "._.#b.p00p##0.bbbbbb.#._",
        "...#b.0p..0#..b.#0...._.",
        "_...bb0.00...00.0.#._.c.",
        "..#..b#0#.p0#.b#00....._",
        "_.c..b.0..#0..b0.c0.._..",
        "_....bp0p0pp0p0p0bbb..._",
        "._.##._.c........._..c__",
        "_.####.....#.._.c..0.#_.",
        "..###..#c.##..#...##..._",
        "_.###c#_...0...#...#0...",
        "._._._..._..._0._#._._._",
        "_c_._._.._._.c._.._._.__"
      ],
      "terrain": {
        "#": "t_dirtmound",
        ".": "t_dirt",
        "0": "t_pit_shallow",
        "_": "t_grass",
        "b": "t_brick_wall_halfway",
        "c": "t_grass",
        "d": "t_dirt",
        "p": "t_pit",
        "{": "t_dirt"
      },
      "furniture": { "d": "f_dumpster", "{": "f_dumpster" },
      "place_item": [
        { "chance": 30, "item": "nail", "repeat": 1, "x": 7, "y": 4 },
        { "chance": 30, "item": "concrete", "repeat": 1, "x": 2, "y": 6 },
        { "chance": 30, "item": "concrete", "repeat": 3, "x": 2, "y": 7 },
        { "chance": 30, "item": "rebar", "repeat": 2, "x": 2, "y": 8 },
        { "chance": 30, "item": "rebar", "repeat": 1, "x": 2, "y": 9 },
        { "chance": 30, "item": "2x4", "repeat": 1, "x": 4, "y": 15 },
        { "chance": 30, "item": "2x4", "repeat": 3, "x": 4, "y": 16 },
        { "chance": 30, "item": "2x4", "repeat": 11, "x": 4, "y": 17 }
      ],
      "place_items": [
        { "chance": 20, "item": "hand_tools", "x": 14, "y": 3 },
        { "chance": 10, "item": "power_tools", "x": 13, "y": 11 },
        { "chance": 10, "item": "power_tools", "x": 3, "y": 6 },
        { "chance": 15, "item": "tools_common", "x": 12, "y": 5 },
        { "chance": 35, "item": "trash", "x": 17, "y": 13 },
        { "chance": 25, "item": "trash", "x": 4, "y": 13 },
        { "chance": 25, "item": "trash", "x": 16, "y": 8 },
        { "chance": 25, "item": "trash", "x": 6, "y": 7 },
        { "chance": 25, "item": "trash", "x": 9, "y": 3 },
        { "chance": 35, "item": "floor_trash", "x": 12, "y": 16 },
        { "chance": 15, "item": "floor_trash", "x": 4, "y": 4 },
        { "chance": 15, "item": "floor_trash", "x": 9, "y": 2 },
        { "chance": 20, "item": "tools_carpentry", "x": 13, "y": 5 },
        { "chance": 20, "item": "tools_construction", "x": 13, "y": 4 },
        { "chance": 15, "item": "clothing_work_gloves", "x": 4, "y": 3 },
        { "chance": 20, "item": "clothing_work_boots", "x": 8, "y": 14 },
        { "chance": 30, "item": "hardware_bulk", "x": 1, "y": 11 },
        { "chance": 30, "item": "hardware_bulk", "x": 1, "y": 12 },
        { "chance": 30, "item": "hardware_bulk", "x": 1, "y": 13 },
        { "chance": 30, "item": "hardware_bulk", "x": 1, "y": 14 },
        { "chance": 30, "item": "hardware_bulk", "x": 1, "y": 14 },
        { "chance": 30, "item": "hardware_bulk", "x": 7, "y": 2 },
        { "chance": 30, "item": "hardware_bulk", "x": 8, "y": 3 },
        { "chance": 30, "item": "hardware_trash", "x": 6, "y": 10 },
        { "chance": 20, "item": "hardware_trash", "x": 18, "y": [ 7, 8 ] },
        { "chance": 30, "item": "hardware_trash", "x": 10, "y": 3 },
        { "chance": 30, "item": "hardware_trash", "x": 3, "y": [ 3, 4 ] },
        { "chance": 20, "item": "construction_worker", "x": 15, "y": 8 },
        { "chance": 20, "item": "construction_worker", "x": 6, "y": 3 }
      ]
    }
  }
]
