[
  {
    "type": "mapgen",
    "method": "json",
    "om_terrain": [ "house_toolshed" ],
    "weight": 200,
    "object": {
      "fill_ter": "t_floor",
      "rows": [
        ".%%%.........-----p..^..",
        ".%#####o###o###*#######.",
        ".%#89|d     I|L  sHHHHo.",
        ".%ot |D @@  E|   H    o.",
        ".%#S +  @@   |R  H    #.",
        ".##|||||||||+|R   EsEyo.",
        ".oD    E|T            o.",
        ".#d @@  |6  hfh   AAA #.",
        ".ob @@I |6  hfh  JJJJJ#.",
        ".#|||||+|   hfh      7#.",
        ".#v|d                Oo.",
        ".#>+      y   y 341F52#.",
        ".#||+|##[###[###o######.",
        ".oB  S#~~~~~~~..%%jjj%$.",
        ".#B8 t#~~GKG~~.....~..$.",
        ".######~~GKG~~~~~~~~..$.",
        ".$^....~~~~~~~.....~..$.",
        ".$.................~..$.",
        ".$..............###*###.",
        ".$..............#q!!!q#.",
        ".$..............#q!!!q#.",
        ".$..............#qq!!q#.",
        ".$$$$$$$$$$$$$$$#######.",
        "........................"
      ],
      "palettes": [ "standard_domestic_palette" ],
      "terrain": {
        "%": [ "t_region_shrub", "t_region_shrub_fruit", "t_region_shrub_decorative" ],
        "$": "t_fence",
        "#": "t_adobe_brick_wall",
        "[": "t_door_glass_c",
        "G": "t_concrete",
        "K": "t_concrete",
        "~": "t_concrete",
        "q": "t_thconc_floor",
        "!": "t_thconc_floor"
      },
      "set": [
        { "point": "terrain", "id": "t_tree_apple", "x": [ 0, 14 ], "y": [ 0, 0 ], "repeat": [ 1, 2 ] },
        { "point": "terrain", "id": "t_tree", "x": [ 2, 14 ], "y": [ 17, 21 ], "repeat": [ 1, 3 ] },
        { "point": "terrain", "id": "t_tree_young", "x": [ 2, 14 ], "y": [ 17, 21 ], "repeat": [ 1, 3 ] }
      ],
      "place_loot": [
        { "group": "guns_pistol_common", "x": [ 2, 2 ], "y": [ 9, 10 ], "chance": 5, "ammo": 90, "magazine": 100 },
        { "group": "supplies_fuel", "x": [ 17, 21 ], "y": [ 19, 21 ], "chance": 75, "repeat": [ 1, 2 ] },
        { "item": "television", "x": [ 21, 21 ], "y": [ 9, 9 ], "chance": 75 },
        { "item": "laptop", "x": [ 10, 10 ], "y": [ 7, 7 ], "chance": 15 },
        { "item": "lawnmower", "x": [ 20, 20 ], "y": [ 21, 21 ], "chance": 70 },
        { "item": "stepladder", "x": 19, "y": 21, "chance": 70 }
      ],
      "place_monsters": [ { "monster": "GROUP_ZOMBIE", "x": [ 2, 21 ], "y": [ 2, 21 ], "chance": 2 } ]
    }
  },
  {
    "type": "mapgen",
    "method": "json",
    "om_terrain": "house_toolshed_roof",
    "object": {
      "fill_ter": "t_shingle_flat_roof",
      "rows": [
        "                        ",
        " |222222222222222222253.",
        " |....................3 ",
        " |....................3 ",
        " |....................3 ",
        " |..X.................3 ",
        " |....................3 ",
        " |....................3 ",
        " |...............&....3 ",
        " |....................3 ",
        " |....................3 ",
        " |....................3 ",
        " |....3---------------3 ",
        " |.=..3                 ",
        " |....3                 ",
        " |5---3                 ",
        "                        ",
        "                        ",
        "                ....... ",
        "                ....... ",
        "                ....... ",
        "                ....... ",
        "                ....... ",
        "                        "
      ],
      "palettes": [ "roof_palette" ],
      "terrain": { ".": "t_shingle_flat_roof" }
    }
  }
]
