[
  {
    "method": "json",
    "om_terrain": "house_29",
    "//": "used by basement_chem",
    "type": "mapgen",
    "weight": 100,
    "object": {
      "fill_ter": "t_floor",
      "rows": [
        "..........``p...........",
        "..........``............",
        "..........``.....X......",
        "...`````````............",
        "...`......```````````...",
        "...`..%%.```..%%....`...",
        "...`..####*###o###..`...",
        "...`..#xxy L|@d y#..`...",
        "...`..o l   |@  Io..`...",
        "...`..#HHH  |  hIo..`...",
        "...`..#RRT  |    #..`...",
        "...`.%#     + ybD#ŦŦɤŦŦŦ",
        "ŦŦŦɤŦŦ# hfh |||||#..`..Ŧ",
        "Ŧ..`.%o hfh  |QBB#..`..Ŧ",
        "Ŧ..`.%#      +---o..`..Ŧ",
        "Ŧ..`..#5    Y|t8S#..`..Ŧ",
        "Ŧ..`..#O    7#####..`..Ŧ",
        "Ŧ..`..o4    6#^jj%..`..Ŧ",
        "Ŧ..`..#F123 >#......`..Ŧ",
        "Ŧ..`..##oo#*##..[...`..Ŧ",
        "Ŧ..`.......`........`..Ŧ",
        "Ŧ..``````````````````..Ŧ",
        "Ŧ......................Ŧ",
        "ŦŦŦŦŦŦŦŦŦŦŦŦŦŦŦŦŦŦŦŦŦŦŦŦ"
      ],
      "palettes": [ "domestic_general_and_variant_palette", "standard_domestic_landscaping_palette", "standard_domestic_lino_bathroom" ],
      "terrain": { "-": "t_linoleum_gray" },
      "place_vehicles": [ { "vehicle": "rolling_trash_can", "x": 8, "y": 1, "chance": 80, "status": 0 } ]
    }
  },
  {
    "type": "mapgen",
    "method": "json",
    "om_terrain": "house_29_roof",
    "object": {
      "fill_ter": "t_shingle_flat_roof",
      "rows": [
        "                        ",
        "                        ",
        "                        ",
        "                        ",
        "                        ",
        "                        ",
        "      ------------      ",
        "      -..........-      ",
        "      -..........-      ",
        "      -..........-      ",
        "      -..........-      ",
        "      -..........-      ",
        "      -..........-      ",
        "      -..........-      ",
        "      -..........-      ",
        "      -..........-      ",
        "      -......5----      ",
        "      -......-          ",
        "      -......-          ",
        "      --------          ",
        "                        ",
        "                        ",
        "                        ",
        "                        "
      ],
      "palettes": [ "roof_palette" ],
      "terrain": { ".": "t_shingle_flat_roof" }
    }
  }
]
