[
    {
        "type" : "mapgen",
        "om_terrain" : ["house"],
        "method" : "json",
        "weight" : 300,
        "object" : {
            "fill_ter" : "t_floor",
            "rows" : [
                ".#ssssssss..###...s.....",
                ".#ssssssss.----vv-;----.",
                ".#ssssssss.|ooo      ?|.",
                ".#ssssssss.|    n    ?|.",
                ".#ssssssss.|         ?|.",
                ".#ssssssss.|????      |.",
                ".#ssssssss.|          |.",
                ".#ssssssss.|    hhh   v.",
                "..sssssssss;    nnn   v.",
                "..ssssssss.|    nnn   v.",
                "..ssssssss.|    hhh   v.",
                "..ssssssss.|          |.",
                ".|---------|+-----+---|.",
                ".vSCfO     | | t     B|.",
                ".v         + |      BBv.",
                ".v ccc  rrr| + S    BB|.",
                ".|---------| |--------|.",
                ".|d        | |  rrrr  |.",
                ".|@@       | |        |.",
                ".|@@       + +  rrrr  |.",
                ".|         | |        |.",
                ".|         | |  cccc  |.",
                ".----vv-----v----------.",
                "........................"
            ],
            "terrain" : {
                "|" : "t_wall",
                "-" : "t_wall",
                "." : "t_grass",
                "#" : "t_shrub",
                "+" : "t_door_c",
                ";" : "t_door_locked",
                "?" : "t_floor",
                "@" : "t_floor",
                "B" : "t_floor",
                "C" : "t_floor",
                "c" : "t_floor",
                "D" : "t_floor",
                "d" : "t_floor",
                "f" : "t_floor",
                "h" : "t_floor",
                "n" : "t_floor",
                "O" : "t_floor",
                "o" : "t_floor",
                "r" : "t_floor",
                "S" : "t_floor",
                "s" : "t_sidewalk",
                "v" : "t_window_domestic"
            },
            "furniture" : {
                "?" : "f_sofa",
                "@" : "f_bed",
                "B" : "f_bathtub",
                "C" : "f_cupboard",
                "c" : "f_counter",
                "D" : "f_trashcan",
                "d" : "f_dresser",
                "f" : "f_fridge",
                "h" : "f_chair",
                "n" : "f_table",
                "O" : "f_oven",
                "o" : "f_bookcase",
                "r" : "f_rack",
                "S" : "f_sink"
            },
            "toilets" : {
                "t" : { }
            },
            "set" : [
                { "point" : "terrain", "id" : "t_dirt", "x" : [23,23], "y" : [ 0,23], "repeat" : [5,10] },
                { "point" : "terrain", "id" : "t_dirt", "x" : [ 0,23], "y" : [23,23], "repeat" : [5, 8] }
            ],
            "place_vehicles" : [
                { "vehicle" : "rv", "x" : 5, "y" : 4, "rotation" : 270, "chance" : 10 }
            ],
            "place_loot" : [
                { "group" : "bed",                  "chance" : 90, "x" : [ 2, 3], "y" : [18,19], "repeat" : [1,3] },
                { "group" : "livingroom",           "chance" : 90, "x" : [12,21], "y" : [ 2, 6], "repeat" : [1,4] },
                { "group" : "dining",               "chance" : 80, "x" : [16,18], "y" : [ 8, 9], "repeat" : [1,4] },
                { "group" : "bedroom",              "chance" : 80, "x" : [ 1,10], "y" : [17,21], "repeat" : [1,5] },
                { "group" : "dresser",              "chance" : 85, "x" : [ 2, 2], "y" : [17,17], "repeat" : [1,4] },
                { "group" : "consumer_electronics", "chance" : 20, "x" : [ 1,10], "y" : [17,21], "repeat" : [1,2] },
                { "group" : "guns_pistol_common",   "chance" :  5, "x" : [ 2, 2], "y" : [17,17], "magazine" : 100, "ammo" : 90 },
                { "group" : "novels",               "chance" : 85, "x" : [12,14], "y" : [ 2, 2], "repeat" : [1,3] },
                { "group" : "cleaning",             "chance" : 90, "x" : [14,21], "y" : [13,15], "repeat" : [1,2] },
                { "group" : "softdrugs",            "chance" : 75, "x" : [14,21], "y" : [13,15], "repeat" : [1,3] },
                { "group" : "kitchen",              "chance" : 75, "x" : [ 2,10], "y" : [13,15], "repeat" : [1,3] },
                { "group" : "fridge",               "chance" : 90, "x" : [ 4, 4], "y" : [13,13], "repeat" : [1,5] },
                { "group" : "oven",                 "chance" : 75, "x" : [ 5, 5], "y" : [13,13], "repeat" : [1,3] },
                { "group" : "cannedfood",           "chance" : 40, "x" : [ 9,10], "y" : [15,15], "repeat" : [1,2] },
                { "group" : "pasta",                "chance" : 40, "x" : [ 3, 5], "y" : [15,15], "repeat" : [1,2] },
                { "group" : "knifeblock",           "chance" : 70, "x" : [ 3, 5], "y" : [15,15], "repeat" : [1,2] },
                { "group" : "cannedfood",           "chance" : 60, "x" : [16,19], "y" : [17,17], "repeat" : [1,3] },
                { "group" : "camping",              "chance" : 70, "x" : [16,19], "y" : [19,19], "repeat" : [1,4] },
                { "group" : "softdrugs",            "chance" : 60, "x" : [16,19], "y" : [21,21], "repeat" : [1,3] }
            ],
            "place_monsters" : [
                { "monster" : "GROUP_ZOMBIE", "chance" : 2, "x" : [2,21], "y" : [2,21] }
            ]
        }
    }
]
