[
  {
    "method": "json",
    "om_terrain": "house_28",
    "//": "used by basement_weed",
    "type": "mapgen",
    "weight": 100,
    "object": {
      "fill_ter": "t_floor",
      "rows": [
        ".````````````p..........",
        ".`......%%```%%.........",
        ".`.....##o#*#o##.....[..",
        ".`..[..#r     L#........",
        ".`.....or     io..[.....",
        ".`.....#y     i#........",
        ".`.#####     ||#####....",
        ".`.#F126     |dT  I#....",
        ".`.o4        |   @@o....",
        ".`.o5   hfh  |   @@#.[..",
        ".`.oO   hfh  +     o....",
        ".`.#7       y|  EbD#....",
        ".`.#TsHHH   R|+|####ŦɤŦŦ",
        ".`.#E  l    R|-t#^.....Ŧ",
        "ŦɤŦ#y xxx   R|S9#...[..Ŧ",
        "Ŧ`.##o#####  ####......Ŧ",
        "Ŧ`..^...``# i#.........Ŧ",
        "Ŧ`````````¶ i:......[..Ŧ",
        "Ŧ..[....``:y>:.........Ŧ",
        "Ŧ.........#::#...[.....Ŧ",
        "Ŧ...[..................Ŧ",
        "Ŧ.......[...[.......[..Ŧ",
        "Ŧ.[............[.......Ŧ",
        "ŦŦŦŦŦŦŦŦŦŦŦŦŦŦŦŦŦŦŦŦŦŦŦŦ"
      ],
      "palettes": [ "domestic_general_and_variant_palette", "standard_domestic_landscaping_palette", "standard_domestic_lino_bathroom" ],
      "terrain": { "-": "t_linoleum_gray" },
      "place_vehicles": [ { "vehicle": "rolling_trash_can", "x": 15, "y": 1, "chance": 80, "status": 0 } ]
    }
  },
  {
    "type": "mapgen",
    "method": "json",
    "om_terrain": "house_28_roof",
    "object": {
      "fill_ter": "t_shingle_flat_roof",
      "rows": [
        "                        ",
        "                        ",
        "       ---------        ",
        "       -.......-        ",
        "       -.......-        ",
        "       -...X...-        ",
        "   -----.......-----    ",
        "   -...............-    ",
        "   -........&......-    ",
        "   -...............-    ",
        "   -...............-    ",
        "   -...N...........-    ",
        "   -.........=..5---    ",
        "   -............-       ",
        "   -............-       ",
        "   -5------..----       ",
        "          -..-          ",
        "          -..-          ",
        "          -..-          ",
        "          ----          ",
        "                        ",
        "                        ",
        "                        ",
        "                        "
      ],
      "palettes": [ "roof_palette" ],
      "terrain": { ".": "t_shingle_flat_roof" }
    }
  }
]
