[
  {
    "type": "mapgen",
    "method": "json",
    "om_terrain": [ "house_42" ],
    "object": {
      "fill_ter": "t_floor",
      "rows": [
        "............``p.........",
        "............``....[.....",
        "..##oo##o##.``..........",
        "..#REII| d#.``..%%%%%%^.",
        "..oy h + D#!``!##oooo##.",
        "..#    |||##o*##x  Es #.",
        "..# @@ |y    ÷L|x    Ho.",
        "..#¤@@ +           llH#.",
        "..#||||| hfh      HHHs#.",
        "..o8tS|  hfh          o.",
        "..#9''+      ÷T|  yRRR#.",
        "..#||||===###¶##  ||||#.",
        "..#F=JJ=AJ#jj~~#  + dD#.",
        "..o5====AJ#j~~~#|+|   o.",
        "..#1=====J#j~~~#S'|  ¤#.",
        "..#23O47=Y#~~~~ot'| @@o.",
        "..##o##|=|#$$/$#BB|b ¤#.",
        ".....^#W=6#````#####o##.",
        "......#Z=6#.............",
        "......##*##.............",
        "...[...............[....",
        "........................",
        ".............[.....[....",
        "........................"
      ],
      "palettes": [
        "domestic_general_and_variant_palette",
        "standard_domestic_lino_kitchen",
        "standard_domestic_lino_bathroom",
        "standard_domestic_landscaping_palette"
      ],
      "terrain": {
        "~": "t_thconc_floor",
        "j": "t_thconc_floor",
        "'": { "param": "linoleum_color_bathroom", "fallback": "t_linoleum_gray" },
        "A": { "param": "linoleum_color_kitchen", "fallback": "t_linoleum_gray" },
        "Y": { "param": "linoleum_color_kitchen", "fallback": "t_linoleum_gray" },
        "W": { "param": "linoleum_color_kitchen", "fallback": "t_linoleum_gray" },
        "Z": { "param": "linoleum_color_kitchen", "fallback": "t_linoleum_gray" },
        "$": "t_screened_porch_wall",
        "/": "t_screen_door_c"
      },
      "furniture": { ":": [ "f_indoor_plant", "f_indoor_plant_y" ] },
      "place_loot": [
        { "item": "hose", "x": 19, "y": 18, "chance": 35 },
        { "item": "television", "x": 16, "y": 5, "chance": 35 },
        { "item": "stereo", "x": 16, "y": 6, "chance": 35 }
      ],
      "place_vehicles": [ { "vehicle": "tricycle", "x": 13, "y": 14, "chance": 35, "rotation": 270 } ],
      "place_nested": [ { "chunks": [ "rolling_trash_can_1x1" ], "x": 5, "y": 1 } ]
    }
  },
  {
    "type": "mapgen",
    "method": "json",
    "om_terrain": "house_42_roof",
    "object": {
      "fill_ter": "t_shingle_flat_roof",
      "rows": [
        "                        ",
        "                        ",
        "  ---------             ",
        "  -.......-             ",
        "  -.......-    ------5- ",
        "  -.......------......- ",
        "  -..............X....- ",
        "  -...................- ",
        "  -...................- ",
        "  -...................- ",
        "  -...........N.......- ",
        "  -...................- ",
        "  -.....=.........&...- ",
        "  -...................- ",
        "  -...................- ",
        "  -...................- ",
        "  ----5...------......- ",
        "      -...-    -------- ",
        "      -...-             ",
        "      -----             ",
        "                        ",
        "                        ",
        "                        ",
        "                        "
      ],
      "palettes": [ "roof_palette" ],
      "terrain": { ".": "t_shingle_flat_roof" }
    }
  }
]
