[
  {
    "type": "mapgen",
    "method": "json",
    "om_terrain": [ "house_38" ],
    "object": {
      "fill_ter": "t_floor",
      "rows": [
        "........p`!.....&`````%.",
        "....%%%.!`!..[.##=====#.",
        "...##o##!`!....#&~~~~~#.",
        "...#D d#$;$#$$$#~~~~~~#.",
        "...#D d#~~~~G::#~~~~~~#.",
        "..##|+|#*o##oo##~~~~~~#^",
        "..#BB_S| L| hhh#~~~~~~##",
        "..oBB_t|    fff#~~~~~~U#",
        "..#BB_8|    hhh#~~~~~~~o",
        "..#||+||       #q~~~~~No",
        "..#D| R|  | RRy#q~~~~AN#",
        "..#+|  +  |||||###*#####",
        "..#    |    rrT |6___1#.",
        "..o   d|     h   ____O#.",
        "..#b   |   EsE   ____2#.",
        "..o @@ |H      y|F_453#.",
        "..#I@@I|H  l   x##*#o##.",
        "..##oo##H  l   a#~~~~~$.",
        "....%%^#H   E  x#~~~::$.",
        ".......##oo##oo##$;$$$$.",
        ".........%%..%%..```!!!.",
        ".................`````..",
        "........................",
        "........................"
      ],
      "palettes": [ "standard_domestic_palette" ],
      "terrain": {
        "%": [ "t_region_shrub", "t_region_shrub_fruit", "t_region_shrub_decorative" ],
        "[": [ [ "t_region_tree_fruit", 2 ], [ "t_region_tree_nut", 2 ], "t_region_tree_shade" ],
        "!": "t_region_groundcover_urban",
        "=": "t_door_metal_locked",
        "&": "t_gates_control_brick",
        "#": "t_brick_wall",
        "~": "t_thconc_floor",
        "q": "t_thconc_floor",
        "U": "t_thconc_floor",
        "A": "t_thconc_floor",
        "G": "t_thconc_floor",
        "N": "t_thconc_floor",
        "`": "t_concrete",
        ":": "t_thconc_floor",
        "_": "t_linoleum_white",
        "J": "t_linoleum_white",
        "1": "t_linoleum_white",
        "2": "t_linoleum_white",
        "3": "t_linoleum_white",
        "4": "t_linoleum_white",
        "5": "t_linoleum_white",
        "6": "t_linoleum_white",
        "7": "t_linoleum_white",
        "8": "t_linoleum_white",
        "O": "t_linoleum_white",
        "F": "t_linoleum_white",
        "B": "t_linoleum_white",
        "S": "t_linoleum_white",
        "t": "t_linoleum_white",
        "$": "t_screened_porch_wall",
        ";": "t_screen_door_c"
      },
      "furniture": { "!": "f_region_flower", ":": [ "f_indoor_plant", "f_indoor_plant_y" ] },
      "place_loot": [
        { "item": "hose", "x": 19, "y": 20, "chance": 35 },
        { "item": "lawnmower", "x": 22, "y": 8, "chance": 35 },
        { "item": "television", "x": 15, "y": 16 },
        { "item": "stereo", "x": 15, "y": 18, "chance": 35 }
      ],
      "place_vehicles": [ { "vehicle": "car", "x": 19, "y": 5, "chance": 35, "rotation": 270 } ]
    }
  },
  {
    "type": "mapgen",
    "method": "json",
    "om_terrain": "house_38_roof",
    "object": {
      "fill_ter": "t_shingle_flat_roof",
      "rows": [
        "                        ",
        "               |2222223 ",
        "   |2222       |......3 ",
        "   |...32222222|......3 ",
        "   |..................3 ",
        "  ||..................3 ",
        "  |...................53",
        "  |....................3",
        "  |....................3",
        "  |......X.......N.....3",
        "  |....................3",
        "  |...................33",
        "  |...................3 ",
        "  |.......=.&.........3 ",
        "  |...................3 ",
        "  |...................3 ",
        "  |...................3 ",
        "  |----5..............3 ",
        "       |..............3 ",
        "       |--------------3 ",
        "                        ",
        "                        ",
        "                        ",
        "                        "
      ],
      "palettes": [ "roof_palette" ],
      "terrain": { ".": "t_shingle_flat_roof" }
    }
  }
]
