[
  {
    "type": "mapgen",
    "om_terrain": "house_fence02_1",
    "weight": 250,
    "method": "json",
    "object": {
      "palettes": [
        "standard_domestic_palette",
        "standard_domestic_lino_kitchen",
        "standard_domestic_lino_bathroom",
        "standard_domestic_landscaping_palette"
      ],
      "fill_ter": "t_floor",
      "rows": [
        "}.........)))))))p.....}",
        "}.......[.))))))).$$$$.}",
        "}.?...?...))))))).$$$$.}",
        "}.........)))))))....?.}",
        "}.--------)))))))-----.}",
        "}.-.../...)))))))./..-.}",
        "}.-.......)))))))....-.}",
        "}.-(((###o###o####o##-.}",
        "}.-/((#JJ5F3hff|D¤@@#-.}",
        "}.-(((oO____  h|  @@#-.}",
        "}.-(((#6612_   +    o-.}",
        "}.-(((#||||    |||++#-.}",
        "}.-(((#t~~+    |Q|dd#-.}",
        "}.-(((o8S9|RR  |+|||#-.}",
        "}.-/((#||||||    b=&o-.}",
        "}.-(((#¤yrrD|       *-.}",
        "}.-(((o@ h  +      L#-.}",
        "}.-(((#@   d|y  x  V#-.}",
        "}.-(((#||||||      so-.}",
        "}.-/((oZ~~`        E#..}",
        "}.--<-#W~<|RRRlHHHly#^.}",
        "}.----##o#######o####..}",
        "}...........^..........}",
        "}}}}}}}}}}}}}}}}}}}}}}}}"
      ],
      "terrain": {
        "}": "t_privacy_fence",
        "/": "t_column",
        ")": "t_pavement",
        "W": { "param": "linoleum_color_bathroom", "fallback": "t_linoleum_gray" },
        "Z": { "param": "linoleum_color_bathroom", "fallback": "t_linoleum_gray" },
        "`": "t_door_locked",
        "(": "t_dirt",
        "$": "t_dirtmound",
        "%": [ [ "t_region_tree_nut", 5 ], [ "t_region_tree_shade", 4 ], [ "t_region_tree_fruit", 2 ] ],
        "_": { "param": "linoleum_color_kitchen", "fallback": "t_linoleum_gray" },
        "Q": "t_null",
        "?": "t_region_groundcover_urban"
      },
      "furniture": { "?": [ "f_boulder_medium", "f_boulder_large" ], "$": "f_region_flower", "&": "f_rack", "=": "f_table" },
      "items": {
        "=": { "item": "table_foyer", "chance": 50 },
        "&": { "item": "clothing_outdoor_shoes", "chance": 40, "repeat": [ 1, 2 ] }
      },
      "place_loot": [ { "item": "television", "x": 16, "y": 17 } ],
      "place_vehicles": [ { "vehicle": "car", "x": 14, "y": 3, "chance": 20, "rotation": 90 } ]
    }
  },
  {
    "type": "mapgen",
    "om_terrain": "house_fence02_2",
    "weight": 250,
    "method": "json",
    "object": {
      "palettes": [ "standard_domestic_palette", "standard_domestic_lino_kitchen", "standard_domestic_lino_bathroom" ],
      "fill_ter": "t_floor",
      "rows": [
        "........................",
        "........................",
        "........................",
        "........................",
        "...))))))))))))))))))...",
        "...),,,,,,,,,,,,,,,,)...",
        "...),,,,,qqq,,,,₸$₸,)...",
        "...),,###o##o¶###oo##...",
        "...),,#xRdd|= Rs l H#...",
        "...),,#    |b RE l H#...",
        "...),,#¤   +  RT l Ho...",
        "...),,o@@ y|i      y#...",
        "...),,#@@ D|i   A__5#...",
        "...),,#|||||i  h6__O#...",
        "...),,#8S|RR  ff4__Jo...",
        "...),,o~~+   hff31FJ#...",
        "...),,#t9|y   ||||||#...",
        "...),,#|||L   |T rrr#...",
        "...),,*       +   h o...",
        "...),,#|`|||+||   @@#^..",
        "...)>,#z >|zzz|dd¤@@#...",
        "...)))##o########o###...",
        ".............^..........",
        "........................"
      ],
      "terrain": {
        "_": { "param": "linoleum_color_kitchen", "fallback": "t_linoleum_gray" },
        ")": "t_railing_v",
        ",": "t_floor_noroof",
        "`": "t_door_locked",
        "₸": "t_floor_noroof",
        "$": "t_floor_noroof",
        ".": "t_open_air",
        "q": "t_floor_noroof",
        "A": { "param": "linoleum_color_kitchen", "fallback": "t_linoleum_gray" }
      },
      "furniture": { "$": "f_tourist_table", "=": "f_table" },
      "items": { "=": { "item": "table_foyer", "chance": 50 } },
      "place_loot": [ { "item": "television", "x": 7, "y": 8 } ]
    }
  },
  {
    "type": "mapgen",
    "om_terrain": "house_fence02_roof",
    "weight": 250,
    "method": "json",
    "object": {
      "palettes": [ "roof_palette" ],
      "fill_ter": "t_shingle_flat_roof",
      "rows": [
        "                        ",
        "                        ",
        "                        ",
        "                        ",
        "                        ",
        "                        ",
        "                        ",
        "      ---------------   ",
        "      -.............-   ",
        "      -.............-   ",
        "      -.............-   ",
        "      -..........X..-   ",
        "      -.............-   ",
        "      -.............-   ",
        "      -.............-   ",
        "      -.N...........-   ",
        "      -.........=...-   ",
        "      -.............-   ",
        "      -.............-   ",
        "      -.............5   ",
        "      -.............-   ",
        "      ------5--------   ",
        "                        ",
        "                        "
      ],
      "terrain": { ".": "t_shingle_flat_roof" }
    }
  }
]
