[
  {
    "type": "mapgen",
    "method": "json",
    "om_terrain": [ "house_toolshed" ],
    "weight": 200,
    "object": {
      "fill_ter": "t_floor",
      "rows": [
        ".%%%.........-----p..^..",
        ".%#####o###o###*#######.",
        ".%#89|d     I|L  sHHHHo.",
        ".%ot |D @@  E|   H    o.",
        ".%#S +  @@   |R  H    #.",
        ".##|||||||||+|R   EsEyo.",
        ".oD    E|T            o.",
        ".#d @@  |6  hfh   AAA #.",
        ".ob @@I |6  hfh  JJJJJ#.",
        ".#|||||+|   hfh      7#.",
        ".#v|d                Oo.",
        ".#>+      y   y 341F52#.",
        ".#||+|##[###[###o######.",
        ".oB  S#~~~~~~~..%%jjj%$.",
        ".#B8 t#~~GKG~~.....~..$.",
        ".######~~GKG~~~~~~~~..$.",
        ".$^....~~~~~~~.....~..$.",
        ".$.................~..$.",
        ".$..............###*###.",
        ".$..............#q!!!q#.",
        ".$..............#q!!!q#.",
        ".$..............#qq!!q#.",
        ".$$$$$$$$$$$$$$$#######.",
        "........................"
      ],
      "palettes": [ "domestic_general_and_variant_palette" ],
      "terrain": {
        "%": [ "t_region_shrub", "t_region_shrub_fruit", "t_region_shrub_decorative" ],
        "$": "t_fence",
        "[": "t_door_glass_c",
        "G": "t_concrete",
        "K": "t_concrete",
        "~": "t_concrete",
        "q": "t_thconc_floor",
        "!": "t_thconc_floor"
      },
      "place_nested": [ { "chunks": [ "rolling_trash_can_1x1" ], "x": 6, "y": 0 } ],
      "set": [
        { "point": "terrain", "id": "t_tree_apple", "x": [ 0, 14 ], "y": [ 0, 0 ], "repeat": [ 1, 2 ] },
        { "point": "terrain", "id": "t_tree", "x": [ 2, 14 ], "y": [ 17, 21 ], "repeat": [ 1, 3 ] },
        { "point": "terrain", "id": "t_tree_young", "x": [ 2, 14 ], "y": [ 17, 21 ], "repeat": [ 1, 3 ] }
      ],
      "place_loot": [
        { "group": "guns_pistol_common", "x": [ 2, 2 ], "y": [ 9, 10 ], "chance": 5, "ammo": 90, "magazine": 100 },
        { "group": "supplies_fuel", "x": [ 17, 21 ], "y": [ 19, 21 ], "chance": 75, "repeat": [ 1, 2 ] },
        { "item": "television", "x": [ 21, 21 ], "y": [ 9, 9 ], "chance": 75 },
        { "item": "laptop", "x": [ 10, 10 ], "y": [ 7, 7 ], "chance": 15 },
        { "item": "lawnmower", "x": [ 20, 20 ], "y": [ 21, 21 ], "chance": 70 },
        { "item": "stepladder", "x": 19, "y": 21, "chance": 70 }
      ],
      "place_monsters": [ { "monster": "GROUP_ZOMBIE", "x": [ 2, 21 ], "y": [ 2, 21 ], "chance": 2 } ]
    }
  },
  {
    "type": "mapgen",
    "method": "json",
    "om_terrain": "house_toolshed_roof",
    "object": {
      "fill_ter": "t_shingle_flat_roof",
      "rows": [
        "                        ",
        " --------------------5- ",
        " -....................- ",
        " -....................- ",
        " -....................- ",
        " -..X.................- ",
        " -....................- ",
        " -....................- ",
        " -...............&....- ",
        " -....................- ",
        " -....................- ",
        " -....................- ",
        " -....----------------- ",
        " -.=..-                 ",
        " -....-                 ",
        " -5----                 ",
        "                        ",
        "                        ",
        "                ....... ",
        "                ....... ",
        "                ....... ",
        "                ....... ",
        "                ....... ",
        "                        "
      ],
      "palettes": [ "roof_palette" ],
      "terrain": { ".": "t_shingle_flat_roof" }
    }
  },
  {
    "type": "mapgen",
    "method": "json",
    "om_terrain": "house_toolshed_basement",
    "object": {
      "fill_ter": "t_thconc_floor",
      "rows": [
        "                        ",
        " |||||||||||||||||||||| ",
        " |S8%F.g%.z.2.........| ",
        " |t.%%++%z............| ",
        " |%+%.................| ",
        " |....................| ",
        " |.1..................| ",
        " |....................| ",
        " |....................| ",
        " |....................| ",
        " |....................| ",
        " |<...................| ",
        " |%%+%||||||||||||||||| ",
        " |W..J|                 ",
        " |Z..J|                 ",
        " ||||||                 ",
        "                        ",
        "                        ",
        "                        ",
        "                        ",
        "                        ",
        "                        ",
        "                        ",
        "                        "
      ],
      "palettes": [ "basement_empty" ],
      "nested": {
        "1": {
          "chunks": [
            [ "null", 60 ],
            [ "5x5_holdout_S", 2 ],
            [ "livingroom_5x5_S_1", 30 ],
            [ "livingroom_5x5_E_1", 30 ],
            [ "livingroom_5x5_N_1", 30 ],
            [ "livingroom_5x5_W_1", 30 ],
            [ "livingroom_5x5_S_2", 30 ],
            [ "livingroom_5x5_E_2", 30 ],
            [ "livingroom_5x5_N_2", 30 ],
            [ "livingroom_5x5_W_2", 30 ],
            [ "home_office_4x4_N", 20 ],
            [ "home_office_4x4_S", 20 ]
          ]
        },
        "2": {
          "chunks": [
            [ "null", 70 ],
            [ "room_10x10_woodworker_W", 20 ],
            [ "room_10x10_guns_W", 7 ],
            [ "room_10x10_pool_W", 2 ],
            [ "room_10x10_junk_W", 30 ],
            [ "room_10x10_recording_studio_W", 20 ]
          ]
        }
      }
    }
  }
]
