[
  {
    "method": "json",
    "om_terrain": "house_30",
    "//": "used by basement_chem2",
    "type": "mapgen",
    "weight": 100,
    "object": {
      "fill_ter": "t_floor",
      "rows": [
        ".......!`p..............",
        ".......!`!..............",
        ".......!`!......[.......",
        "...[...!`!..............",
        "......!```!.........[...",
        "......!```!!!!!!!.......",
        "......##*####ooo##......",
        "......#L |R  s  x#...[..",
        "......#  |R  H   o......",
        "......o      Hl  #......",
        "......#  |r  HHHT#......",
        "......#  |rh    y#^%%...",
        "...##### |||   ||##o##..",
        "...#9Qt|       +  y@@#..",
        "...oS--+ hfh   |    so..",
        "...##||| hfh   |dbD###..",
        "....#347   J|+|||||#....",
        "....#2     J|     d#....",
        "....o1     >|E @@  o....",
        "....#FO5  ####I@@ID#....",
        "....###o#*#`^##o#o##....",
        "........``````.!!!......",
        "...u....``````.....X....",
        "........................"
      ],
      "palettes": [ "domestic_general_and_variant_palette" ],
      "terrain": {
        "%": [ "t_region_shrub", "t_region_shrub_fruit", "t_region_shrub_decorative" ],
        "[": [ [ "t_region_tree_fruit", 2 ], [ "t_region_tree_nut", 2 ], "t_region_tree_shade" ],
        "!": "t_region_groundcover_urban",
        "`": "t_concrete",
        "-": "t_linoleum_white",
        "Q": "t_linoleum_white",
        "8": "t_linoleum_white",
        "B": "t_linoleum_white",
        "S": "t_linoleum_white",
        "9": "t_linoleum_white",
        "t": "t_linoleum_white"
      },
      "furniture": { "!": "f_region_flower" },
      "place_vehicles": [ { "vehicle": "rolling_trash_can", "x": 6, "y": 1, "chance": 80, "status": 0 } ]
    }
  },
  {
    "type": "mapgen",
    "method": "json",
    "om_terrain": "house_30_roof",
    "object": {
      "fill_ter": "t_shingle_flat_roof",
      "rows": [
        "                        ",
        "                        ",
        "                        ",
        "                        ",
        "                        ",
        "                        ",
        "      ------------      ",
        "      -..........-      ",
        "      -..........-      ",
        "      -..........-      ",
        "      -....=..&..-      ",
        "      -..........-      ",
        "   ----...X......5----  ",
        "   -.................-  ",
        "   -.................-  ",
        "   --........N.....---  ",
        "    -..............-    ",
        "    -..............-    ",
        "    -..............-    ",
        "    -.....---5.....-    ",
        "    -------  -------    ",
        "                        ",
        "                        ",
        "                        "
      ],
      "palettes": [ "roof_palette" ],
      "terrain": { ".": "t_shingle_flat_roof" }
    }
  }
]
