[
  {
    "method": "json",
    "om_terrain": "house_02",
    "//": "normal variant",
    "type": "mapgen",
    "weight": 100,
    "object": {
      "fill_ter": "t_floor",
      "rows": [
        "............!`!.........",
        "...........p!`!.........",
        "..$$$$$$$$$$!`!$$$$$$$..",
        "..$.........!`!......$..",
        "..$...[.....!`!...X..$..",
        "..$......[..```......$..",
        "..##oo##oo##:*:##ooo##..",
        "..#147FO5JJ|y L|D  @@#^.",
        "..#2       |   |b  @@o%.",
        "..#3  66  Y|   |d   Io%.",
        "..#|+||||+||   +  E T#%.",
        "..#            ||||||#..",
        "..o hfh    sss +  ETR#..",
        "..o hfh   ||||||     o..",
        "..o hfh   +----| h  @o..",
        "..#      y|9S8t|II d@#..",
        "..#||   ||#######ooo##..",
        "..#y    RR#GKG/.........",
        "..#x  H   ¶~~~/.........",
        "..#x  H E :~~~=.........",
        ".^#THHs rr#~~~/.........",
        "..###ooo###////.........",
        "........................",
        "........................"
      ],
      "palettes": [ "standard_domestic_migration_palette", "standard_domestic_landscaping_palette" ],
      "terrain": {
        "$": "t_fence",
        ";": "t_fencegate_c",
        "/": "t_screened_porch_wall",
        "=": "t_screen_door_c",
        "-": "t_linoleum_white",
        "8": "t_linoleum_white",
        "9": "t_linoleum_white",
        "S": "t_linoleum_white",
        "t": "t_linoleum_white",
        "G": "t_thconc_floor",
        "K": "t_thconc_floor",
        "~": "t_thconc_floor"
      },
      "place_vehicles": [ { "vehicle": "rolling_trash_can", "x": 7, "y": 1, "chance": 80, "status": 0 } ],
      "furniture": { "!": "f_region_flower" },
      "place_loot": [ { "item": "television", "x": 3, "y": 18 }, { "item": "stereo", "x": 3, "y": 19 } ],
      "place_nested": [
        {
          "chunks": [ [ "playset_4x4_2", 25 ], [ "firepit_5x5_1", 25 ], [ "firepit_5x5_2", 25 ], [ "playset_4x4_1", 25 ] ],
          "x": 17,
          "y": 18
        }
      ]
    }
  },
  {
    "method": "json",
    "om_terrain": "house_02",
    "//": "construction variant",
    "type": "mapgen",
    "weight": 20,
    "object": {
      "fill_ter": "t_floor",
      "rows": [
        ".............`..........",
        "...........A.`..........",
        "..ppppppppppp`pppppppp..",
        "..p..........`.......p..",
        "..p..........`.......p..",
        "..pCCCCCCCCC```......p..",
        "..##oo##oo##o*o##ooo##..",
        "..#887FOS77|   |     #..",
        "..#8       |  W|  W  o..",
        "..#8   W   |   |     o..",
        "..#|+wwww+||   +     #..",
        "..#            |wwwww#..",
        "..o        W   +   W #..",
        "..o       wwwww|     o..",
        "..oW      +~~~~|     o..",
        "..#    W  w~s6t|  W  #..",
        "..#ww   ww#######ooo##..",
        "..#      W#cccc.p.......",
        "..o  W    +cccc.....{...",
        "..o       #cccc.........",
        "..#       #cccc.........",
        "..###ooo###cccc....p....",
        "........................",
        "........................"
      ],
      "palettes": [ "construction_palette" ],
      "terrain": {
        ".": [ [ "t_region_groundcover_urban", 7 ], [ "t_region_soil", 10 ] ],
        "A": "t_region_soil",
        "C": "t_region_soil",
        "p": [ "t_pit_shallow", [ "t_region_soil", 3 ] ],
        "w": "t_wall_half",
        "{": "t_region_groundcover_urban",
        "6": "t_linoleum_white",
        "~": "t_linoleum_white",
        "t": "t_linoleum_white",
        "s": "t_linoleum_white",
        "`": "t_thconc_floor"
      },
      "furniture": {
        "A": "f_mailbox",
        "{": "f_dumpster",
        "C": [
          [ "f_null", 20 ],
          [ "f_crate_c", 3 ],
          [ "f_pallet_brick", 2 ],
          [ "f_pallet_brick_adobe", 2 ],
          [ "f_pallet_cement", 2 ],
          [ "f_stack_plank", 3 ]
        ],
        "6": "f_counter",
        "s": "f_sink"
      },
      "item": { "W": { "item": "glass_sheet", "chance": 40 } },
      "items": {
        "W": [
          { "item": "floor_trash", "chance": 30 },
          { "item": "hardware_trash", "chance": 30 },
          { "item": "tools_construction", "chance": 5 },
          { "item": "tools_carpentry", "chance": 5 },
          { "item": "power_tools", "chance": 5 },
          { "item": "tools_home", "chance": 10 },
          { "item": "construction_worker", "chance": 10 }
        ],
        "~": [
          { "item": "floor_trash", "chance": 10 },
          { "item": "hardware_trash", "chance": 10 },
          { "item": "tools_plumbing", "chance": 5 },
          { "item": "supplies_plumbing", "chance": 5 }
        ]
      }
    }
  },
  {
    "method": "json",
    "om_terrain": "house_02",
    "//": "Abandoned variant",
    "type": "mapgen",
    "weight": 40,
    "object": {
      "fill_ter": "t_floor",
      "rows": [
        ".............-..........",
        "...........p.-..........",
        "..ŦŦŦŦŦŦŦŦŦŦ.-.ŦŦŦŦŦŦŦ..",
        ".............-..........",
        ".............-..........",
        "............---.........",
        "..##oo##oo##o*o##ooo##..",
        "..#2JJFO5C4|   |     #^.",
        "..#1      4|   |     o..",
        "..#3      2|   |     o..",
        "..#|+||||+||   +     #..",
        "..#            ||||||#..",
        "..o            +     #..",
        "..o       ||||||     o..",
        "..o       +~~~~|     o..",
        "..#       |~=8t|     #..",
        "..#||   ||#######ooo##..",
        "..#       #````.........",
        "..o       *````.........",
        "..o       #````.........",
        ".^#       #````.........",
        "..###ooo###````.........",
        "........................",
        "........................"
      ],
      "palettes": [ "standard_domestic_abandoned_palette" ],
      "terrain": {
        "8": "t_linoleum_white",
        "=": "t_linoleum_white",
        "~": "t_linoleum_white",
        "t": "t_linoleum_white",
        "`": "t_thconc_floor"
      },
      "furniture": { "=": "f_sink" }
    }
  },
  {
    "type": "mapgen",
    "method": "json",
    "om_terrain": "house_02_roof",
    "object": {
      "fill_ter": "t_shingle_flat_roof",
      "rows": [
        "                        ",
        "                        ",
        "                        ",
        "                        ",
        "                        ",
        "                        ",
        "  --------------------  ",
        "  -..................5  ",
        "  -..................-  ",
        "  -..................-  ",
        "  -....=......N......-  ",
        "  -..................-  ",
        "  -..................-  ",
        "  -..................-  ",
        "  -..................-  ",
        "  -..................-  ",
        "  -.....&.....--------  ",
        "  -...........-         ",
        "  -...........-         ",
        "  -...........-         ",
        "  5...........-         ",
        "  -------------         ",
        "                        ",
        "                        "
      ],
      "palettes": [ "roof_palette" ],
      "terrain": { ".": "t_shingle_flat_roof" }
    }
  }
]
