[
  {
    "type": "mapgen",
    "method": "json",
    "om_terrain": [ "house_rv" ],
    "weight": 300,
    "object": {
      "fill_ter": "t_floor",
      "rows": [
        ".%~~~~~~~~p.%%%..---....",
        ".%~~~~~~~~.####oo#*####.",
        ".%~~~~~~~~.#RRR  L   E#.",
        ".%~~~~~~~~.#         s#.",
        ".%~~~~~~~~.# ll      E#.",
        ".%~~~~~~~~.#HHHH     T#.",
        ".%~~~~~~~~.#          #.",
        ".%~~~~~~~~.#L    hhh  o.",
        "..~~~~~~~~~*     fff  o.",
        "..~~~~~~~~.#     hhh  o.",
        "..~~~~~~~~.#          o.",
        "..~~~~~~~~^#     AAA y#.",
        ".########### ||| JJJ||#.",
        ".#BBy      + |66    7Fo.",
        ".o     || || |Y      5o.",
        ".#S88Yt|Q U|     43O21o.",
        ".#|||||||||| ||+||||||#.",
        ".#d   b  +D| |zz666666#.",
        ".#@@    y||| |z      z#.",
        ".#@@       + +  UUUUUU#.",
        ".#s       h|+|      A #.",
        ".#  TEy  II|>|gzqqqNNN#.",
        ".####oo#####o##########.",
        ".....................^.."
      ],
      "palettes": [ "standard_domestic_palette" ],
      "terrain": {
        "%": [ "t_region_shrub", "t_region_shrub_fruit", "t_region_shrub_decorative" ],
        "G": "t_concrete",
        "K": "t_concrete",
        "~": "t_concrete",
        "j": "t_concrete"
      },
      "place_loot": [
        { "group": "guns_pistol_common", "x": 2, "y": 17, "chance": 5, "ammo": 90, "magazine": 100 },
        { "group": "camping", "x": [ 16, 19 ], "y": 19, "chance": 70, "repeat": [ 1, 4 ] }
      ],
      "place_monsters": [ { "monster": "GROUP_ZOMBIE", "x": [ 2, 21 ], "y": [ 2, 21 ], "chance": 2 } ],
      "place_vehicles": [ { "vehicle": "rv", "x": 5, "y": 4, "chance": 5, "rotation": 270 } ]
    }
  },
  {
    "type": "mapgen",
    "method": "json",
    "om_terrain": "house_rv_roof",
    "object": {
      "fill_ter": "t_shingle_flat_roof",
      "rows": [
        "                        ",
        "           |22222222223 ",
        "           |..........3 ",
        "           |..........3 ",
        "           |..........3 ",
        "           |..........3 ",
        "           |....&.....3 ",
        "           |..........3 ",
        "           |..........3 ",
        "           |..........3 ",
        "           |..........3 ",
        "           |..........3 ",
        " |2222222225..........3 ",
        " |....................3 ",
        " |....................3 ",
        " |...:................3 ",
        " |....................3 ",
        " |....................3 ",
        " |....................3 ",
        " |..............=.....3 ",
        " |....................3 ",
        " |....................3 ",
        " |------------------5-3 ",
        "                        "
      ],
      "palettes": [ "roof_palette" ],
      "terrain": { ".": "t_shingle_flat_roof" }
    }
  },
  {
    "type": "mapgen",
    "method": "json",
    "om_terrain": "house_rv_basement",
    "object": {
      "fill_ter": "t_thconc_floor",
      "rows": [
        "                        ",
        "           |||||||||||| ",
        "           |1.........| ",
        "           |..........| ",
        "           |..........| ",
        "           |..........| ",
        "           |..........| ",
        "           |..........| ",
        "           |..........| ",
        "           |..........| ",
        "           |..........| ",
        "           |..........| ",
        " |||||||||||..........| ",
        " |2...................| ",
        " |....................| ",
        " |...................F| ",
        " |....................| ",
        " |...................g| ",
        " |....................| ",
        " |................A...| ",
        " |...................U| ",
        " |..........<...WJJZ.U| ",
        " |||||||||||||||||||||| ",
        "                        "
      ],
      "palettes": [ "basement_empty" ],
      "nested": {
        "1": {
          "chunks": [
            [ "null", 70 ],
            [ "room_10x10_pool_S", 10 ],
            [ "room_10x10_recording_studio_S", 30 ],
            [ "room_10x10_woodworker_S", 30 ]
          ]
        },
        "2": { "chunks": [ [ "null", 75 ], [ "room_9x9_cellar_E", 20 ], [ "room_9x9_weed_E", 5 ], [ "room_9x9_recroom_E", 30 ] ] }
      }
    }
  }
]
