[
  {
    "type": "mapgen",
    "method": "json",
    "om_terrain": [ "multi_unit_first_floor" ],
    "object": {
      "fill_ter": "t_floor",
      "rows": [
        "....``..................",
        "....``p.................",
        "...````.................",
        "..##*o#######o########..",
        "..#  |s         x   H#..",
        "..o  *              Ho..",
        "..o  ||||||||   +----#..",
        "..#  |F457O2|   |8S8b#..",
        "..#<>|3     |   |||||#..",
        "..#|||n    y|        #..",
        "..#66|1        hfh  y#..",
        "..o  +         hfh  ro..",
        "..#UU|Y     |  hfh  ro..",
        "..#|||||JJJJ|  hfh  y#..",
        "..#vRRP|AA A         #..",
        ".^#   P|         ee  #..",
        "..#r   |  HHHHs  ee  #..",
        "..orh  +  Hl     ee  o..",
        "..#r   |R H         y#..",
        "..#T yE|R  EsE      R#..",
        "..##oo######oo###*####..",
        "..=000000000000000000=..",
        "..=========..=========..",
        "........................"
      ],
      "palettes": [ "standard_domestic_palette" ],
      "terrain": {
        "%": [ "t_region_shrub", "t_region_shrub_fruit", "t_region_shrub_decorative" ],
        "[": [ [ "t_region_tree_fruit", 2 ], [ "t_region_tree_nut", 2 ], "t_region_tree_shade" ],
        "!": "t_region_groundcover_urban",
        "`": "t_concrete",
        "#": "t_adobe_brick_wall",
        "t": "t_linoleum_gray",
        "S": "t_linoleum_gray",
        "b": "t_linoleum_gray",
        "Q": "t_linoleum_gray",
        "8": "t_linoleum_gray",
        "9": "t_linoleum_gray",
        "-": "t_linoleum_gray",
        "]": "t_wall_glass",
        ")": "t_door_glass_c",
        "0": "t_floor_noroof",
        "=": "t_railing"
      },
      "furniture": { "!": "f_region_flower" }
    }
  },
  {
    "type": "mapgen",
    "method": "json",
    "om_terrain": [ "multi_unit_second_floor_of_three" ],
    "object": {
      "fill_ter": "t_floor",
      "rows": [
        "________________________",
        "________________________",
        "________________________",
        "__###o#######o########__",
        "__#  |s         x   H#__",
        "__o  *              Ho__",
        "__o  ||||||||   +----#__",
        "__#  |F457O2|   |8S8b#__",
        "__#><|3     |   |||||#__",
        "__#|||n    y|        #__",
        "__#66|1        hfh  y#__",
        "__o  +         hfh  ro__",
        "__#UU|Y     |  hfh  ro__",
        "__#|||||JJJJ|  hfh  y#__",
        "__#vRRP|AA A         #__",
        "__#   P|         ee  #__",
        "__#r   |  HHHHs  ee  #__",
        "__orh  +  Hl     ee  o__",
        "__#r   |R H         y#__",
        "__#T yE|R  EsE      R#__",
        "__##oo######oo###*####__",
        "__=000000000000000000=__",
        "__====================__",
        "________________________"
      ],
      "palettes": [ "standard_domestic_palette" ],
      "terrain": {
        "_": "t_open_air",
        "#": "t_adobe_brick_wall",
        "t": "t_linoleum_gray",
        "S": "t_linoleum_gray",
        "Q": "t_linoleum_gray",
        "8": "t_linoleum_gray",
        "B": "t_linoleum_gray",
        "9": "t_linoleum_gray",
        "-": "t_linoleum_gray",
        "0": "t_floor_noroof",
        "=": "t_railing"
      },
      "place_loot": [ { "item": "stereo", "x": 12, "y": 19 } ]
    }
  },
  {
    "type": "mapgen",
    "method": "json",
    "om_terrain": [ "multi_unit_top_floor" ],
    "object": {
      "fill_ter": "t_floor",
      "rows": [
        "________________________",
        "________________________",
        "________________________",
        "__###o#######o########__",
        "__#  |s         x   H#__",
        "__o  *              Ho__",
        "__o  ||||||||   +----#__",
        "__#  |F457O2|   |8S8b#__",
        "__# >|3     |   |||||#__",
        "__#|||n    y|        #__",
        "__#66|1        hfh  y#__",
        "__o  +         hfh  ro__",
        "__#UU|Y     |  hfh  ro__",
        "__#|||||JJJJ|  hfh  y#__",
        "__#vRRP|AA A         #__",
        "__#   P|         ee  #__",
        "__#r   |  HHHHs  ee  #__",
        "__orh  +  Hl     ee  o__",
        "__#r   |R H         y#__",
        "__#T yE|R  EsE      R#__",
        "__##oo######oo###*####__",
        "__=000000000000000000=__",
        "__====================__",
        "________________________"
      ],
      "palettes": [ "standard_domestic_palette" ],
      "terrain": {
        "_": "t_open_air",
        "#": "t_adobe_brick_wall",
        "t": "t_linoleum_gray",
        "S": "t_linoleum_gray",
        "Q": "t_linoleum_gray",
        "8": "t_linoleum_gray",
        "B": "t_linoleum_gray",
        "9": "t_linoleum_gray",
        "-": "t_linoleum_gray",
        "0": "t_floor_noroof",
        "=": "t_railing"
      },
      "place_loot": [ { "item": "stereo", "x": 12, "y": 19 } ]
    }
  },
  {
    "type": "mapgen",
    "method": "json",
    "om_terrain": "multi_unit_roof",
    "object": {
      "fill_ter": "t_shingle_flat_roof",
      "rows": [
        "                        ",
        "                        ",
        "                        ",
        "  |2222222222222222223  ",
        "  |..................3  ",
        "  |..................3  ",
        "  |..................3  ",
        "  |..................3  ",
        "  |..................3  ",
        "  |......:...........3  ",
        "  |..................3  ",
        "  |..................3  ",
        "  |.......=..........3  ",
        "  |..................3  ",
        "  |..................3  ",
        "  |..................3  ",
        "  5...............&..3  ",
        "  |......N...........3  ",
        "  |..................3  ",
        "  |..................3  ",
        "  |------------------3  ",
        "                        ",
        "                        ",
        "                        "
      ],
      "palettes": [ "roof_palette" ],
      "terrain": { ".": "t_shingle_flat_roof" }
    }
  },
  {
    "type": "mapgen",
    "method": "json",
    "om_terrain": "multi_unit_basement",
    "object": {
      "fill_ter": "t_thconc_floor",
      "rows": [
        "                        ",
        "                        ",
        "                        ",
        "  ||||||||||||||||||||  ",
        "  |U..F.g...WJZ......|  ",
        "  |...........J......|  ",
        "  |...........J.z.z.z|  ",
        "  |.......z..z..z..zz|  ",
        "  |.<....1...........|  ",
        "  |2.................|  ",
        "  |..................|  ",
        "  |..................|  ",
        "  |..................|  ",
        "  |..................|  ",
        "  |..................|  ",
        "  |..................|  ",
        "  |..................|  ",
        "  |..................|  ",
        "  |..................|  ",
        "  |..................|  ",
        "  ||||||||||||||||||||  ",
        "                        ",
        "                        ",
        "                        "
      ],
      "palettes": [ "basement_empty" ],
      "nested": {
        "1": { "chunks": [ [ "null", 25 ], [ "recroom_12x12", 25 ], [ "tvroom_12x12", 25 ], [ "workoutroom_12x12", 25 ] ] },
        "2": { "chunks": [ [ "null", 25 ], [ "room_6x6_woodworker", 25 ], [ "room_6x6_junk", 25 ], [ "room_6x6_bike", 25 ] ] }
      }
    }
  }
]
