[
  {
    "method": "json",
    "om_terrain": [ [ "urban_4_1", "urban_4_2" ] ],
    "type": "mapgen",
    "weight": 250,
    "object": {
      "fill_ter": "t_thconc_floor",
      "rows": [
        "                                                ",
        "                                                ",
        "                                                ",
        "                  ||||||                        ",
        "   ||||||||||||||||....|||||||||||||||||||      ",
        "   |2...........................WJJJZ..Fg|      ",
        "   |...................................zz|      ",
        "   |...............................A....z|      ",
        "   |..........%%%.............||||||||||||      ",
        "   |..........%.+.............|                 ",
        "   |..........+<%.......1.....|                 ",
        "   |..........%%%.............|                 ",
        "   |..........................|                 ",
        "   |..........................|                 ",
        "   |..........................|                 ",
        "   |..........................|                 ",
        "   ||||||...||||||||||...||||||                 ",
        "        |||||        |||||                      ",
        "                                                ",
        "                                                ",
        "                                                ",
        "                                                ",
        "                                                ",
        "                                                "
      ],
      "palettes": [ "basement_empty" ],
      "nested": {
        "2": {
          "chunks": [ [ "null", 50 ], [ "11x11_gym_open", 10 ], [ "11x11_recroom_open", 30 ], [ "room_11x11_apartment_E", 10 ] ]
        },
        "1": {
          "chunks": [
            [ "null", 70 ],
            [ "room_6x6_brewer_W", 5 ],
            [ "room_6x6_guns_W", 5 ],
            [ "room_6x6_junk_W", 30 ],
            [ "room_6x6_office_W", 30 ]
          ]
        }
      }
    }
  },
  {
    "method": "json",
    "om_terrain": [ [ "urban_4_3", "urban_4_4" ] ],
    "type": "mapgen",
    "weight": 250,
    "object": {
      "fill_ter": "t_floor",
      "rows": [
        "................................................",
        "................................................",
        "............[...........```.....................",
        "..................#oooo#```.....................",
        "...################]]]]##*##oo#########o##......",
        "...#R  xxxx   |6|,,]}}],,,F1552O3|,t|QNN'#^.....",
        "...#R         |,+,,,,,,,,,,,,,,,,+,,|Q''U#......",
        "...#          |6|,,,,00,,,,,,,47,|,S|U''U#......",
        "...#    ll   E|||  ||JJJ| |JJ|##*######*##......",
        "...#  H       | +  |      AA y#'''''''''''......",
        "...#  HHHHH   |>|  |   h      #'''''''''''......",
        "...#         R|||  |  hffh   r#'''''''''''......",
        "...#R        R|<|  |  hffh   r#'''''''''''......",
        "...#R         |    |  hffh   r#'''''''''''......",
        "...#R                   h     #'''''''''''......",
        "...#R ET  h Ty|L  y|         y#'''''''''''......",
        "...######rrr###o**o###ycy######''''''''''#......",
        "........#ooo#````````#ooo#......________........",
        ".............````````...........________........",
        ".......[........``..............________........",
        "................``..............________........",
        "................``...[..........________........",
        "................``..............________........",
        "................``..............________.p......"
      ],
      "palettes": [ "standard_domestic_palette" ],
      "terrain": {
        "%": [ "t_region_shrub", "t_region_shrub_fruit", "t_region_shrub_decorative" ],
        "[": [ [ "t_region_tree_fruit", 2 ], [ "t_region_tree_nut", 2 ], "t_region_tree_shade" ],
        "!": "t_region_groundcover_urban",
        "#": "t_adobe_brick_wall",
        "=": "t_door_metal_locked",
        "_": "t_pavement",
        "&": "t_gates_control_brick",
        "'": "t_thconc_floor",
        "q": "t_thconc_floor",
        "Q": "t_thconc_floor",
        "N": "t_thconc_floor",
        "U": "t_thconc_floor",
        "`": "t_concrete",
        "}": "t_linoleum_white",
        ",": "t_linoleum_white",
        "O": "t_linoleum_white",
        "F": "t_linoleum_white",
        "1": "t_linoleum_white",
        "2": "t_linoleum_white",
        "3": "t_linoleum_white",
        "4": "t_linoleum_white",
        "5": "t_linoleum_white",
        "6": "t_linoleum_white",
        "7": "t_linoleum_white",
        "8": "t_linoleum_white",
        "n": "t_linoleum_white",
        "J": "t_linoleum_white",
        "Y": "t_linoleum_white",
        "S": "t_linoleum_white",
        "t": "t_linoleum_white",
        "f": "t_linoleum_white",
        "0": "t_linoleum_white",
        "]": "t_linoleum_white"
      },
      "furniture": { "!": "f_region_flower", "0": "f_stool", "]": "f_sofa", "}": "f_table" },
      "place_loot": [ { "item": "television", "x": 8, "y": 5, "chance": 100 }, { "item": "stereo", "x": 9, "y": 5, "chance": 100 } ],
      "place_vehicles": [ { "vehicle": "suburban_home", "x": 36, "y": 12, "chance": 30, "rotation": 270 } ]
    }
  },
  {
    "method": "json",
    "om_terrain": [ [ "urban_4_5", "urban_4_6" ] ],
    "type": "mapgen",
    "weight": 250,
    "object": {
      "fill_ter": "t_floor",
      "rows": [
        "~~~~~~~~~~~~~~~~~~~~~~~~~~~~~~~~~~~~~~~~~~~~~~~~",
        "~~~~~~~~~~~~~~~~~~~~~~~~~~~~~~~~~~~~~~~~~~~~~~~~",
        "~~~~~~~~~~~~~~~~~~~~~~~~~~~~~~~~~~~~~~~~~~~~~~~~",
        "~~~~~~~~~~~~~~~~~~======~~~~~~~~~~~~~~~~~~~~~~~~",
        "~~~###o#####o##################)))))))))))~~~~~~",
        "~~~#    b  III|Q |@   III    @#==========%~~~~~~",
        "~~~#s       hI|Q |@    h     @#^=========0~~~~~~",
        "~~~#@@@      I||+|d          D#==========0~~~~~~",
        "~~~#@@@      T|  |D   byR    d#==========0~~~~~~",
        "~~~#@@@       +  |||+|||||+|||#==========0~~~~~~",
        "~~~#s        d|       +U|zD|Dv#==========0~~~~~~",
        "~~~o         d| ||+||+||||||+|#==========0~~~~~~",
        "~~~#  R       |>|t,8|   III   #==========0~~~~~~",
        "~~~#||||+||||+||||,S|    h    o==========0~~~~~~",
        "~~~#B,,,,,,,|  D|B,S|R        o==========0~~~~~~",
        "~~~#B,8SSC8t|EsQ|B,8|R ET   @@#==========0~~~~~~",
        "~~~####oo################oo####__________0~~~~~~",
        "~~~~~~~~=====~~~~~~~~=====~~~~~~~~~~~~~~~~~~~~~~",
        "~~~~~~~~~~~~~~~~~~~~~~~~~~~~~~~~~~~~~~~~~~~~~~~~",
        "~~~~~~~~~~~~~~~~~~~~~~~~~~~~~~~~~~~~~~~~~~~~~~~~",
        "~~~~~~~~~~~~~~~~~~~~~~~~~~~~~~~~~~~~~~~~~~~~~~~~",
        "~~~~~~~~~~~~~~~~~~~~~~~~~~~~~~~~~~~~~~~~~~~~~~~~",
        "~~~~~~~~~~~~~~~~~~~~~~~~~~~~~~~~~~~~~~~~~~~~~~~~",
        "~~~~~~~~~~~~~~~~~~~~~~~~~~~~~~~~~~~~~~~~~~~~~~~~"
      ],
      "palettes": [ "standard_domestic_palette" ],
      "terrain": {
        "~": "t_open_air",
        "#": "t_adobe_brick_wall",
        "=": "t_shingle_flat_roof",
        "&": "t_shingle_flat_roof",
        "%": "t_gutter_drop",
        "0": "t_gutter_east",
        "_": "t_gutter_south",
        ")": "t_gutter_north",
        "B": "t_linoleum_white",
        "S": "t_linoleum_white",
        "t": "t_linoleum_white",
        "8": "t_linoleum_white",
        ",": "t_linoleum_white"
      }
    }
  },
  {
    "method": "json",
    "om_terrain": [ [ "urban_4_7", "urban_4_8" ] ],
    "type": "mapgen",
    "weight": 250,
    "object": {
      "fill_ter": "t_shingle_flat_roof",
      "rows": [
        "                                                ",
        "                                                ",
        "                                                ",
        "                                                ",
        "   |222222222222222222222222223                 ",
        "   |..........................3                 ",
        "   |..........................5                 ",
        "   |..........................3                 ",
        "   |..........................3                 ",
        "   |................=.&.......3                 ",
        "   |..........................3                 ",
        "   |..........................3                 ",
        "   |.....................N....3                 ",
        "   |..........................3                 ",
        "   |..........................3                 ",
        "   |..........................3                 ",
        "   |--------------------------3                 ",
        "                                                ",
        "                                                ",
        "                                                ",
        "                                                ",
        "                                                ",
        "                                                ",
        "                                                "
      ],
      "palettes": [ "roof_palette" ],
      "terrain": { ".": "t_shingle_flat_roof" }
    }
  }
]
