[
  {
    "method": "json",
    "om_terrain": [ [ "urban_2_1", "urban_2_2" ] ],
    "type": "mapgen",
    "weight": 250,
    "object": {
      "fill_ter": "t_floor_roofed",
      "rows": [
        "................................................",
        "........```````````````.........................",
        "..u...`````#########o#*####ooo####o####.........",
        "......`````o Txxxx     L|234S7O1FJJJ|6#....[....",
        "......`````*       E    |n,,,,,,,,,,+6#.........",
        "........```o   ll  s    ,,,,,,,00J||||#.........",
        ".......##+##E      E   y|0,,,YJJJJ|q'q#^........",
        ".......#'''|  HHHH   |+||||,,#######+####oo###..",
        "....[..#UUU|        ||,t|>+  #A'''''''''''''q#..",
        ".......#||||        |,,,|D+  #''''''''''''''q#..",
        ".......#6,6|      RR|8S8|||  #'''''''''''''''o..",
        ".......#|+||||  |||||||||<|  #'''''''''''''''#..",
        ".......#R              y|    +''''''''''''''N#..",
        ".......#R     hhhh           #''''''''''''''N#..",
        ".......#a    ffffff     |y  L#'''''''''''''''o..",
        ".......#R     hhhh     E#o**o#'''''''''''''''#..",
        "......^#R             ET#````#&'''''''''''''&#..",
        ".......####oo######oo####````##======#======##..",
        "..........%%%%....%%%%....``...______.______....",
        "..........................`````______!______....",
        "..........................`````______!______....",
        "..................[............______.______....",
        "...[...........................______!______....",
        "...............................______!______p..."
      ],
      "palettes": [ "standard_domestic_palette" ],
      "terrain": {
        "%": [ "t_region_shrub", "t_region_shrub_fruit", "t_region_shrub_decorative" ],
        "[": [ [ "t_region_tree_fruit", 2 ], [ "t_region_tree_nut", 2 ], "t_region_tree_shade" ],
        "!": "t_region_groundcover_urban",
        "=": "t_door_metal_locked",
        "_": "t_pavement",
        "&": "t_gates_control_brick",
        "'": "t_thconc_floor_roofed",
        "q": "t_thconc_floor_roofed",
        "A": "t_thconc_floor_roofed",
        "N": "t_thconc_floor_roofed",
        "U": "t_thconc_floor_roofed",
        "`": "t_concrete",
        ",": "t_linoleum_white_roofed",
        "O": "t_linoleum_white_roofed",
        "F": "t_linoleum_white_roofed",
        "1": "t_linoleum_white_roofed",
        "2": "t_linoleum_white_roofed",
        "3": "t_linoleum_white_roofed",
        "4": "t_linoleum_white_roofed",
        "5": "t_linoleum_white_roofed",
        "6": "t_linoleum_white_roofed",
        "7": "t_linoleum_white_roofed",
        "8": "t_linoleum_white_roofed",
        "n": "t_linoleum_white_roofed",
        "J": "t_linoleum_white_roofed",
        "Y": "t_linoleum_white_roofed",
        "S": "t_linoleum_white_roofed",
        "t": "t_linoleum_white_roofed",
        "0": "t_linoleum_white_roofed"
      },
      "furniture": { "!": "f_region_flower", "0": "f_stool" },
      "place_loot": [
        { "item": "television", "x": 15, "y": 3, "chance": 100 },
        { "item": "stereo", "x": 16, "y": 3, "chance": 100 },
        { "item": "lawnmower", "x": 8, "y": 7, "chance": 100 },
        { "item": "stepladder", "x": 10, "y": 7, "chance": 100 }
      ],
      "place_vehicles": [
        { "vehicle": "suburban_home", "x": 33, "y": 11, "chance": 30, "rotation": 270 },
        { "vehicle": "suburban_home", "x": 40, "y": 11, "chance": 30, "rotation": 270 }
      ]
    }
  },
  {
    "method": "json",
    "om_terrain": [ [ "urban_2_3", "urban_2_4" ] ],
    "type": "mapgen",
    "weight": 250,
    "object": {
      "fill_ter": "t_floor_roofed",
      "rows": [
        "~~~~~~~~~~~~~~~~~~~~~~~~~~~~~~~~~~~~~~~~~~~~~~~~",
        "~~~~~~~~~~~~~~~~~~~~~~~~~~~~~~~~~~~~~~~~~~~~~~~~",
        "~~~~~~~~~~~##o#####o######oo##)))))))))~~~~~~~~~",
        "~~~~~~~~~~~#  @I @I T|I@T   y#^=======0~~~~~~~~~",
        "~~~~~~~~~~~o  @  @   | @   hIo========0~~~~~~~~~",
        "~~~~~~~~~~~#         |      I#========0~~~~~~~~~",
        "~~~~~~~====#E       I|ydbD  Y#========0~~~~~~~~~",
        "~~~~~~~====ol      hI||||||+|#========%)))))))~~",
        "~~~~~~~====#E       I|t8S8|  #===============0~~",
        "~~~~~~~#####         |,,,,+ yo===============0~~",
        "~~~~~~~#v|D+  dbdT  y|BB||| yo===============0~~",
        "~~~~~~~#+||||||||||+|||||>| yo===============0~~",
        "~~~~~~~#         +           #===============0~~",
        "~~~~~~~#R  E   @@||||||||+|||#===============0~~",
        "~~~~~~~#a  l   @@|D|v|RE    I#===============0~~",
        "~~~~~~^#R  E  h  + | +     hIo===============0~~",
        "~~~~~~~#T    II d|D|Q|R  TIII#===============0~~",
        "~~~~~~~##o#####o########ooo###_______________0~~",
        "~~~~~~~~~~~~~~~~~~~~~~~~~~~~~~~~~~~~~~~~~~~~~~~~",
        "~~~~~~~~~~~~~~~~~~~~~~~~~~~~~~~~~~~~~~~~~~~~~~~~",
        "~~~~~~~~~~~~~~~~~~~~~~~~~~~~~~~~~~~~~~~~~~~~~~~~",
        "~~~~~~~~~~~~~~~~~~~~~~~~~~~~~~~~~~~~~~~~~~~~~~~~",
        "~~~~~~~~~~~~~~~~~~~~~~~~~~~~~~~~~~~~~~~~~~~~~~~~",
        "~~~~~~~~~~~~~~~~~~~~~~~~~~~~~~~~~~~~~~~~~~~~~~~~"
      ],
      "palettes": [ "standard_domestic_palette" ],
      "terrain": {
        "~": "t_open_air",
        "=": "t_shingle_flat_roof",
        "&": "t_shingle_flat_roof",
        "%": "t_gutter_drop",
        "0": "t_gutter_east",
        "_": "t_gutter_south",
        ")": "t_gutter_north",
        "B": "t_linoleum_white_roofed",
        "S": "t_linoleum_white_roofed",
        "t": "t_linoleum_white_roofed",
        "8": "t_linoleum_white_roofed",
        ",": "t_linoleum_white_roofed"
      },
      "furniture": { "&": "f_chimney" }
    }
  },
  {
    "method": "json",
    "om_terrain": [ [ "urban_2_5", "urban_2_6" ] ],
    "type": "mapgen",
    "weight": 250,
    "object": {
      "fill_ter": "t_shingle_flat_roof",
      "rows": [
        "                                                ",
        "                                                ",
        "           |222222222222222223                  ",
        "           |.................5                  ",
        "           |.................3                  ",
        "           |.................3                  ",
        "           |....&............3                  ",
        "           |.................3                  ",
        "           |.........N.......3                  ",
        "       |222|.................3                  ",
        "       |.....................3                  ",
        "       |.....................3                  ",
        "       |.....................3                  ",
        "       |.....................3                  ",
        "       |~..........X.........3                  ",
        "       5.....................3                  ",
        "       |.....................3                  ",
        "       |---------------------3                  ",
        "                                                ",
        "                                                ",
        "                                                ",
        "                                                ",
        "                                                ",
        "                                                "
      ],
      "palettes": [ "roof_palette" ],
      "terrain": { ".": "t_shingle_flat_roof" }
    }
  },
  {
    "method": "json",
    "om_terrain": [ [ "urban_2_1_basement", "urban_2_2_basement" ] ],
    "type": "mapgen",
    "object": {
      "fill_ter": "t_thconc_floor_roofed",
      "rows": [
        "                                                ",
        "                                                ",
        "           ||||||||||||||||||||||||||||         ",
        "           |..........................|         ",
        "           |..........................|         ",
        "           |..........................|         ",
        "       |||||..........................|         ",
        "       |1..............W|||U..........||||||||  ",
        "       |...............J|<|U........2........|  ",
        "       |...............Z|+|..................|  ",
        "       |.........................z.z.........|  ",
        "       |........................z............|  ",
        "       |.....................................|  ",
        "       |.....................................|  ",
        "       |............zz...F.g.................|  ",
        "       |................||||||...............|  ",
        "       |................|    |...............|  ",
        "       ||||||||||||||||||    |||||||||||||||||  ",
        "                                                ",
        "                                                ",
        "                                                ",
        "                                                ",
        "                                                ",
        "                                                "
      ],
      "palettes": [ "basement_empty" ],
      "nested": {
        "2": { "chunks": [ [ "null", 80 ], [ "room_9x9_cellar_W", 20 ], [ "room_9x9_weed_W", 5 ], [ "room_9x9_recroom_W", 20 ] ] },
        "1": {
          "chunks": [
            [ "null", 70 ],
            [ "room_10x10_woodworker_E", 20 ],
            [ "room_10x10_guns_E", 7 ],
            [ "room_10x10_junk_E", 30 ],
            [ "room_10x10_recording_studio_E", 20 ]
          ]
        }
      }
    }
  }
]
