[
  {
    "method": "json",
    "om_terrain": [ [ "urban_11_1", "urban_11_2" ] ],
    "type": "mapgen",
    "object": {
      "fill_ter": "t_floor",
      "rows": [
        "...............................p________........",
        "..............[...............%.________.%......",
        "................................________........",
        "..............................%.________.%......",
        ".......[........................________........",
        "....................[...........________.%...[..",
        ".........................```````________........",
        ".........................```````________.%......",
        "..........%%..%..%..%..%.```...&________........",
        "..........%#####o#######o#*#####========##......",
        "...........#yTE  HH   L    + Q|&'''''''''#%.....",
        "...[.......#x   l H        ||||''''''''''o%.....",
        "...........#x   l H        |q'+''''''''''#%.....",
        "...........o   AAA    <| |+||||'''''''''q#......",
        "...........#|||JJJ|  ||| |~~~B|'''''''''q#......",
        "...........#F,,,,,,,,66| |S8tB|'''''''''q#......",
        "..........^#7,,,,,,,,,,,,||||||''''''''''#^.....",
        "...........o5,,,,,hffh,,,+    +''''''''''o......",
        "..........%#12O34,hffh,,Y|  WZ|'NN''''''g#%.....",
        "..........%########oo#####*#o######o######%.....",
        "..........%%%.....%%%%..`````...........%%%.....",
        ".....[..................`````...................",
        ".............................................[..",
        "................................................"
      ],
      "palettes": [
        "parametrized_linoleum_palette",
        "domestic_general_and_variant_palette",
        "standard_domestic_lino_kitchen",
        "standard_domestic_lino_bathroom",
        "standard_domestic_landscaping_palette"
      ],
      "terrain": {
        ",": { "param": "linoleum_color_kitchen", "fallback": "t_linoleum_gray" },
        "h": { "param": "linoleum_color_kitchen", "fallback": "t_linoleum_gray" },
        "f": { "param": "linoleum_color_kitchen", "fallback": "t_linoleum_gray" },
        "'": "t_thconc_floor",
        "Q": "t_floor",
        "g": "t_thconc_floor",
        "=": "t_door_metal_locked",
        "&": "t_gates_control_brick",
        "q": "t_thconc_floor",
        "N": "t_thconc_floor",
        "Y": { "param": "linoleum_color", "fallback": "t_linoleum_gray" }
      },
      "place_loot": [ { "item": "television", "x": 12, "y": 11, "chance": 100 }, { "item": "stereo", "x": 12, "y": 12, "chance": 50 } ],
      "place_vehicles": [ { "vehicle": "suburban_home", "x": 35, "y": 13, "rotation": 270 } ],
      "place_nested": [ { "chunks": [ "rolling_trash_can_1x1" ], "x": 12, "y": 1 } ]
    }
  },
  {
    "method": "json",
    "om_terrain": [ [ "urban_11_3", "urban_11_4" ] ],
    "type": "mapgen",
    "object": {
      "fill_ter": "t_floor",
      "rows": [
        "~~~~~~~~~~~~~~~~~~~~~~~~~~~~~~~~~~~~~~~~~~~~~~~~",
        "~~~~~~~~~~~~~~~~~~~~~~~~~~~~~~~~~~~~~~~~~~~~~~~~",
        "~~~~~~~~~~~~~~~~~~~~~~~~~~~~~~~~~~~~~~~~~~~~~~~~",
        "~~~~~~~~~~~~~~~~~~~~~~~~~~~~~~~~~~~~~~~~~~~~~~~~",
        "~~~~~~~~~~~~~~~~~~~~~~~~~~~~~~~~~~~~~~~~~~~~~~~~",
        "~~~~~~~~~~~~~~~~~~~~~~~~~~~~~~~~~~~~~~~~~~~~~~~~",
        "~~~~~~~~~~~~~~~~~~~~~~~~~~~~~~~~~~~~~~~~~~~~~~~~",
        "~~~~~~~~~~~~~~~~~~~~~~~~~~~~~~~~~~~~~~~~~~~~~~~~",
        "~~~~~~~~~~~~~~~~~~~~~~~~~~~~~~~~~~~~~~~~~~~~~~~~",
        "~~~~~~~~~~~&&&&&&&&&&&&&&&&&&&&&&&&&&&&&&&~~~~~~",
        "~~~~~~~~~~~&&&&#oo#&&&&&#ooo#&&&&&#oo#&&&&~~~~~~",
        "~~~~~~~~~~~#####ii#######iii#######ii#####~~~~~~",
        "~~~~~~~~~~~#Dbdd     +         |rII     s#~~~~~~",
        "~~~~~~~~~~~#         |>||||||| |Ih    @@@#~~~~~~",
        "~~~~~~~~~~~o         |||8S8S8| +      @@@o~~~~~~",
        "~~~~~~~~~~^# @@      + |,,,,,|||D       s#^~~~~~",
        "~~~~~~~~~~~#I@@I    R|D|t,,,,,,+      db #~~~~~~",
        "~~~~~~~~~~~#####HH#######BBB#######HH#####~~~~~~",
        "~~~~~~~~~~~&&&&#oo#&&&&&#ooo#&&&&&#oo#&&&&~~~~~~",
        "~~~~~~~~~~~&&&&&&&&&&&&&&&&&&&&&&&&&&&&&&&~~~~~~",
        "~~~~~~~~~~~~~~~~~~~~~~~~~~~~~~~~~~~~~~~~~~~~~~~~",
        "~~~~~~~~~~~~~~~~~~~~~~~~~~~~~~~~~~~~~~~~~~~~~~~~",
        "~~~~~~~~~~~~~~~~~~~~~~~~~~~~~~~~~~~~~~~~~~~~~~~~",
        "~~~~~~~~~~~~~~~~~~~~~~~~~~~~~~~~~~~~~~~~~~~~~~~~"
      ],
      "palettes": [ "domestic_general_and_variant_palette", "standard_domestic_lino_kitchen", "standard_domestic_lino_bathroom" ],
      "terrain": {
        "~": "t_open_air",
        "&": "t_shingle_flat_roof",
        ",": { "param": "linoleum_color_bathroom", "fallback": "t_linoleum_gray" }
      }
    }
  },
  {
    "method": "json",
    "om_terrain": [ [ "urban_11_5", "urban_11_6" ] ],
    "type": "mapgen",
    "object": {
      "fill_ter": "t_shingle_flat_roof",
      "rows": [
        "                                                ",
        "                                                ",
        "                                                ",
        "                                                ",
        "                                                ",
        "                                                ",
        "                                                ",
        "                                                ",
        "                                                ",
        "                                                ",
        "               ----     -----     ----          ",
        "           -----..-------...-------..-----      ",
        "           -.............................-      ",
        "           -.............................-      ",
        "           -.............................-      ",
        "           -....&....................N...-      ",
        "           5............=................5      ",
        "           -----..-------...-------..-----      ",
        "               ----     -----     ----          ",
        "                                                ",
        "                                                ",
        "                                                ",
        "                                                ",
        "                                                "
      ],
      "palettes": [ "roof_palette" ],
      "terrain": { ".": "t_shingle_flat_roof" }
    }
  }
]
