[
  {
    "method": "json",
    "om_terrain": [ [ "urban_3_1", "urban_3_2" ] ],
    "type": "mapgen",
    "weight": 250,
    "object": {
      "fill_ter": "t_floor",
      "rows": [
        "................................................",
        "................................................",
        "............[...%%%%``%%%........!!!!!..........",
        "...[............%```````###oo#####ooo######.....",
        ".........!!!....%```````#]]]],,,F1253O4|Z)#.....",
        ".........!X!....%```````o]fff,,,,,,,,,,+ )#.....",
        ".........!!!....````````*,,,,,JJJ,n7566|W)#.....",
        ".....[..........````````*  ||||##+#########.....",
        "................%```````o  |S88#'''''''''q#!....",
        "......^!!!......%``###``#  +,,t#''''''''''#!....",
        ".....###o#########o#a#o##  ||||#'''''''''N#!....",
        ".....#  y yHHHH             <|>+'''''''''N#.....",
        ".....#x       H            ||||#'''''''''A#.....",
        ".....#x     l H            |RRR#''''''''''#!....",
        ".....#x     l H    0}          #''''''''''#.....",
        ".....#             0}        h #''''''''''#!....",
        "....^#y   EsET    RR|L    y|rrr#&'''''''''#.....",
        ".....###o#######o#####o**o###o###========##.....",
        "......................````.%%%%%.________.......",
        "......................````..%%%..________.......",
        "...[...................``........________.......",
        "..............[........``````````________.......",
        ".................................________.......",
        ".................................________.p....."
      ],
      "palettes": [ "domestic_general_and_variant_palette" ],
      "terrain": {
        "%": [ "t_region_shrub", "t_region_shrub_fruit", "t_region_shrub_decorative" ],
        "[": [ [ "t_region_tree_fruit", 2 ], [ "t_region_tree_nut", 2 ], "t_region_tree_shade" ],
        "!": "t_region_groundcover_urban",
        "=": "t_door_metal_locked",
        "_": "t_pavement",
        "&": "t_gates_control_brick",
        "#": "t_brick_wall",
        "'": "t_thconc_floor",
        "q": "t_thconc_floor",
        "A": "t_thconc_floor",
        "N": "t_thconc_floor",
        "U": "t_thconc_floor",
        "`": "t_concrete",
        "}": "t_ponywall",
        ",": "t_linoleum_white",
        "O": "t_linoleum_white",
        "F": "t_linoleum_white",
        "1": "t_linoleum_white",
        "2": "t_linoleum_white",
        "3": "t_linoleum_white",
        "4": "t_linoleum_white",
        "5": "t_linoleum_white",
        "6": "t_linoleum_white",
        "7": "t_linoleum_white",
        "8": "t_linoleum_white",
        "n": "t_linoleum_white",
        "J": "t_linoleum_white",
        "Y": "t_linoleum_white",
        "S": "t_linoleum_white",
        "t": "t_linoleum_white",
        "f": "t_linoleum_white",
        "]": "t_linoleum_white"
      },
      "furniture": { "!": "f_region_flower", "0": "f_stool", "]": "f_sofa", ")": "f_counter" },
      "place_loot": [
        { "item": "television", "x": 6, "y": 13, "chance": 100 },
        { "item": "stereo", "x": 6, "y": 14, "chance": 100 },
        { "item": "lawnmower", "x": 41, "y": 14, "chance": 100 },
        { "item": "stepladder", "x": 41, "y": 15, "chance": 100 }
      ],
      "place_vehicles": [
        { "vehicle": "rolling_trash_can", "x": 23, "y": 23, "chance": 80, "status": 0 },
        { "vehicle": "suburban_home", "x": 36, "y": 11, "chance": 30, "rotation": 270 }
      ]
    }
  },
  {
    "method": "json",
    "om_terrain": [ [ "urban_3_3", "urban_3_4" ] ],
    "type": "mapgen",
    "weight": 250,
    "object": {
      "fill_ter": "t_floor",
      "rows": [
        "************************************************",
        "************************************************",
        "************************************************",
        "************************######o#######o####*****",
        "************************#@@    D|d|I   s@@#*****",
        "************************#       + |Ih   @@#*****",
        "************************oI     T|d|I      #*****",
        "************************oIh    I|||       o*****",
        "************************#     hI| +       #*****",
        "*******************###**#@@    D|D|   dbd #*****",
        "*****-!--------#####a####|||||+|||||+|||||#*****",
        "*****-.........#T       + D|>          + Q#*****",
        "*****-.........#s  HHH  |||||+|||||||+||||#*****",
        "*****-.........o@@        by  d|,BB|8,,,BB#*****",
        "*****-.........o@@             +,,t|S,,,,,o*****",
        "*****-.........#s      h      d|,,,|S,,,,,#*****",
        "*****!........^#     TIII     E|8S8|8,,,,t#*****",
        "*****----------##################o#########*****",
        "************************************************",
        "************************************************",
        "************************************************",
        "************************************************",
        "************************************************",
        "************************************************"
      ],
      "palettes": [ "domestic_general_and_variant_palette" ],
      "terrain": {
        "*": "t_open_air",
        ".": "t_shingle_flat_roof",
        "!": "t_gutter_drop",
        "-": "t_gutter",
        "B": "t_linoleum_white",
        "S": "t_linoleum_white",
        "t": "t_linoleum_white",
        "8": "t_linoleum_white",
        ",": "t_linoleum_white"
      }
    }
  },
  {
    "method": "json",
    "om_terrain": [ [ "urban_3_5", "urban_3_6" ] ],
    "type": "mapgen",
    "weight": 250,
    "object": {
      "fill_ter": "t_shingle_flat_roof",
      "rows": [
        "                                                ",
        "                                                ",
        "                                                ",
        "                        -------------------     ",
        "                        -.................-     ",
        "                        -.................-     ",
        "                        -.................-     ",
        "                        -.....=...........-     ",
        "                        -.................-     ",
        "                   ---  -............N....-     ",
        "               -----~----.................-     ",
        "               -..........................-     ",
        "               -..........................-     ",
        "               -..........................-     ",
        "               -......................X...-     ",
        "               -...........:..............-     ",
        "               5..........................-     ",
        "               ----------------------------     ",
        "                                                ",
        "                                                ",
        "                                                ",
        "                                                ",
        "                                                ",
        "                                                "
      ],
      "palettes": [ "roof_palette" ],
      "terrain": { ".": "t_shingle_flat_roof" }
    }
  },
  {
    "method": "json",
    "om_terrain": [ [ "urban_3_1_basement", "urban_3_2_basement" ] ],
    "type": "mapgen",
    "object": {
      "fill_ter": "t_thconc_floor",
      "rows": [
        "                                                ",
        "                                                ",
        "                                                ",
        "                        |||||||||||||||||||     ",
        "                        |J.............z..|     ",
        "                        |J..A.....z......F|     ",
        "                        |J...........z.z..|     ",
        "                        |Z......2.........|     ",
        "                        |W................|     ",
        "                   |||  |g................|     ",
        "     |||||||||||||||a||||.................|     ",
        "     |1.......................<...........|     ",
        "     |............3.......................|     ",
        "     |....................................|     ",
        "     |....................................|     ",
        "     |....................................|     ",
        "     |....................................|     ",
        "     ||||||||||||||||||||||||||||||||||||||     ",
        "                                                ",
        "                                                ",
        "                                                ",
        "                                                ",
        "                                                ",
        "                                                "
      ],
      "palettes": [ "basement_empty" ],
      "nested": {
        "1": {
          "chunks": [
            [ "null", 70 ],
            [ "room_6x6_guns_E", 2 ],
            [ "room_6x6_junk_E", 30 ],
            [ "room_6x6_office_E", 30 ],
            [ "room_6x6_brewer_E", 10 ]
          ]
        },
        "2": {
          "chunks": [
            [ "null", 70 ],
            [ "room_10x10_woodworker_W", 20 ],
            [ "room_10x10_guns_W", 7 ],
            [ "room_10x10_junk_W", 30 ],
            [ "room_10x10_recording_studio_W", 20 ]
          ]
        },
        "3": {
          "chunks": [
            [ "null", 10 ],
            [ "livingroom_5x5_S_1", 30 ],
            [ "livingroom_5x5_N_1", 30 ],
            [ "livingroom_5x5_W_1", 30 ],
            [ "livingroom_5x5_S_2", 30 ],
            [ "livingroom_5x5_E_2", 30 ],
            [ "livingroom_5x5_N_2", 30 ],
            [ "livingroom_5x5_W_2", 30 ],
            [ "home_office_4x4_N", 20 ],
            [ "home_office_4x4_S", 20 ]
          ]
        }
      }
    }
  }
]
