[
  {
    "type": "palette",
    "id": "prefab_home",
    "terrain": {
      " ": "t_floor",
      ".": "t_region_groundcover",
      "_": [ [ "t_region_soil", 2 ], "t_region_groundcover" ],
      "=": [ [ "t_railroad_rubble", 2 ], "t_region_soil" ]
    },
    "nested": {
      "{": { "chunks": [ [ "6x8_concrete", 1 ], [ "null", 7 ] ] },
      "}": {
        "chunks": [
          [ "7x15_mobile_home_0", 1 ],
          [ "7x15_mobile_home_1", 1 ],
          [ "7x15_mobile_home_2", 1 ],
          [ "7x15_mobile_home_3", 1 ],
          [ "7x15_mobile_home_4", 1 ]
        ]
      },
      "[": { "chunks": [ [ "trailer_fence_1", 4 ], [ "trailer_fence_2", 6 ], [ "null", 55 ] ] },
      "]": {
        "chunks": [
          [ "shed_6x6_woodworker", 5 ],
          [ "shed_6x6_junk", 60 ],
          [ "greenhouse_6x6_herbal", 2 ],
          [ "greenhouse_6x6_vegetable", 2 ]
        ]
      }
    }
  },
  {
    "type": "mapgen",
    "method": "json",
    "om_terrain": [ "prefab" ],
    "//": "empty lawn variant",
    "weight": 500,
    "object": {
      "fill_ter": "t_region_groundcover",
      "rows": [
        "[.._=__=_...............",
        "..._=__=_...............",
        "..._=__=_...............",
        "..._=__=_...............",
        "..._=__=_...............",
        "..{_=__}_....       ....",
        "..._=__=_....       ....",
        "..._=__=_....       ....",
        "..._=__=_....       ....",
        "..._=__=_....       ....",
        "..._=__=_....       ....",
        "..._=__=_....       ....",
        "...______....       ....",
        ".............       ....",
        ".............       ....",
        ".............       ....",
        ".............       ....",
        ".............       ....",
        ".............       ....",
        "........................",
        "........................",
        "........................",
        "........................",
        "........................"
      ],
      "palettes": [ "standard_domestic_palette", "prefab_home" ],
      "place_vehicles": [ { "vehicle": "parking_garage", "x": 6, "y": [ 5, 9 ], "chance": 20, "rotation": 90 } ],
      "place_nested": [ { "chunks": [ [ "1x1_clothesdryer", 3 ], [ "null", 5 ] ], "x": [ 2, 11 ], "y": [ 14, 21 ] } ],
      "place_monster": [ { "group": "GROUP_HOUSE", "x": [ 2, 21 ], "y": [ 2, 21 ], "repeat": 2 } ]
    }
  },
  {
    "type": "mapgen",
    "method": "json",
    "om_terrain": [ "prefab" ],
    "//": "shed/greenhouse variant",
    "weight": 100,
    "object": {
      "fill_ter": "t_region_groundcover",
      "rows": [
        "[.._=__=_...............",
        "..._=__=_...............",
        "..._=__=_...............",
        "..._=__=_...............",
        "..._=__=_...............",
        "..{_=__}_....       ....",
        "..._=__=_....       ....",
        "..._=__=_....       ....",
        "..._=__=_....       ....",
        "..._=__=_....       ....",
        "..._=__=_....       ....",
        "..._=__=_....       ....",
        "...______....       ....",
        ".....__......       ....",
        ".....__......       ....",
        "...].........       ....",
        ".............       ....",
        ".............       ....",
        ".............       ....",
        "........................",
        "........................",
        "........................",
        "........................",
        "........................"
      ],
      "palettes": [ "standard_domestic_palette", "prefab_home" ],
      "place_vehicles": [ { "vehicle": "parking_garage", "x": 6, "y": [ 5, 9 ], "chance": 20, "rotation": 90 } ],
      "place_nested": [ { "chunks": [ [ "1x1_clothesdryer", 3 ], [ "null", 5 ] ], "x": [ 9, 11 ], "y": [ 2, 5 ] } ],
      "place_monster": [ { "group": "GROUP_HOUSE", "x": [ 2, 21 ], "y": [ 2, 21 ], "repeat": 2 } ]
    }
  },
  {
    "type": "mapgen",
    "method": "json",
    "om_terrain": [ "prefab" ],
    "//": "outdoor furniture variant 1",
    "weight": 50,
    "object": {
      "fill_ter": "t_region_groundcover",
      "rows": [
        "[.._=__=_...............",
        "..._=__=_...............",
        "..._=__=_...............",
        "..._=__=_...............",
        "..._=__=_...............",
        "..{_=__}_....       ....",
        "..._=__=_....       ....",
        "..._=__=_....       ....",
        "..._=__=_....       ....",
        "..._=__=_....       ....",
        "..._=__=_....       ....",
        "..._=__=_....       ....",
        "...______....       ....",
        ".............       ....",
        "............G       ....",
        "......GK.....       ....",
        "......GK.....       ....",
        "........G....       ....",
        ".............       ....",
        "...₸.₸..................",
        "........................",
        "........................",
        "........................",
        "........................"
      ],
      "palettes": [ "standard_domestic_palette", "prefab_home" ],
      "place_vehicles": [ { "vehicle": "parking_garage", "x": 6, "y": [ 5, 9 ], "chance": 20, "rotation": 90 } ],
      "place_nested": [
        { "chunks": [ [ "1x1_clothesdryer", 3 ], [ "null", 5 ] ], "x": [ 9, 11 ], "y": [ 2, 5 ] },
        { "chunks": [ [ "1x1_tree", 1 ], [ "null", 1 ] ], "x": [ 7, 11 ], "y": [ 19, 20 ] }
      ],
      "place_monster": [ { "group": "GROUP_HOUSE", "x": [ 2, 21 ], "y": [ 2, 21 ], "repeat": 2 } ]
    }
  },
  {
    "type": "mapgen",
    "method": "json",
    "om_terrain": [ "prefab" ],
    "//": "outdoor furniture variant 2",
    "weight": 50,
    "object": {
      "fill_ter": "t_region_groundcover",
      "rows": [
        "[.._=__=_...............",
        "..._=__=_...............",
        "..._=__=_...............",
        "..._=__=_...............",
        "..._=__=_...............",
        "..{_=__}_....       ....",
        "..._=__=_....       ....",
        "..._=__=_....       ....",
        "..._=__=_....       ....",
        "..._=__=_....       ....",
        "..._=__=_....       ....",
        "..._=__=_....       ....",
        "...______....       ....",
        ".............       ....",
        ".............       ....",
        "............₸       ....",
        "........G....       ....",
        "........K...₸       ....",
        "........KG...       ....",
        "........................",
        ".......₸................",
        "........................",
        "........................",
        "........................"
      ],
      "palettes": [ "standard_domestic_palette", "prefab_home" ],
      "place_vehicles": [ { "vehicle": "parking_garage", "x": 6, "y": [ 5, 9 ], "chance": 20, "rotation": 90 } ],
      "place_nested": [
        { "chunks": [ [ "1x1_clothesdryer", 3 ], [ "null", 5 ] ], "x": [ 9, 11 ], "y": [ 2, 5 ] },
        { "chunks": [ [ "1x1_tree", 1 ], [ "null", 1 ] ], "x": [ 3, 5 ], "y": [ 14, 20 ] }
      ],
      "place_monster": [ { "group": "GROUP_HOUSE", "x": [ 2, 21 ], "y": [ 2, 21 ], "repeat": 2 } ]
    }
  },
  {
    "type": "mapgen",
    "method": "json",
    "om_terrain": [ "prefab" ],
    "//": "outdoor furniture variant 3",
    "weight": 50,
    "object": {
      "fill_ter": "t_region_groundcover",
      "rows": [
        "[.._=__=_...............",
        "..._=__=_...............",
        "..._=__=_...............",
        "..._=__=_...............",
        "..._=__=_...............",
        "..{_=__}_....       ....",
        "..._=__=_....       ....",
        "..._=__=_....       ....",
        "..._=__=_....       ....",
        "..._=__=_....       ....",
        "..._=__=_....       ....",
        "..._=__=_....       ....",
        "...______....       ....",
        ".............       ....",
        "..........₸..       ....",
        "...KGG.......       ....",
        "..GK.........       ....",
        ".............       ....",
        ".........G...       ....",
        "........................",
        "........................",
        "........................",
        "........................",
        "........................"
      ],
      "palettes": [ "standard_domestic_palette", "prefab_home" ],
      "place_vehicles": [ { "vehicle": "parking_garage", "x": 6, "y": [ 5, 9 ], "chance": 20, "rotation": 90 } ],
      "place_nested": [
        { "chunks": [ [ "1x1_clothesdryer", 3 ], [ "null", 5 ] ], "x": [ 2, 7 ], "y": [ 18, 21 ] },
        { "chunks": [ [ "1x1_tree", 1 ], [ "null", 1 ] ], "x": [ 9, 20 ], "y": 21 }
      ],
      "place_monster": [ { "group": "GROUP_HOUSE", "x": [ 2, 21 ], "y": [ 2, 21 ], "repeat": 2 } ]
    }
  },
  {
    "type": "mapgen",
    "method": "json",
    "om_terrain": [ "prefab" ],
    "//": "garden variant",
    "weight": 33,
    "object": {
      "fill_ter": "t_region_groundcover",
      "rows": [
        "[.._=__=_...............",
        "..._=__=_...............",
        "..._=__=_...............",
        "..._=__=_...............",
        "..._=__=_...............",
        "..{_=__}_....       ....",
        "..._=__=_....       ....",
        "..._=__=_....       ....",
        "..._=__=_....       ....",
        "..._=__=_....       ....",
        "..._=__=_....       ....",
        "..._=__=_....       ....",
        "...______....       ....",
        "........____.       ....",
        "..........._.       ....",
        "..........._.       ....",
        ".$$$$$$$$$._.       ....",
        ".$_______$._.       ....",
        ".$_!!!!!_$._.       ....",
        ".$__________............",
        ".$_!!!!!_$..............",
        ".$_______$..............",
        ".$$$$$$$$$..............",
        "........................"
      ],
      "palettes": [ "standard_domestic_palette", "prefab_home" ],
      "terrain": { "$": "t_fence_wire", "!": "t_dirtmound" },
      "sealed_item": { "!": { "items": { "item": "farming_seeds", "chance": 100 }, "furniture": "f_plant_seedling", "chance": 80 } },
      "place_vehicles": [ { "vehicle": "parking_garage", "x": 6, "y": [ 5, 9 ], "chance": 20, "rotation": 90 } ],
      "place_nested": [
        { "chunks": [ [ "1x1_clothesdryer", 3 ], [ "null", 5 ] ], "x": [ 9, 11 ], "y": [ 2, 5 ] },
        { "chunks": [ [ "1x1_tree", 1 ], [ "null", 1 ] ], "x": [ 3, 9 ], "y": 14 }
      ],
      "place_monster": [ { "group": "GROUP_HOUSE", "x": [ 2, 21 ], "y": [ 2, 21 ], "repeat": 2 } ]
    }
  },
  {
    "type": "mapgen",
    "method": "json",
    "om_terrain": [ "prefab_roof" ],
    "weight": 100,
    "object": {
      "fill_ter": "t_shingle_flat_roof",
      "rows": [
        "                        ",
        "                        ",
        "                        ",
        "                        ",
        "                        ",
        "             .......    ",
        "             .......    ",
        "             ...&...    ",
        "             .......    ",
        "             .......    ",
        "             .......    ",
        "             .......    ",
        "             ...=...    ",
        "             .......    ",
        "             .......    ",
        "             .......    ",
        "             .......    ",
        "             ...&...    ",
        "             .......    ",
        "             .......    ",
        "                        ",
        "                        ",
        "                        ",
        "                        "
      ],
      "palettes": [ "roof_palette" ],
      "terrain": { ".": "t_shingle_flat_roof" }
    }
  }
]
