[
  {
    "type": "mapgen",
    "method": "json",
    "om_terrain": [ [ "afs_habblock_2_a1", "afs_hablock_2_a2" ], [ "afs_habblock_2_a3", "afs_habblock_2_a4" ] ],
    "object": {
      "fill_ter": "t_metal_floor",
      "rows": [
        "©©  ©©©© ©  ©©©  ©©¢¢¢ ¢¢¢  ¢©©   ©©©©   ©©©©©  ",
        "©////©© © ©©©////© ¢¢ ¢¢  ¢¢¢©©////©  ©©© ©////©",
        " /.<//////////.</©©¢ ¢ ¢ ¢    ©/.<//////////.</ ",
        " /.'.!......!.'./©© ¢¢¢¢¢¢¢¢¢©©/.'.!......!.'./ ",
        " ///////''///////©¢ ¢¢¢ ¢  ¢¢ ©///////''/////// ",
        "  /½{{{!..1..../©©¢ ¢¢  ¢¢  ¢  ©/....1..!{{{½/  ",
        "  /½{{½/..//..//  ¢ ¢¢¢ ¢  ¢¢¢©©//..//../½{{½/  ",
        "  /½;;½/../5..5/©   ¢  ¢¢¢¢¢¢¢ ©/5..5/../½;;½/  ",
        "  //{{//..//..//©©   ¢¢¢¢ ¢ ¢  ©//..//..//{{//  ",
        "  /8{{8/../5''5/©© ¢ ¢¢¢¢¢  ¢¢ ©/5''5/../8{{8/  ",
        "  /9{{9/..//..//   ¢   ¢¢¢¢  ¢©©//..//../9{{9/  ",
        "  //{{//../5..5/© ¢¢¢¢ ¢¢¢¢ ¢  ©/5..5/..//{{//  ",
        "  /8{{8/..//..//©©¢¢  ¢¢¢¢ ¢¢¢ ©//..//../8{{8/  ",
        "  /9{{9/../5..5/© ¢¢ ¢¢¢ ¢¢ ¢¢  /5..5/../9{{9/  ",
        "  //{{//''///1//© ¢¢ ¢¢¢¢¢¢   ©©///1//''//{{//  ",
        "  /8;;l/../á.'á/©    ¢¢   ¢ ¢¢ ©/á.'á/../l;;8/  ",
        "  /9{{l/../á.há/©©¢  ¢¢¢¢¢¢¢  ©©/áh.á/../l{{9/  ",
        "  //{{l/..//fff/©©¢ ¢ ¢¢¢ ¢¢    /fff//../l{{//  ",
        "  /{{{//.../////©©¢   ¢¢  ¢¢  © /////...//{{{/  ",
        "  /////..../20//© ¢¢¢ ¢¢¢  ¢ ¢©©//02/..../////  ",
        "   /02/....!22/© ¢ ¢¢ ¢¢¢¢ ¢¢¢  ©/22!..../20/   ",
        "   /22!.''.////©   ¢ ¢ ¢¢  ¢¢¢¢©©////.''.!22/   ",
        "   ////....!..!©   ¢¢¢  ¢¢    ¢©©!..!....////   ",
        "   =b...℗℗.=.'/©©  ¢ ¢¢¢ ¢   ¢¢  /'.=.℗℗...b=   ",
        "   =b...℗℗.=.'/©    ¢¢¢¢¢¢ ¢  ¢ ©/'.=.℗℗...b=   ",
        "   ////....!..!©©¢¢¢¢¢¢¢¢  ¢¢ ¢©©!..!....////   ",
        "   /22!.''.////©  ¢¢¢¢¢     ¢¢¢©©////.''.!22/   ",
        "   /02/....!22/©©    ¢¢¢¢¢  ¢   ©/22!..../20/   ",
        "  /////..../20//© ¢¢  ¢ ¢  ¢¢¢ ©//02/..../////  ",
        "  /&{/....//////© ¢¢¢ ¢¢¢¢¢ ¢¢ ©////////../{&/  ",
        "  /*;:..../..hv/© ¢¢¢¢¢¢¢¢¢¢¢  ©/SW/joF/..:;*/  ",
        "  ////.''.=.kck/©© ¢ ¢¢¢¢¢¢    ©/'//.../''////  ",
        "  /*;:....=..'./  ¢  ¢¢¢¢¢¢¢¢¢©©/:/..hh/..:;*/  ",
        "  /&{/...////://©  ¢    ¢    ¢©©/...'yy/../{&/  ",
        "  /////..=kc..k/© ¢   ¢   ¢¢¢¢ ©/:/..hh/..////  ",
        "  /.6./..=qh'hc/©©¢¢  ¢¢¢  ¢¢¢  /~/..../.../❶/  ",
        "  /.'./..=q...v/© ¢  ¢¢¢¢  ¢¢¢  ////.hh/..//./  ",
        "  //34/..////://  ¢¢  ¢¢¢ ¢¢¢  ©/S':.yy/../❸./  ",
        "  /7../../p..../©©¢¢ ¢¢¢¢  ¢¢¢ ©/W//'hh/../❸./  ",
        "  //'./..=b'kh./  ¢¢  ¢¢  ¢¢¢ © ///....:..1.'/  ",
        "  /7..3..=b.kck/©  ¢    ¢¢¢  ¢ ©/.:./://../../  ",
        "  //..4..:...../      ¢¢ ¢¢ ¢ ©©/'///'/..//../  ",
        "  /7.//''/pbbb./© ¢  ¢¢¢    ¢¢©©/SW/WS/''/❹❺c/  ",
        " /////.../==/////©©   ¢¢¢  ¢¢  ////////..////// ",
        " /.'.!......!.../©© ¢¢    ¢¢¢ ©/.'.!......!.'./ ",
        " /.<//////////.</©       ©  ©© /.<//////////.</ ",
        " ////        ////© ©©   ©©© ©©©////        //// ",
        "                                                "
      ],
      "palettes": [
        "afs_habitat_structure",
        "afs_habitat_exterior",
        "afs_habitat_residential_furnishing",
        "afs_habitat_life_support",
        "afs_light_param_palette"
      ],
      "terrain": {
        "0": "t_elevator_control",
        "1": "t_afs_door_metal_elocked",
        "2": "t_elevator",
        "3": "t_door_metal_locked",
        "4": "t_afs_industrial_card_reader",
        "8": "t_linoleum_white",
        "9": "t_linoleum_white",
        "l": "t_linoleum_white",
        "½": "t_linoleum_white",
        "&": "t_linoleum_white",
        "*": "t_linoleum_white"
      },
      "furniture": {
        "5": "f_drone_recharge_station",
        "6": [ [ "f_drone_ai_core_broken", 20 ], [ "f_drone_ai_core", 1 ] ],
        "7": "f_ancient_processor",
        "8": "f_washer",
        "9": "f_dryer",
        "á": "f_rack",
        "½": "f_table"
      },
      "items": { "á": { "item": "afs_tools_electric_repair", "chance": 60, "repeat": [ 1, 3 ] } },
      "place_monster": [
        { "group": "AFS_GROUP_RUIN_MOXIE", "x": [ 0, 23 ], "y": [ 0, 23 ], "pack_size": [ 1, 3 ], "chance": 30 },
        { "group": "AFS_GROUP_RUIN_MOXIE", "x": [ 24, 47 ], "y": [ 0, 23 ], "pack_size": [ 1, 3 ], "chance": 30 },
        { "group": "AFS_GROUP_RUIN_MOXIE", "x": [ 0, 23 ], "y": [ 24, 47 ], "pack_size": [ 1, 3 ], "chance": 30 },
        { "group": "AFS_GROUP_RUIN_MOXIE", "x": [ 24, 47 ], "y": [ 24, 47 ], "pack_size": [ 1, 3 ], "chance": 30 },
        {
          "group": "AFS_GROUP_ROBOT_NEUTRAL_OLD_DOMESTIC",
          "x": [ 12, 13 ],
          "y": [ 5, 13 ],
          "pack_size": [ 1, 3 ],
          "chance": 25
        },
        {
          "group": "AFS_GROUP_ROBOT_NEUTRAL_OLD_DOMESTIC",
          "x": [ 35, 36 ],
          "y": [ 5, 13 ],
          "pack_size": [ 1, 3 ],
          "chance": 25
        }
      ],
      "place_nested": [
        { "chunks": [ { "param": "lightstatus", "fallback": "null" } ], "x": 0, "y": 0 },
        { "chunks": [ { "param": "lightstatus", "fallback": "null" } ], "x": 24, "y": 0 },
        { "chunks": [ { "param": "lightstatus", "fallback": "null" } ], "x": 0, "y": 24 },
        { "chunks": [ { "param": "lightstatus", "fallback": "null" } ], "x": 24, "y": 24 }
      ]
    }
  },
  {
    "type": "mapgen",
    "method": "json",
    "om_terrain": [
      [ "afs_habblock_2_floor2_a1", "afs_hablock_2_floor2_a2" ],
      [ "afs_habblock_2_floor2_a3", "afs_habblock_2_floor2_a4" ]
    ],
    "object": {
      "fill_ter": "t_metal_floor",
      "rows": [
        "                                                ",
        " ////        ////              ////        //// ",
        " /<>//==//==//<>/              /<>//==//==//<>/ ",
        " /.'.!..℗℗..!.'./              /.'.!..℗℗..!.'./ ",
        " /////..''../////              /////..''..///// ",
        "  /.bb........./                /F{/........./  ",
        "  =.℗℗n.22]222.=                =o{jh...vv.hh=  ",
        "  =.℗℗n.2á{{á2.=                =j;j.......yy=  ",
        "  /.bb..2á{{á2./                /*{jh.hyh..hh/  ",
        "  /..'..2á;;á2'/                /{{c..hyh..../  ",
        "  /.22222á{{á2./                /://......////  ",
        "  =.2ááááá{{á2.=                =;ê/.....hj{F=  ",
        "  =.2{;{{{{{á2.=                ={ê/.vv..hj;o=  ",
        "  /.2ááá{//://./                /://......c{*/  ",
        "  /.2{;{{/â'â/./                /..hh..hh./://  ",
        "  /'2áááá/â.â/'/                /..yy..yy./;ê/  ",
        "  =.22222/////.=                =..hh..hh./{ê=  ",
        "  /............/                /........./://  ",
        "  /pbb..''./////                /////.''...../  ",
        "  /////..../10//                //01/..../////  ",
        "   /01/....!11/                  /11!..../10/   ",
        "   /11!....////                  ////....!11/   ",
        "   ////......./                  /.......////   ",
        "   =℗℗...'...b=                  =b...'...℗℗=   ",
        "   =℗℗...'...b=                  =b...'...℗℗=   ",
        "   ////......./                  /.......////   ",
        "   /11!....////                  ////....!11/   ",
        "   /01/....!11/                  /11!..../10/   ",
        "  /////.''./10//                //01/.''./////  ",
        "  /......../////                /////......../  ",
        "  ////nn.....℗℗/                /.......///!//  ",
        "  =@ä///////..℗=                =......n=6{{k=  ",
        "  /@3:{{:;é/n../                /..''..n={;5c/  ",
        "  ////{{////n../                /......n={{{k/  ",
        "  /@@/;;/ä@/n../                /../:/:////://  ",
        "  =@@/{{:3@/n..=                =.n={{{{{{j{{=  ",
        "  =ä3:{{////.''=                =..={7{7{{c{ë=  ",
        "  ////{{/ä@/n../                /.n=;ê{ê;{j{ë/  ",
        "  /~/5{{:3@/n../                /'n={ê{ê{{j{ë/  ",
        "  /:/ck{////.../                /..={ê{ê{{////  ",
        "  =;{{{{/n.....=                =.n={{{{{{:{7=  ",
        "  ={{//!/n.....=                =..////////;{=  ",
        "  /44/n.....pbb/                /........./&*/  ",
        " /////..''../////              /////..''..///// ",
        " /.'.!..℗℗..!.'./              /.'.!..℗℗..!.'./ ",
        " /<>//==//==//<>/              /<>//==//==//<>/ ",
        " ////        ////              ////        //// ",
        "                                                "
      ],
      "palettes": [ "afs_habitat_structure", "afs_habitat_exterior", "afs_habitat_residential_furnishing", "afs_light_param_palette" ],
      "terrain": {
        " ": "t_open_air",
        "0": "t_elevator_control",
        "1": "t_elevator",
        "2": "t_wall_clearcrete_alarm",
        "á": "t_linoleum_white",
        "3": "t_carpet_metal_red",
        "@": "t_carpet_metal_red",
        "ä": "t_carpet_metal_red",
        "é": "t_linoleum_white",
        "k": "t_linoleum_white",
        "4": "t_linoleum_white",
        "5": "t_linoleum_white",
        "c": "t_linoleum_white",
        "j": "t_linoleum_white",
        "6": "t_linoleum_white",
        "ë": "t_linoleum_white",
        "&": "t_linoleum_white",
        "*": "t_linoleum_white",
        "7": "t_linoleum_white",
        "F": "t_linoleum_white",
        "o": "t_linoleum_white",
        "ê": "t_linoleum_white"
      },
      "furniture": {
        "á": "f_planter",
        "â": "f_rack",
        "ä": "f_table",
        "é": "f_rack",
        "ê": "f_rack",
        "ë": "f_rack",
        "4": "f_bench",
        "5": "f_chair",
        "6": "f_trashcan",
        "7": "f_screenmirror"
      },
      "items": {
        "â": { "item": "farming_tools", "chance": 60, "repeat": [ 1, 2 ] },
        "ä": { "item": "afs_consumer_vr", "chance": 60 },
        "é": { "item": "afs_consumer_vr", "chance": 80, "repeat": [ 1, 3 ] },
        "ê": { "item": "afs_old_food_storage", "chance": 40, "repeat": [ 1, 3 ] },
        "ë": { "item": "consumer_electronics", "chance": 40, "repeat": [ 1, 3 ] }
      },
      "place_monster": [
        { "group": "AFS_GROUP_RUIN_MOXIE", "x": [ 4, 13 ], "y": [ 2, 23 ], "pack_size": [ 1, 3 ], "chance": 30 },
        { "group": "AFS_GROUP_RUIN_MOXIE", "x": [ 34, 43 ], "y": [ 2, 23 ], "pack_size": [ 1, 3 ], "chance": 30 },
        { "group": "AFS_GROUP_RUIN_MOXIE", "x": [ 4, 13 ], "y": [ 24, 45 ], "pack_size": [ 1, 3 ], "chance": 30 },
        { "group": "AFS_GROUP_RUIN_MOXIE", "x": [ 34, 43 ], "y": [ 24, 45 ], "pack_size": [ 1, 3 ], "chance": 30 }
      ],
      "place_nested": [
        { "chunks": [ { "param": "lightstatus", "fallback": "null" } ], "x": 0, "y": 0 },
        { "chunks": [ { "param": "lightstatus", "fallback": "null" } ], "x": 24, "y": 0 },
        { "chunks": [ { "param": "lightstatus", "fallback": "null" } ], "x": 0, "y": 24 },
        { "chunks": [ { "param": "lightstatus", "fallback": "null" } ], "x": 24, "y": 24 }
      ]
    }
  },
  {
    "type": "mapgen",
    "method": "json",
    "om_terrain": [
      [ "afs_habblock_2_floor3_a1", "afs_hablock_2_floor3_a2" ],
      [ "afs_habblock_2_floor3_a3", "afs_habblock_2_floor3_a4" ]
    ],
    "object": {
      "fill_ter": "t_metal_floor",
      "rows": [
        "                                                ",
        " ////        ////              ////        //// ",
        " /><//==//==//></              /><//==//==//></ ",
        " /.'.!..''..!.'./              /.'.!......!.'./ ",
        " ///////..///////              ///////../////// ",
        "  /W555/../555W/                /6555/../555W/  ",
        "  =@@5e/../e5@@=                =@@5e/../e5@@=  ",
        "  =@@5e/../e5@@=                =@@5e/../e5@@=  ",
        "  /y555/../5556/                /W555/../5556/  ",
        "  //:///..///://                ///://..//:///  ",
        "  /á.yy/..:...h/                /yy.á/../.'.á/  ",
        "  =..hh/../á..y=                =hh../..:.hyh=  ",
        "  =.'../../..'h=                =.'..:../.hyh=  ",
        "  /....:../Foj./                /Foj./../.'../  ",
        "  /.joF/..////:/                ////:/../Foj./  ",
        "  /:////../&{*{/                /&{*{/..////:/  ",
        "  ={*{&/../{{;{=                ={;{{/../&{*{=  ",
        "  /{;{{/''//222/      4444      /222//''/{{;{/  ",
        "  /222//.../////    444hh444    /////...//222/  ",
        "  /////..../10//   4433yy3344   //01/..../////  ",
        "   /01/....!11/   4433.hh.3344   /11!..../10/   ",
        "   /11!....////   4b3......3b4   ////....!11/   ",
        "   ////.....bb/444/b..3333..b/444/bb.....////   ",
        "   =℗℗...'....!...!.'333333'.!...!....'...℗℗=   ",
        "   =℗℗...'....!...!.'333333'.!...!....'...℗℗=   ",
        "   ////.....pV/444/b..3333..b/444/Vp.....////   ",
        "   /11!....////   4b3......3b4   ////....!11/   ",
        "   /01/....!11/   4433.hh.3344   /11!..../10/   ",
        "  /////..../10//   4433yy3344   //01/..../////  ",
        "  /222//.../////    444hh444    /////...//222/  ",
        "  /{;{{/''//222/      4444      /222//''/{{;{/  ",
        "  ={*{&/../{;{{=                ={;{{/../&{*{=  ",
        "  /:////../{*{&/                /{*{&/..////:/  ",
        "  /.Foj/../:////                /:////../Foj./  ",
        "  /.'..:../.Foj/                /.Foj/..:..../  ",
        "  =hyh./../..'./                /h'../../..'.=  ",
        "  =hhh./..:..hh/                /y..á/../hh..=  ",
        "  /á'../../á.yy/                /h...:../yy.á/  ",
        "  ///://..//:///                //:///..///://  ",
        "  /W555/../5556/                /6555/../555W/  ",
        "  =@@5e/../e5@@=                =@@5e/../e5@@=  ",
        "  =@@5e/../e5@@=                =@@5e/../e5@@=  ",
        "  /6555/../555W/                /W555/../5556/  ",
        " ///////..///////              ///////../////// ",
        " /.'.!..''..!.'./              /.'.!......!.'./ ",
        " /><//==//==//></              /><//==//==//></ ",
        " ////        ////              ////        //// ",
        "                                                "
      ],
      "palettes": [ "afs_habitat_structure", "afs_habitat_exterior", "afs_habitat_residential_furnishing", "afs_light_param_palette" ],
      "terrain": {
        " ": "t_open_air",
        "0": "t_elevator_control",
        "1": "t_elevator",
        "3": "t_grass",
        "4": "t_wall_clearcrete_alarm",
        "2": "t_linoleum_white",
        "*": "t_linoleum_white",
        "&": "t_linoleum_white",
        "5": "t_carpet_metal_red",
        "e": "t_carpet_metal_red",
        "@": "t_carpet_metal_red",
        "W": "t_carpet_metal_red",
        "6": "t_carpet_metal_red"
      },
      "furniture": { "á": "f_bookcase", "2": "f_bathtub", "6": "f_table" },
      "items": { "á": { "item": "homebooks", "repeat": [ 2, 3 ] } },
      "vendingmachines": { "V": { "item_group": "afs_vending_false_meals", "reinforced": true, "powered": true, "networked": true } },
      "place_monster": [
        { "group": "AFS_GROUP_RUIN_MOXIE", "x": [ 4, 13 ], "y": [ 2, 23 ], "pack_size": [ 1, 3 ], "chance": 30 },
        { "group": "AFS_GROUP_RUIN_MOXIE", "x": [ 34, 43 ], "y": [ 2, 23 ], "pack_size": [ 1, 3 ], "chance": 30 },
        { "group": "AFS_GROUP_RUIN_MOXIE", "x": [ 4, 13 ], "y": [ 24, 45 ], "pack_size": [ 1, 3 ], "chance": 30 },
        { "group": "AFS_GROUP_RUIN_MOXIE", "x": [ 34, 43 ], "y": [ 24, 45 ], "pack_size": [ 1, 3 ], "chance": 30 }
      ],
      "place_nested": [
        { "chunks": [ { "param": "lightstatus", "fallback": "null" } ], "x": 0, "y": 0 },
        { "chunks": [ { "param": "lightstatus", "fallback": "null" } ], "x": 24, "y": 0 },
        { "chunks": [ { "param": "lightstatus", "fallback": "null" } ], "x": 0, "y": 24 },
        { "chunks": [ { "param": "lightstatus", "fallback": "null" } ], "x": 24, "y": 24 }
      ]
    }
  },
  {
    "type": "mapgen",
    "method": "json",
    "om_terrain": [
      [ "afs_habblock_2_floor4_a1", "afs_hablock_2_floor4_a2" ],
      [ "afs_habblock_2_floor4_a3", "afs_habblock_2_floor4_a4" ]
    ],
    "object": {
      "fill_ter": "t_metal_floor",
      "rows": [
        "                                                ",
        " ////        ////              ////        //// ",
        " /<>//==//==//<>/              /.>//==//==//.>/ ",
        " /.'.!..''..!.'./              /.'.!..''..!.'./ ",
        " ///////..///////              ///////../////// ",
        "  /W555/../555W/                /6555/../555W/  ",
        "  =@@5e/../e5@@=                =@@5e/../e5@@=  ",
        "  =@@5e/../e5@@=                =@@5e/../e5@@=  ",
        "  /6555/../5556/                /W555/../5556/  ",
        "  //:///..///://                ///://..//:///  ",
        "  /á.yy/..:...h/                /yy.á/../..'á/  ",
        "  =..hh/../á.'y=                =hh../..:.hyh=  ",
        "  =.'../../...h=                =.'..:../.hyh=  ",
        "  /....:../Foj./                /Foj./../..'./  ",
        "  /.joF/..////:/                ////:/../Foj./  ",
        "  /:////../&{*{/                /&{*{/..////:/  ",
        "  ={*{&/../{{;{=                ={{;{/../&{*{=  ",
        "  /{{;{/''//222/      3333      /222//''/{{;{/  ",
        "  /222//.../////    33333333    /////...//222/  ",
        "  /////..../10//   3333333333   //01/..../////  ",
        "   /01/....!11/   333333333333   /11!..../10/   ",
        "   /11!....////   333333333333   ////....!11/   ",
        "   ////....pbb/333333333333333333/bbp....////   ",
        "   =℗℗...'..../333333333333333333/....'...℗℗=   ",
        "   =℗℗...'..../333333333333333333/....'...℗℗=   ",
        "   ////....pbb/333333333333333333/bbp....////   ",
        "   /11!....////   333333333333   ////....!11/   ",
        "   /01/....!11/   333333333333   /11!..../10/   ",
        "  /////..../10//   3333333333   //01/..../////  ",
        "  /222//.../////    33333333    /////...//222/  ",
        "  /{;{{/''//222/      3333      /222//''/{{;{/  ",
        "  ={*{&/../{;{{=                ={;{{/../&{*{=  ",
        "  /:////../{*{&/                /{*{&/..////:/  ",
        "  /.Foj/../:////                /:////../Foj./  ",
        "  /.'..:../.Foj/                /.Foj/..:..../  ",
        "  =hyh./../....=                =h.../../....=  ",
        "  =hhh./..:.'hh=                =y'.á/../hh'.=  ",
        "  /á'../../á.yy/                /h...:../yy.á/  ",
        "  ///://..//:///                //:///..///://  ",
        "  /W555/../5556/                /6555/../555W/  ",
        "  =@@5e/../e5@@=                =@@5e/../e5@@=  ",
        "  =@@5e/../e5@@=                =@@5e/../e5@@=  ",
        "  /6555/../555W/                /W555/../5556/  ",
        " ///////..///////              ///////../////// ",
        " /.'.!..''..!.'./              /.'.!..''..!.'./ ",
        " /<>//==//==//<>/              /.>//==//==//.>/ ",
        " ////        ////              ////        //// ",
        "                                                "
      ],
      "palettes": [ "afs_habitat_structure", "afs_habitat_exterior", "afs_habitat_residential_furnishing", "afs_light_param_palette" ],
      "terrain": {
        " ": "t_open_air",
        "0": "t_elevator_control",
        "1": "t_elevator",
        "3": "t_clearcrete_roof",
        "2": "t_linoleum_white",
        "*": "t_linoleum_white",
        "&": "t_linoleum_white",
        "5": "t_carpet_metal_red",
        "e": "t_carpet_metal_red",
        "@": "t_carpet_metal_red",
        "W": "t_carpet_metal_red",
        "6": "t_carpet_metal_red"
      },
      "furniture": { "á": "f_bookcase", "2": "f_bathtub", "6": "f_table" },
      "items": { "á": { "item": "homebooks", "repeat": [ 2, 3 ] } },
      "place_monster": [
        { "group": "AFS_GROUP_RUIN_MOXIE", "x": [ 4, 13 ], "y": [ 2, 23 ], "pack_size": [ 1, 3 ], "chance": 30 },
        { "group": "AFS_GROUP_RUIN_MOXIE", "x": [ 34, 43 ], "y": [ 2, 23 ], "pack_size": [ 1, 3 ], "chance": 30 },
        { "group": "AFS_GROUP_RUIN_MOXIE", "x": [ 4, 13 ], "y": [ 24, 45 ], "pack_size": [ 1, 3 ], "chance": 30 },
        { "group": "AFS_GROUP_RUIN_MOXIE", "x": [ 34, 43 ], "y": [ 24, 45 ], "pack_size": [ 1, 3 ], "chance": 30 }
      ],
      "place_nested": [
        { "chunks": [ { "param": "lightstatus", "fallback": "null" } ], "x": 0, "y": 0 },
        { "chunks": [ { "param": "lightstatus", "fallback": "null" } ], "x": 24, "y": 0 },
        { "chunks": [ { "param": "lightstatus", "fallback": "null" } ], "x": 0, "y": 24 },
        { "chunks": [ { "param": "lightstatus", "fallback": "null" } ], "x": 24, "y": 24 }
      ]
    }
  },
  {
    "type": "mapgen",
    "method": "json",
    "om_terrain": [
      [ "afs_habblock_2_floor5_a1", "afs_hablock_2_floor5_a2" ],
      [ "afs_habblock_2_floor5_a3", "afs_habblock_2_floor5_a4" ]
    ],
    "object": {
      "fill_ter": "t_metal_floor_no_roof",
      "rows": [
        "                                                ",
        " ////        ////              [[[[        [[[[ ",
        " />.//////////>./              [.™[[[[[[[[[[..[ ",
        " /.'.!..''..!.'./              [.™.©©©™©™©©™™.[ ",
        " ///////..///////              [[.™©.™™...©.™[[ ",
        "  /jF.jh../¼¼¼½/                [™™©..™™..™™.[  ",
        "  =o.'j.../¾¼@@=                [™.™™©™™©.™™.[  ",
        "  =*..jh../¾¼@@=                [.™©.©.™©™©™™[  ",
        "  ///.//..:¼¼¼¼/                [™.©™©©™©™™.™[  ",
        "  /.......///::/                [™™©™©..©.©™.[  ",
        "  //////...â/WW/                [™.©™©™.©.©™™[  ",
        "  /2{&*/....////                [™.©.™™™™.©.™[  ",
        "  /2{;{:.ö..sss/                [..©™©©™©™©..[  ",
        "  //////......./                [.™™™™.™™™™..[  ",
        "  /½¼¼¼:....333/                [[[[[[..[[[[[[  ",
        "  /@@¼¾/áá.'.../                [℗℗℗℗....℗℗℗℗[  ",
        "  =@@¼¾///..eee=                [℗℗bb™™™.℗℗℗℗[  ",
        "  =½¼¼¼:W/.....=                [℗™.™™™....℗℗[  ",
        "  /¼¼¼¼:W/...../                [.™™™..™™™..℗[  ",
        "  /////////.4y//                [[℗℗™™.℗.™™.[[  ",
        "   /01/.../:///                  [℗℗℗™™℗℗.™™[   ",
        "   /11!......./                  [℗℗℗™™.℗℗.™[   ",
        "   ////.....///[[[[[[[[[[[[[[[[[[[℗℗™™.b℗℗™.[   ",
        "   =℗℗...'..!'!™™..™™.™.™™..™™..™™™..™.b℗℗™.[   ",
        "   =℗℗...'..!'!.™...™.™™™..™™...™..℗..™™℗℗..[   ",
        "   ////.....///[[[[[[[[[[[[[[[[[[[™℗℗™™℗℗℗™.[   ",
        "   /11!......./                  [™℗℗℗℗℗℗℗™™[   ",
        "   /01/.../:///                  [™℗℗℗℗℗℗™.™[   ",
        "  /////////.4y//                [[™™℗℗℗™™™™.[[  ",
        "  /¼¼¼¼:W/...../                [℗.™™™.™™™™℗℗[  ",
        "  =½¼¼¼:W/.....=                [℗..™™...™℗℗℗[  ",
        "  =@@¼¾///..eee=                [℗℗bb™.™.℗℗℗℗[  ",
        "  /@@¼¾/áá.'.../                [℗℗℗℗.™.℗℗℗℗℗[  ",
        "  /½¼¼¼:....333/                [[[[[[™.[[[[[[  ",
        "  //////......./                [.™™™...™.™..[  ",
        "  /2{;{:....sss/                [..™™™..™™.™.[  ",
        "  /2{&^/....////                [™.55™.™.55™.[  ",
        "  //////...â/WW/                [™™55..™.55™™[  ",
        "  /.......///::/                [™™55.66.55™.[  ",
        "  //..//..:¼¼¼½/                [.™55.™.™55™.[  ",
        "  =*..jh../¾¼@@=                [™™55™™.™55™™[  ",
        "  =o.'j.ö./¾¼@@=                [™.55.77.55™.[  ",
        "  /jF.jh../¼¼¼½/                [.™™™™77..™™.[  ",
        " ///////..///////              [[.8™™.77™.™8.[[ ",
        " /.'.!..''..!.'./              [.™™™™...™™™.™™[ ",
        " />.//////////>./              [..[[[[[[[[[[™.[ ",
        " ////        ////              [[[[        [[[[ ",
        "                                                "
      ],
      "palettes": [ "afs_habitat_structure", "afs_habitat_exterior", "afs_habitat_residential_furnishing", "afs_light_param_palette" ],
      "terrain": {
        " ": "t_open_air",
        ".": "t_metal_floor_no_roof",
        "0": "t_elevator_control",
        "1": "t_elevator",
        "^": "t_linoleum_white",
        "&": "t_linoleum_white",
        "2": "t_linoleum_white",
        "¼": "t_carpet_metal_red",
        "@": "t_carpet_metal_red",
        "W": "t_carpet_metal_red",
        "½": "t_carpet_metal_red",
        "¾": "t_carpet_metal_red"
      },
      "furniture": {
        "á": "f_bookcase",
        "â": "f_drone_recharge_station",
        "2": "f_bathtub",
        "3": "f_coffee_table",
        "4": "f_rack_coat",
        "5": "f_solar_unit",
        "6": "f_small_satellite_dish",
        "7": "f_vent_pipe",
        "8": "f_roof_turbine_vent",
        "½": "f_table",
        "¾": "f_entertainment_center"
      },
      "items": { "á": { "item": "homebooks", "repeat": [ 2, 3 ] } },
      "monster": { "ö": { "monster": "mon_utilibot_butler", "chance": 30 } },
      "place_monster": [
        { "group": "AFS_GROUP_RUIN_MOXIE", "x": [ 4, 13 ], "y": [ 2, 23 ], "pack_size": [ 1, 3 ], "chance": 30 },
        { "group": "AFS_GROUP_RUIN_MOXIE", "x": [ 34, 43 ], "y": [ 2, 23 ], "pack_size": [ 1, 3 ], "chance": 30 },
        { "group": "AFS_GROUP_RUIN_MOXIE", "x": [ 4, 13 ], "y": [ 24, 45 ], "pack_size": [ 1, 3 ], "chance": 30 },
        { "group": "AFS_GROUP_RUIN_MOXIE", "x": [ 34, 43 ], "y": [ 24, 45 ], "pack_size": [ 1, 3 ], "chance": 30 }
      ],
      "place_nested": [
        { "chunks": [ { "param": "lightstatus", "fallback": "null" } ], "x": 0, "y": 0 },
        { "chunks": [ { "param": "lightstatus", "fallback": "null" } ], "x": 24, "y": 0 },
        { "chunks": [ { "param": "lightstatus", "fallback": "null" } ], "x": 0, "y": 24 },
        { "chunks": [ { "param": "lightstatus", "fallback": "null" } ], "x": 24, "y": 24 }
      ]
    }
  },
  {
    "type": "mapgen",
    "method": "json",
    "om_terrain": [ [ "afs_habblock_2_roof_a1" ], [ "afs_habblock_2_roof_a2" ] ],
    "object": {
      "fill_ter": "t_metal_floor",
      "rows": [
        "                        ",
        " [[[[        [[[[       ",
        " [..[[[[[[[[[[..[       ",
        " [..............[       ",
        " [[............[[       ",
        "  [............[        ",
        "  [............[        ",
        "  [............[        ",
        "  [............[        ",
        "  [............[        ",
        "  [............[        ",
        "  [............[        ",
        "  [............[        ",
        "  [............[        ",
        "  [............[        ",
        "  [............[        ",
        "  [............[        ",
        "  [............[        ",
        "  [............[        ",
        "  [[..........[[        ",
        "   [..........[         ",
        "   [..........[         ",
        "   [..........[         ",
        "   [..........[         ",
        "   [..........[         ",
        "   [..........[         ",
        "   [..........[         ",
        "   [..........[         ",
        "  [[..........[[        ",
        "  [............[        ",
        "  [............[        ",
        "  [............[        ",
        "  [............[        ",
        "  [............[        ",
        "  [............[        ",
        "  [............[        ",
        "  [............[        ",
        "  [............[        ",
        "  [............[        ",
        "  [............[        ",
        "  [............[        ",
        "  [............[        ",
        "  [............[        ",
        " [[............[[       ",
        " [..............[       ",
        " [..[[[[[[[[[[..[       ",
        " [[[[        [[[[       ",
        "                        "
      ],
      "palettes": [ "afs_habitat_structure", "afs_habitat_exterior" ],
      "terrain": { " ": "t_open_air", ".": "t_metal_floor_no_roof" }
    }
  }
]
