[
  {
    "type": "mapgen",
    "method": "json",
    "om_terrain": [ [ "mine_amigara_west", "mine_amigara_central", "mine_amigara_east" ] ],
    "object": {
      "fill_ter": "t_rock_floor",
      "rows": [
        "#################@              ^       @@@@############################",
        "################@  *******************     @@@@@@!######################",
        "###############!  **  ^              **  ^       @######################",
        "##############@  **  @@@@@@!@@@@@@@@  **         @######################",
        "#############@^ **  @###############@  ********   @@@@##################",
        "@@@@@@@@!@@@@  **  @#################!    ^   **     @##################",
        "               *  @##################@@@@@@@! ^*  ^  @##################",
        "               * !##########################@@ Δ     @##################",
        "            ^  *  @##########################@ Ʌ     @##################",
        "@@@!@@@@@@@@!  **  @#########################@       @##################",
        "#############@  **  @########################@@@@@@@@@##################",
        "##############@  **  !##################################################",
        "###############@  **  @#######################@@@@@@@@@@@@@@@@@@@@@@@@@@",
        "################!  **^ @######################! @@@@@@@@@@@!@@@@@@@@@@ !",
        "#################@  **  @@@!@@@@@@@@@@!@@@@@@@                          ",
        "##################@  **         ^                    ^                  ",
        "###################@  **************************************************",
        "####################!                      ^                            ",
        "#####################@@@@@@@!@@@@@@@@!@@@@@@@@                          ",
        "##############################################!  @@@@@@@@@@!@@@@@@@@@@ !",
        "###############################################@@@@@@@@@@@@@@@@@@@@@@@@@",
        "########################################################################",
        "########################################################################",
        "########################################################################"
      ],
      "terrain": {
        " ": [ [ "t_puddle_underground", 1 ], [ "t_rock_floor", 10 ] ],
        "@": [ [ "t_rock", 4 ], [ "t_rock_floor", 1 ] ],
        "#": "t_rock",
        "*": "t_railroad_track_small",
        "!": "t_pillar",
        "Δ": "t_railroad_ramp_down_low",
        "Ʌ": "t_railroad_ramp_down_high"
      },
      "items": {
        " ": [
          {
            "item": {
              "subtype": "distribution",
              "entries": [
                { "item": "coal_lump", "prob": 20, "count": [ 1, 10 ] },
                { "item": "rock", "prob": 40, "count": [ 1, 10 ] },
                { "item": "rock_large", "prob": 10, "count": [ 1, 10 ] },
                { "item": "rock_flaking", "prob": 20, "count": [ 1, 10 ] },
                { "item": "material_shrd_limestone", "prob": 40, "count": [ 1, 10 ] },
                { "item": "material_limestone", "prob": 40, "count": [ 1, 10 ] },
                { "item": "material_niter", "prob": 5, "count": [ 1, 10 ] },
                { "item": "material_sand", "prob": 50, "charges": [ 10, 500 ] },
                { "item": "material_soil", "prob": 50, "charges": [ 10, 500 ] },
                { "item": "chunk_sulfur", "prob": 5, "count": [ 1, 10 ] },
                { "item": "material_rocksalt", "prob": 5, "count": [ 1, 10 ] },
                { "item": "material_rhodonite", "prob": 5, "count": [ 1, 10 ] },
                { "item": "material_zincite", "prob": 5, "count": [ 1, 10 ] }
              ]
            },
            "repeat": [ 1, 3 ],
            "chance": 1
          },
          { "item": "mine_equipment", "chance": 1 }
        ]
      },
      "traps": { "^": "tr_sinkhole" }
    }
  },
  {
    "type": "mapgen",
    "method": "json",
    "om_terrain": [ [ "mine_amigara_-1_west", "mine_amigara_-1_central", "mine_amigara_-1_east" ] ],
    "object": {
      "fill_ter": "t_rock_floor",
      "rows": [
        "№######@@..............^..............@###########@@@@@@###########@@@@@",
        "######@  .***************************..!#######@@@     @@@@########@   @",
        "#####@ ..**......^.............^....**.@#######@     ^    @#######@@ @@@",
        "######!.**.  @@@@!@@@@@@@@@@@@!@@@@ .*.@#######@@@@@@@@@@  @######@  @##",
        "#@@@@@@.*. @@######################@^*.@#################@  @####@@ @@##",
        "#@     .*.@######@@@@@@@@@###@@@###!.Δ.@#####@@@@@########@  @@##@  @###",
        "####   .*^!#####@#    ^  @###@ @@##@.Ʌ.@@####!...@@@@@#####@  @##@ @####",
        "####   .*.@#####@  @@@@@@@###@  @#@ ... @####@.Ŧ.    @#####@# @@@@ @####",
        "#@ ^   .*.@#####@ @##########@@ @#@@@@!@@####@.±. 5  @#####@ ^     @@###",
        "#@     .*.@!@@@@@ @@@@  @@####@ @############@.*.    @#####@ @@@@@@ @###",
        "#@@@@@@.*.        ^      @####@^@@@@@@#######@.*.@@@@@####@@ @####@ @###",
        "######!.*.  @@@@@@ @@@  @@###@       @#######@.*.!########@  @####@ @###",
        "###@@@@.*.  @####@ @#@@@@####@@@@@@  @#######@^*.@########@ @@####@ @###",
        "###@   .*.@@@####@ @######@@######@  @@@#####!.*.@@@@@@@@@@ @##@##@@@###",
        "###@   ^*.!######@      ^      @##@    @#####@.*.              @########",
        "###@   .*.@######@ @@@@###########@@@  @@####@.*.@@@@@ @@@@@@@^@@@@@@@@#",
        "###@@@@.*.@######@ @####@@@@@@@@####@   @####@.*.@###@^@#####@        @#",
        "######!.*.@######@@@#@@@@      @####@@@ @####@.*.@###@  @####@        @#",
        "######@.*. @!########@     ^   @######@ @###!..*.!###@@ @@###@@       @#",
        "@@@@@@@.**.. @@@@@@@@!         @!@@@@@@ @!@@..**.@####@  @####@@@@@@@@@#",
        "@      ..**..^..........^....................**^.@####@@ @@@@###########",
        "@@@@@@@@..************************************...@#####@           ^   @",
        "########@..................^...................@@@#####@@@@@@@@ @@@@@@@@",
        "##########@@@@!@@@@@@@@@@@@!@@@@@@@@@@@@@@@!@@@###############@ @#######"
      ],
      "terrain": {
        " ": [ [ "t_water_sh_underground", 1 ], [ "t_rock_floor", 10 ] ],
        ".": [ [ "t_water_sh_underground", 1 ], [ "t_rock_floor", 10 ] ],
        "@": [ [ "t_rock", 4 ], [ "t_rock_floor", 1 ] ],
        "#": "t_rock",
        "№": "t_fault",
        "*": "t_railroad_track_small",
        "!": "t_pillar",
        "Δ": "t_railroad_ramp_down_low",
        "Ʌ": "t_railroad_ramp_down_high",
        "Ŧ": "t_railroad_ramp_up_high",
        "±": "t_railroad_ramp_up_low"
      },
      "items": {
        ".": [
          {
            "item": {
              "subtype": "distribution",
              "entries": [
                { "item": "coal_lump", "prob": 20, "count": [ 1, 10 ] },
                { "item": "rock", "prob": 40, "count": [ 1, 10 ] },
                { "item": "rock_large", "prob": 10, "count": [ 1, 10 ] },
                { "item": "rock_flaking", "prob": 20, "count": [ 1, 10 ] },
                { "item": "material_shrd_limestone", "prob": 40, "count": [ 1, 10 ] },
                { "item": "material_limestone", "prob": 40, "count": [ 1, 10 ] },
                { "item": "material_niter", "prob": 5, "count": [ 1, 10 ] },
                { "item": "material_sand", "prob": 50, "charges": [ 10, 500 ] },
                { "item": "material_soil", "prob": 50, "charges": [ 10, 500 ] },
                { "item": "chunk_sulfur", "prob": 5, "count": [ 1, 10 ] },
                { "item": "material_rocksalt", "prob": 5, "count": [ 1, 10 ] },
                { "item": "material_rhodonite", "prob": 5, "count": [ 1, 10 ] },
                { "item": "material_zincite", "prob": 5, "count": [ 1, 10 ] }
              ]
            },
            "repeat": [ 1, 3 ],
            "chance": 1
          },
          { "item": "mine_equipment", "chance": 1 }
        ]
      },
      "traps": { "^": "tr_sinkhole" },
      "computers": { "5": { "name": "NEPowerOS", "options": [ { "name": "Read logs", "action": "amigara_log" } ] } }
    }
  },
  {
    "type": "mapgen",
    "method": "json",
    "om_terrain": [ [ "mine_amigara_finale_west", "mine_amigara_finale_central", "mine_amigara_finale_east" ] ],
    "object": {
      "fill_ter": "t_rock_floor",
      "rows": [
        "########################################################################",
        "########################################################################",
        "########################################################################",
        "################################@@@@@@@@@@@#############################",
        "################################@@       @@#############################",
        "################################@@   Ŧ   @@#############################",
        "################################@@   ±   !@#############################",
        "################################@!   &   @@@@###########################",
        "################################@@   &      @###########################",
        "################################@@   &    C !###########################",
        "################################@@   &    C @###########################",
        "################################@!   &      @###########################",
        "##################################   &   @@@@###########################",
        "##################################   &   ###############################",
        "###################################  $  ################################",
        "####################################   #################################",
        "##################################### ##################################",
        "##################################@@ # @@###############################",
        "#################################@@     @@##############################",
        "################################@@       @@#############################",
        "###############################@@    5    @@############################",
        "##############################@@           @@###########################",
        "###############################             ############################",
        "###############################*************############################"
      ],
      "terrain": {
        "@": [ [ "t_rock", 4 ], [ "t_rock_floor", 1 ] ],
        "#": "t_rock",
        "*": "t_fault",
        "&": "t_railroad_track_small",
        "!": "t_pillar",
        "$": "t_buffer_stop",
        "Ŧ": "t_railroad_ramp_up_high",
        "±": "t_railroad_ramp_up_low"
      },
      "furniture": { "C": "f_crate_c" },
      "items": { "C": { "item": "archeology_tools", "chance": 90, "repeat": [ 1, 2 ] } },
      "computers": {
        "5": {
          "name": "NEPowerOS",
          "security": 4,
          "options": [ { "name": "Activate Seismic Source", "action": "amigara_start" } ],
          "failures": [ { "action": "amigara" } ]
        }
      }
    }
  }
]
