[
  {
    "type": "mapgen",
    "om_terrain": "FEMA_re",
    "//": "right edge",
    "weight": 0,
    "method": "json",
    "object": {
      "fill_ter": "t_dirt",
      "rows": [
        "........................",
        "ffffffffffffffffffffffff",
        "........................",
        "........................",
        "........................",
        "........................",
        "........................",
        "........................",
        "........................",
        "........................",
        "........................",
        "........................",
        "........................",
        "........................",
        "........................",
        "........................",
        "........................",
        "........................",
        "........................",
        "........................",
        "........................",
        "........................",
        "........................",
        "........................"
      ],
      "rotation": 1,
      "palettes": [ "FEMA_camp" ]
    }
  }
]
