[
  {
    "type": "mapgen",
    "nested_mapgen_id": "fema_blc_03_roof",
    "//": "bottom left corner.",
    "method": "json",
    "object": {
      "mapgensize": [ 24, 24 ],
      "rows": [
        "                        ",
        "                        ",
        "                        ",
        "                        ",
        "    RRRRRRRRRRRRRRRRRR  ",
        "    RRRRRRRRRRRRRRRRRR  ",
        "    RRRRRRRRRRRRRRRRRR  ",
        "    RRRRRRRRRRRRRRRRRR  ",
        "    RRRRRRRRRRRRRRRRRR  ",
        "    RRRRRRRRRRRRRRRRRR  ",
        "    RRRRRRRRRRRRRRRRRR  ",
        "    RRRRRRRRRRRRRRRRRR  ",
        "    RRRRRRRRRRRRRRRRRR  ",
        "    RRRRRRRRRRRRRRRRRR  ",
        "    RRRRRRRRRRRRRRRRRR  ",
        "    RRRRRRRRRRRRRRRRRR  ",
        "    RRRRRRRRRRRRRRRRRR  ",
        "    RRRRRRRRRRRRRRRRRR  ",
        "    RRRRRRRRRRRRRRRRRR  ",
        "    RRRRRRRRRRRRRRRRRR  ",
        "    RRRRRRRRRRRRRRRRRR  ",
        "    RRRRRRRRRRRRRRRRRR  ",
        "                        ",
        "                        "
      ],
      "terrain": { "R": "t_canvas_roof" }
    }
  },
  {
    "type": "mapgen",
    "om_terrain": "FEMA_blc",
    "//": "bottom left corner.",
    "weight": 200,
    "method": "json",
    "object": {
      "fill_ter": "t_dirt",
      "rows": [
        "........................",
        ".fffffffffffffffffffffff",
        ".f......................",
        ".f......................",
        ".f..========**========..",
        ".f..=,,,,,,,,,,,,,,,,=..",
        ".f..=,,,,,,,,,,,,,c,,=..",
        ".f..=,,ffffffff,,TT,,=..",
        ".f..=,,f,,,,,,f,,TT,,=..",
        ".f..=,,f,,ll,,f,,,,,,=..",
        ".f..=,,f,,ll,,F,,,,,,=..",
        ".f..=,,f,,ll,,f,,,,,,=..",
        ".f..*,,f,,,,,,f,,,,,,*..",
        ".f..*,,ffffffff,,,,,,*..",
        ".f..=,,,,,,,c,,c,,,,,=..",
        ".f..=,,XX,,,,TTTT,,,,=..",
        ".f..=,,XX,,,,,,,,,,,,=..",
        ".f..=,,,,,,,,,,,,,,,,=..",
        ".f..=,,XX,XX,,XX,,XX,=..",
        ".f..=,,XX,XX,,XX,,XX,=..",
        ".f..=,,,,,,,,,,,,,,,,=..",
        ".f..========**========..",
        ".f......................",
        ".f......................"
      ],
      "rotation": 3,
      "palettes": [ "FEMA_camp" ],
      "items": { "X": { "item": "mil_surplus", "chance": 40 } },
      "place_nested": [ { "chunks": [ "fema_blc_03_roof" ], "x": 0, "y": 0, "z": 1 } ]
    }
  }
]
