[
  {
    "type": "mapgen",
    "nested_mapgen_id": "fema_entrance_03_roof",
    "//": "entrance. bottom edge",
    "method": "json",
    "object": {
      "mapgensize": [ 24, 24 ],
      "rows": [
        "                        ",
        "                        ",
        "                        ",
        "                        ",
        "         -------------- ",
        "         -............- ",
        "         -............- ",
        "         -............- ",
        "         -............- ",
        "         -............- ",
        "         -............- ",
        "         -............- ",
        "         -............- ",
        "         -............- ",
        "         -............- ",
        "         -............- ",
        "         -............- ",
        "         -------------- ",
        "                        ",
        "                        ",
        "                        ",
        "                        ",
        "                        ",
        "                        "
      ],
      "palettes": [ "roof_palette" ]
    }
  },
  {
    "type": "mapgen",
    "om_terrain": "FEMA_entrance",
    "//": "entrance. bottom edge",
    "weight": 250,
    "method": "json",
    "object": {
      "fill_ter": "t_floor",
      "rows": [
        "........................",
        "ff.....z.fffffffffffffff",
        ".f.......f..............",
        ".f.......f..............",
        ".f..z....--gg-----gg---.",
        ".f.......|~~~~TT~~~DDD|.",
        ".f.......gD~~~TT~~~~c~|.",
        ".f.......gDc~~~~~ZZ~~~|.",
        ".f.......|~~~~~~~~~~~6|.",
        ".fffFFfff|-----++-----|.",
        ".f.......|D~~~~~~~~~XX|z",
        ".f.......gDc~Z~~Z~~~XX|.",
        ".f.......|D~~~~~~~~~~~|.",
        ".f.......+~~~~~~~~AAAA|.",
        ".fffFFfff|-----++-----|.",
        ".........|s~&|~~~~|s~&|.",
        ".........|~~~|llll|~~~|.",
        ".........--+--------+--.",
        "........................",
        "........................",
        "........................",
        "........................",
        ".z....................z.",
        "........................"
      ],
      "rotation": 2,
      "palettes": [ "FEMA_camp" ],
      "terrain": { "z": "t_dirt" },
      "items": { "X": { "item": "mil_surplus", "chance": 60 } },
      "monster": { "Z": { "monster": "mon_zombie_soldier" }, "z": { "monster": "mon_zombie_soldier" } },
      "place_nested": [ { "chunks": [ "fema_entrance_03_roof" ], "x": 0, "y": 0, "z": 1 } ]
    }
  }
]
