[
  {
    "type": "mapgen",
    "method": "json",
    "om_terrain": [ "mi-go_camp1", "mi-go_camp2" ],
    "weight": 100,
    "object": {
      "fill_ter": "t_resin_floor",
      "rows": [
        ".......##.....##.....##.........................",
        ".....######.######.######.......................",
        ".##### {  ###{   ###    ##......................",
        "##  +      ###    +    V #..........##..........",
        "#{  #      + ######     V#........######........",
        "##  #      #   {  #   { V#......### V  ###......",
        ".#  ##    ###    ###    ##....###        ###....",
        ".# ######## ###### #+######.###            ##...",
        ".#+######     ##          ###            {  #...",
        "##    ##   {   #  {    V    ##   {          ##..",
        "#{   V #       #      i      #               #..",
        "#   ViV#  iVi ##     V iV    #               #..",
        "#      +     ###      i      +              ##..",
        "##    ##   #+# ###     {    ##              #...",
        ".######## ##     ###      ###               #...",
        "...########   {    ######## +      {       ##...",
        "....##    ##      ##    ##  ###          ###....",
        ".####      +      #   {  #    ########VV##......",
        "##  #   {  #+##   +      #   ##......####.......",
        "#{  +      #  #####      #####..................",
        "#   ##    ##      ##ViiV##......................",
        "##   ####+###    ########.......................",
        ".###+#.##   ######...##.........................",
        "........###+#.##................................"
      ],
      "terrain": { " ": "t_resin_floor", "#": "t_resin_wall", "+": "t_resin_hole_c" },
      "furniture": {
        "i": "f_alien_tendril",
        "V": "f_alien_anemone",
        "{": "f_alien_gasper"
      }
    }
  }
]
