[
  {
    "type": "mapgen",
    "method": "json",
    "om_terrain": [ "mi-go_camp" ],
    "weight": 100,
    "object": {
      "fill_ter": "t_resin_floor",
      "rows": [
        ".......##.....##.....##.........................",
        ".....######.######.######.......................",
        ".#####    ###    ###    ##......................",
        "##  +      ###    +      #..........##..........",
        "#   #      + ######      #........######........",
        "##  #      #      #      #......###    ###......",
        ".#  ##    ###    ###    ##....###        ###....",
        ".# ######## ###### #+######.###            ##...",
        ".#+######     ##          ###               #...",
        "##    ##       #            ##              ##..",
        "#      #       #             #               #..",
        "#      #      ##             #               #..",
        "#      +     ###             +              ##..",
        "##    ##   #+# ###          ##              #...",
        ".######## ##     ###      ###               #...",
        "...########        ######## +              ##...",
        "....##    ##      ##    ##  ###          ###....",
        ".####      +      #      #    ########  ##......",
        "##  #      #+##   +      #   ##......####.......",
        "#   +      #  #####      #####..................",
        "#   ##    ##      ##    ##......................",
        "##   ####+###    ########.......................",
        ".###+#.##   ######...##.........................",
        "........###+#.##................................"
      ],
      "terrain": {
        " ": "t_resin_floor",
        "#": "t_resin_wall",
        "+": "t_resin_hole_c"
      }
    }
  }
]
