[
  {
    "type": "mapgen",
    "om_terrain": [ "field", "isherwood_barry_rescue_field" ],
    "object": {
      "fill_ter": "t_hard_vacuum",
      "place_nested": [
        { "chunks": [ "24x24_wall_h_lighthouse" ], "x": 0, "y": 0, "flags": { "north": [ "SIDEWALK", "ROAD" ] } },
        { "chunks": [ "24x24_wall_h_lighthouse" ], "x": 0, "y": 22, "flags": { "south": [ "SIDEWALK", "ROAD" ] } },
        { "chunks": [ "24x24_wall_v_lighthouse" ], "x": 0, "y": 0, "flags": { "west": [ "SIDEWALK", "ROAD" ] } },
        { "chunks": [ "24x24_wall_v_lighthouse" ], "x": 22, "y": 0, "flags": { "east": [ "SIDEWALK", "ROAD" ] } },
        { "chunks": [ "2x2_corner_lighthouse" ], "x": 0, "y": 0, "flags": { "north_west": [ "SIDEWALK", "ROAD" ] } },
        { "chunks": [ "2x2_corner_lighthouse" ], "x": 22, "y": 0, "flags": { "north_east": [ "SIDEWALK", "ROAD" ] } },
        { "chunks": [ "2x2_corner_lighthouse" ], "x": 0, "y": 22, "flags": { "south_west": [ "SIDEWALK", "ROAD" ] } },
        { "chunks": [ "2x2_corner_lighthouse" ], "x": 22, "y": 22, "flags": { "south_east": [ "SIDEWALK", "ROAD" ] } }
      ]
    }
  },
  {
    "type": "mapgen",
    "nested_mapgen_id": "24x24_wall_v_lighthouse",
    "object": {
      "mapgensize": [ 24, 24 ],
      "rotation": [ 0, 3 ],
      "rows": [
        "##                      ",
        "##                      ",
        "##                      ",
        "##                      ",
        "##                      ",
        "##                      ",
        "##                      ",
        "##                      ",
        "##                      ",
        "##                      ",
        "##                      ",
        "##                      ",
        "##                      ",
        "##                      ",
        "##                      ",
        "##                      ",
        "##                      ",
        "##                      ",
        "##                      ",
        "##                      ",
        "##                      ",
        "##                      ",
        "##                      ",
        "##                      "
      ],
      "palettes": [ "road_palette" ],
      "flags": [ "ERASE_ALL_BEFORE_PLACING_TERRAIN" ]
    }
  },
  {
    "type": "mapgen",
    "nested_mapgen_id": "24x24_wall_h_lighthouse",
    "object": {
      "mapgensize": [ 24, 24 ],
      "rotation": [ 0, 3 ],
      "rows": [
        "########################",
        "########################",
        "                        ",
        "                        ",
        "                        ",
        "                        ",
        "                        ",
        "                        ",
        "                        ",
        "                        ",
        "                        ",
        "                        ",
        "                        ",
        "                        ",
        "                        ",
        "                        ",
        "                        ",
        "                        ",
        "                        ",
        "                        ",
        "                        ",
        "                        ",
        "                        ",
        "                        "
      ],
      "palettes": [ "road_palette" ],
      "flags": [ "ERASE_ALL_BEFORE_PLACING_TERRAIN" ]
    }
  },
  {
    "type": "mapgen",
    "nested_mapgen_id": "2x2_corner_lighthouse",
    "object": {
      "mapgensize": [ 2, 2 ],
      "rows": [
        "##",
        "##"
      ],
      "palettes": [ "road_palette" ],
      "flags": [ "ERASE_ALL_BEFORE_PLACING_TERRAIN" ]
    }
  },
  {
    "type": "terrain",
    "id": "t_hard_vacuum",
    "name": "hard vacuum",
    "symbol": " ",
    "color": "black",
    "description": "The cold inhospitable vacuum of space.  Going this way without an EVA pack will end in either a slow cold death as your life support fades or a slow hot death as you drop into the planet's atmosphere.",
    "move_cost": 1000,
    "light_emitted": 420,
    "flags": [ "DESTROY_ITEM" ]
  }
]
