[
  {
    "type": "palette",
    "id": "tomb",
    "terrain": {
      ".": "t_rock_floor",
      " ": [ [ "t_region_groundcover_forest", 15 ], [ "t_grass_dead", 1 ] ],
      "-": "t_dirt",
      "_": [ [ "t_region_groundcover_forest", 1 ], [ "t_dirt", 1 ] ],
      "T": "t_tree_dead",
      "R": "t_railroad_rubble",
      "S": "t_shrub",
      "<": "t_slope_up",
      ">": "t_slope_down",
      "#": "t_rock",
      "D": [ [ "t_door_stone_c", 20 ], [ "t_door_stone_o", 1 ] ]
    },
    "furniture": { "H": "f_altar", "C": "f_coffin_c", "¢": "f_coffin_c" },
    "items": {
      "H": { "item": "xedrawood_forest_tomb_artifact_wield", "chance": 100 },
      "¢": { "item": "xedrawood_forest_tomb_artifact_worn", "chance": 33 }
    },
    "monster": { "x": { "monster": "mon_skeleton_animated", "chance": 50 }, "Z": { "monster": "mon_darkman", "chance": 100 } }
  },
  {
    "type": "palette",
    "id": "tomb_roof",
    "terrain": { ".": "t_rock_roof", " ": "t_open_air", ">": "t_slope_down" }
  },
  {
    "type": "mapgen",
    "om_terrain": [ "forest_tomb" ],
    "//": "Ground level - Z-0.",
    "object": {
      "fill_ter": "t_rock_floor",
      "rows": [
        "                  S     ",
        "            S           ",
        " _______S______________ ",
        " _-S------------S-----_ ",
        " _-##<###############-_ ",
        " _-####C..x###C..C###-_ ",
        " _-#####.#######.####-_ ",
        " _-#####.#######.####-_ ",
        " S-####C.##>>##..C###-_ ",
        " _-###x..........###<S_ ",
        " _-###...##..##..C###-_ ",
        " _-###.####..########-_ ",
        " _-###..###..x..#####-_ ",
        " _-###..C##..#...R###-S ",
        " _S########..########-_ ",
        " _-########..########-_ ",
        " _-########..########-_ ",
        " _-########DD###<####-_ ",
        " _--------TRRT-----S--_ ",
        " ____S_____RR__________ ",
        "          TRRT       S  ",
        "      S    RR           ",
        "          TRRT          ",
        "            R    S      "
      ],
      "palettes": [ "tomb" ]
    }
  },
  {
    "type": "mapgen",
    "om_terrain": [ "forest_tomb_bottom" ],
    "//": "Underground level - Z -1.",
    "object": {
      "fill_ter": "t_rock_floor",
      "rows": [
        "########################",
        "##¢..C##################",
        "##..x..#################",
        "##Cx...#################",
        "######.#################",
        "######.R################",
        "######.####.......######",
        "######.####..###.x######",
        "#####C..C##<<##R.C######",
        "#######.###..######C####",
        "###......x..###....x####",
        "###.#######..##.###.####",
        "###.###.........###.####",
        "###D###C###########.####",
        "#.....#####x.###....####",
        "#.x.x.#####......#######",
        "#..¢..#####D############",
        "#.x.x.##C......C########",
        "#.....###.x..x...#######",
        "########...HZ...########",
        "########¢......C########",
        "########################",
        "########################",
        "########################"
      ],
      "palettes": [ "tomb" ]
    }
  },
  {
    "type": "mapgen",
    "om_terrain": [ "forest_tomb_roof" ],
    "//": "Roof level - Z +1.",
    "object": {
      "rows": [
        "                        ",
        "                        ",
        "                        ",
        "                        ",
        "   ..>...............   ",
        "   ..................   ",
        "   ..................   ",
        "   ..................   ",
        "   ..................   ",
        "   .................>   ",
        "   ..................   ",
        "   ..................   ",
        "   ..................   ",
        "   ..................   ",
        "   ..................   ",
        "   ..................   ",
        "   ..................   ",
        "   .............>....   ",
        "                        ",
        "                        ",
        "                        ",
        "                        ",
        "                        ",
        "                        "
      ],
      "palettes": [ "tomb_roof" ]
    }
  }
]
