[
  {
    "om_terrain": [ "hab_unit", "shop_unit", "park_unit" ],
    "type": "mapgen",
    "object": {
      "fill_ter": "t_floor",
      "rows": [
        "_##########++##########_",
        "_#____________________#_",
        "_#____________________#_",
        "_#____________________#_",
        "_#____________________#_",
        "_#____________________#_",
        "_#____________________#_",
        "_#____________________#_",
        "_#____________________#_",
        "_#____________________#_",
        "_#____________________#_",
        "_#____________________#_",
        "_#____________________#_",
        "_#____________________#_",
        "_#____________________#_",
        "_#____________________#_",
        "_#____________________#_",
        "_#____________________#_",
        "_#____________________#_",
        "_#____________________#_",
        "_#____________________#_",
        "_#____________________#_",
        "_######################_",
        "________________________"
      ],
      "terrain": { "#": "t_concrete_wall", "_": "t_sidewalk", "+": "t_sidewalk" }
    }
  },
  {
    "type": "city_building",
    "id": "hab_unit_building",
    "locations": [ "space" ],
    "overmaps": [ { "point": [ 0, 0, 0 ], "overmap": "hab_unit_north" } ],
    "flags": [ "LIGHTHOUSE" ]
  },
  {
    "type": "overmap_terrain",
    "id": "hab_unit",
    "name": "hab unit",
    "sym": "^",
    "color": "light_green",
    "vision_levels": "city_building",
    "travel_cost_type": "structure",
    "see_cost": "high",
    "flags": [ "RISK_HIGH", "GENERIC_LOOT", "SIDEWALK" ]
  }
]
