[
  {
    "type": "mapgen",
    "method": "json",
    "om_terrain": [ "basement_bionic_decoy" ],
    "object": {
      "fill_ter": "t_thconc_floor",
      "rows": [
        "                        ",
        "           ############ ",
        "           #...jjj....# ",
        "           #..........# ",
        "           #..~~~~~~..# ",
        " ###########..~~~~~~..# ",
        " #9#9#9#CC#!..~~~~~~..# ",
        " #+#+#+#..#!..~~~~~~..# ",
        " #........+...........# ",
        " #CCtCtCtC#!!...jjj...# ",
        " #############+######## ",
        " #bbbb#RRRRRR#...rrccr# ",
        " #....#H....R#ff......# ",
        " #jj..#H.s..R#...ccccc# ",
        " #....#E....R#........# ",
        " #c.u.............H..s# ",
        " #................H..s# ",
        " #X.Â.............H..s# ",
        " #...............###### ",
        " #.....#+##++#...#t..S# ",
        " #.....#.w#..#...+...C# ",
        " #.}...#.â#.<#...#.CC9# ",
        " ###################### ",
        "                        "
      ],
      "palettes": [ "domestic_general_and_variant_palette", "standard_and_variant_domestic_basement_palette" ],
      "terrain": { "~": "t_water_pool" },
      "furniture": { "}": "f_pinball_machine" },
      "place_loot": [
        { "group": "alcohol", "x": [ 14, 15 ], "y": 12, "chance": 96, "repeat": [ 1, 2 ] },
        { "group": "fridgesnacks", "x": [ 14, 15 ], "y": 12, "chance": 80, "repeat": [ 1, 2 ] },
        { "group": "homebooks", "x": [ 7, 12 ], "y": 11, "chance": 70, "repeat": [ 1, 2 ] },
        { "group": "homebooks", "x": 12, "y": [ 12, 14 ], "chance": 70, "repeat": [ 1, 2 ] },
        { "group": "magazines", "x": 21, "y": [ 15, 17 ], "chance": 30 },
        { "group": "magazines", "x": 9, "y": 12, "chance": 30 },
        { "group": "snacks", "x": [ 16, 21 ], "y": 11, "chance": 40, "repeat": [ 1, 2 ] },
        { "group": "snacks", "x": [ 16, 21 ], "y": 13, "chance": 40, "repeat": [ 1, 2 ] },
        { "group": "softdrugs", "x": 21, "y": 20, "chance": 75, "repeat": [ 1, 2 ] },
        { "group": "cleaning", "x": 11, "y": 6, "chance": 70, "repeat": [ 1, 2 ] },
        { "group": "swimmer_set_any", "x": 11, "y": 7, "chance": 75, "repeat": [ 1, 4 ] },
        { "group": "cleaning", "x": [ 11, 12 ], "y": 9, "chance": 70, "repeat": [ 1, 2 ] },
        { "item": "television", "x": 21, "y": 16, "chance": 95 },
        { "item": "soap", "x": 19, "y": 21, "chance": 80 },
        { "item": "towel", "x": 20, "y": 21, "chance": 80 },
        { "item": "towel", "x": 3, "y": 13, "chance": 60 },
        { "item": "stereo", "x": 2, "y": 13, "chance": 50 }
      ],
      "place_monsters": [ { "monster": "GROUP_ZOMBIE", "x": [ 5, 17 ], "y": [ 9, 11 ], "chance": 2 } ]
    }
  }
]
