[
  {
    "type": "mapgen",
    "method": "json",
    "om_terrain": [ "basement_meth" ],
    "//": "linked to house_27.",
    "weight": 20,
    "object": {
      "fill_ter": "t_soil",
      "rows": [
        "                        ",
        "                        ",
        "                        ",
        "                        ",
        "       ##############   ",
        "       #D.ÖÖ+D|qq~~Z#   ",
        "       ###ÖÖ+D|~~~~W#   ",
        "       ###ÖÖ|||+||||####",
        "       #D...+....ÖÖÖÖÖÖ#",
        "       #||+||....ÖÖÖÖÖÖ#",
        "       #t~~C|....ÖÖÖÖÖÖ#",
        "       #~~~~+..||||||||#",
        "       #988S|..C+~~9|vs#",
        "       ######..C|!~~|~h#",
        "            #..<|||+|+|#",
        "            #...||b~~~0#",
        "            #..|||b~~~0#",
        "            #..C||A~~~5#",
        "            #+||||f~~~O#",
        "            #~~a||0~~~0#",
        "            #q~g||qqqq0#",
        "            ############",
        "                        ",
        "                        "
      ],
      "palettes": [
        "parametrized_linoleum_palette",
        "standard_domestic_lino_bathroom",
        "domestic_general_and_variant_palette",
        "standard_domestic_basement_palette"
      ],
      "terrain": {
        "a": { "param": "linoleum_color_bathroom", "fallback": "t_linoleum_gray" },
        "g": { "param": "linoleum_color_bathroom", "fallback": "t_linoleum_gray" },
        "5": { "param": "linoleum_color", "fallback": "t_linoleum_gray" },
        "0": { "param": "linoleum_color", "fallback": "t_linoleum_gray" },
        "!": { "param": "linoleum_color", "fallback": "t_linoleum_gray" },
        "A": { "param": "linoleum_color", "fallback": "t_linoleum_gray" },
        "b": { "param": "linoleum_color", "fallback": "t_linoleum_gray" },
        "s": { "param": "linoleum_color", "fallback": "t_linoleum_gray" },
        "h": { "param": "linoleum_color", "fallback": "t_linoleum_gray" }
      },
      "furniture": { "a": "f_home_furnace", "0": "f_lab_bench", "A": "f_air_filter", "b": "f_standing_tank" },
      "place_loot": [
        { "group": "meth_ingredients", "x": [ 18, 21 ], "y": 20, "repeat": [ 10, 20 ] },
        { "group": "hazmat_suits", "x": 17, "y": 13 },
        { "group": "hazmat_masks", "x": 17, "y": 13 },
        { "group": "exotic_books", "x": 15, "y": 17 },
        { "group": "methlab", "x": 22, "y": [ 15, 16 ], "chance": 75, "repeat": [ 1, 3 ] },
        { "group": "methlab", "x": 22, "y": [ 19, 20 ], "chance": 75, "repeat": [ 1, 3 ] },
        { "group": "guns_shotgun_common", "x": 22, "y": 12 },
        { "group": "ammo_common_boxed_used", "x": 22, "y": 12, "repeat": [ 7, 30 ] },
        { "group": "home_hw", "x": 13, "y": 20, "chance": 40, "repeat": [ 1, 3 ] },
        { "group": "home_hw", "x": [ 21, 22 ], "y": 5, "chance": 40, "repeat": [ 1, 3 ] },
        { "group": "religious_books", "x": 15, "y": 17 },
        { "group": "magazines", "x": 15, "y": [ 12, 13 ], "repeat": [ 3, 5 ] },
        { "group": "bed", "x": [ 8, 9 ], "y": [ 6, 7 ], "chance": 90, "repeat": [ 1, 3 ] },
        { "group": "dresser", "x": 8, "y": 5, "chance": 85, "repeat": [ 2, 5 ] },
        { "group": "costume_all", "x": 8, "y": 5, "chance": 15, "repeat": [ 2, 5 ] },
        { "group": "dresser", "x": 8, "y": 8, "chance": 85, "repeat": [ 2, 5 ] },
        { "group": "costume_all", "x": 8, "y": 8, "chance": 15, "repeat": [ 2, 5 ] },
        { "group": "dresser", "x": 13, "y": [ 5, 6 ], "chance": 85, "repeat": [ 2, 5 ] },
        { "group": "costume_all", "x": 13, "y": [ 5, 6 ], "chance": 15, "repeat": [ 2, 5 ] },
        { "group": "laundry", "x": 19, "y": 5, "chance": 50, "repeat": [ 1, 10 ] },
        { "group": "laundry", "x": 19, "y": 6, "chance": 50, "repeat": [ 1, 10 ] },
        { "group": "softdrugs", "x": [ 9, 10 ], "y": 12, "chance": 75, "repeat": [ 1, 3 ] },
        { "group": "cleaning", "x": 11, "y": 10, "chance": 90, "repeat": [ 1, 3 ] },
        { "group": "cleaning", "x": 16, "y": 5, "chance": 90, "repeat": [ 1, 3 ] }
      ],
      "place_item": [
        { "x": 18, "y": 19, "item": "meth" },
        { "x": 21, "y": 12, "item": "meth", "amount": [ 5, 20 ] },
        { "x": 15, "y": [ 12, 13 ], "item": "meth", "chance": 90 },
        { "x": 21, "y": 12, "item": "money_strap_twenty", "amount": [ 3, 9 ] },
        { "x": 15, "y": 5, "item": "corpse" },
        { "x": 18, "y": 19, "item": "chemistry_set" },
        { "x": 11, "y": 10, "item": "towel" },
        { "x": 16, "y": 5, "item": "bleach" },
        { "x": 16, "y": 5, "item": "knife_small", "variant": "knife_steak" }
      ],
      "place_monster": [
        { "monster": "mon_zombie_hazmat", "x": [ 19, 21 ], "y": [ 15, 20 ], "chance": 50 },
        { "monster": "mon_zombie_hazmat", "x": [ 13, 14 ], "y": [ 11, 16 ], "chance": 50 },
        { "monster": "mon_zombie_rot", "x": 15, "y": 6, "chance": 30 },
        { "monster": "mon_zombie", "x": [ 13, 14 ], "y": [ 11, 17 ], "chance": 90, "repeat": [ 1, 3 ] }
      ],
      "place_fields": [
        { "x": [ 15, 16 ], "y": [ 5, 6 ], "field": "fd_blood", "intensity": 3 },
        { "x": [ 15, 16 ], "y": [ 5, 6 ], "field": "fd_blood", "intensity": 2 },
        { "x": [ 14, 19 ], "y": [ 12, 13 ], "field": "fd_toxic_gas", "intensity": 3 },
        { "x": [ 14, 19 ], "y": [ 12, 13 ], "field": "fd_toxic_gas", "intensity": 3 },
        { "x": [ 14, 16 ], "y": [ 12, 13 ], "field": "fd_toxic_gas", "intensity": 3 },
        { "x": [ 14, 16 ], "y": [ 12, 13 ], "field": "fd_toxic_gas", "intensity": 3 },
        { "x": [ 14, 16 ], "y": [ 12, 13 ], "field": "fd_toxic_gas", "intensity": 3 }
      ]
    }
  },
  {
    "type": "mapgen",
    "method": "json",
    "om_terrain": [ "basement_meth" ],
    "//": "linked to house_27.",
    "weight": 250,
    "object": {
      "fill_ter": "t_soil",
      "rows": [
        "                        ",
        "                        ",
        "                        ",
        "                        ",
        "       #################",
        "       #DÖÖÖ+D|qq~~Z|qq#",
        "       ###ÖÖ+D|~~~~W|..#",
        "       ###ÖÖ|||+|||||+|#",
        "       #D...+...ÖÖÖÖÖÖÖ#",
        "       #||+||...ÖÖÖÖÖÖÖ#",
        "       #t...|...ÖÖÖÖÖÖÖ#",
        "       #....+..|########",
        "       #988S|..R#       ",
        "       ######..R#       ",
        "            #..<#       ",
        "            #...#       ",
        "            #..##       ",
        "            #..R#       ",
        "            #+||#       ",
        "            #~~a#       ",
        "            #q~w#       ",
        "            #####       ",
        "                        ",
        "                        "
      ],
      "palettes": [ "parametrized_linoleum_palette", "domestic_general_and_variant_palette", "standard_domestic_basement_palette" ],
      "furniture": { "a": "f_home_furnace" },
      "place_loot": [
        { "group": "religious_books", "x": 15, "y": 17 },
        { "group": "magazines", "x": 15, "y": [ 12, 13 ], "repeat": [ 3, 5 ] },
        { "group": "bed", "x": [ 8, 9 ], "y": [ 6, 7 ], "chance": 90, "repeat": [ 1, 3 ] },
        { "group": "dresser", "x": 8, "y": 5, "chance": 85, "repeat": [ 2, 5 ] },
        { "group": "costume_all", "x": 8, "y": 5, "chance": 15, "repeat": [ 2, 5 ] },
        { "group": "dresser", "x": 8, "y": 8, "chance": 85, "repeat": [ 2, 5 ] },
        { "group": "costume_all", "x": 8, "y": 8, "chance": 15, "repeat": [ 2, 5 ] },
        { "group": "dresser", "x": 13, "y": [ 5, 6 ], "chance": 85, "repeat": [ 2, 5 ] },
        { "group": "costume_all", "x": 13, "y": [ 5, 6 ], "chance": 15, "repeat": [ 2, 5 ] },
        { "group": "laundry", "x": 19, "y": 5, "chance": 50, "repeat": [ 1, 10 ] },
        { "group": "laundry", "x": 19, "y": 6, "chance": 50, "repeat": [ 1, 10 ] },
        { "group": "softdrugs", "x": [ 9, 10 ], "y": 12, "chance": 75, "repeat": [ 1, 3 ] },
        { "group": "softdrugs", "x": 3, "y": 16, "chance": 75, "repeat": [ 1, 3 ] },
        { "group": "cleaning", "x": 11, "y": 10, "chance": 90, "repeat": [ 1, 3 ] },
        { "group": "cleaning", "x": [ 15, 16 ], "y": 5, "chance": 90, "repeat": [ 1, 3 ] },
        { "group": "home_hw", "x": 13, "y": 20, "chance": 40, "repeat": [ 1, 3 ] },
        { "group": "home_hw", "x": [ 21, 22 ], "y": 5, "chance": 40, "repeat": [ 1, 3 ] }
      ],
      "place_item": [ { "x": 11, "y": 10, "item": "towel" } ],
      "place_monster": [ { "monster": "mon_zombie", "x": [ 13, 14 ], "y": [ 11, 17 ], "chance": 90, "repeat": [ 1, 3 ] } ]
    }
  },
  {
    "type": "mapgen",
    "method": "json",
    "om_terrain": [ "basement_meth" ],
    "//": "linked to house_27.",
    "weight": 250,
    "object": {
      "fill_ter": "t_soil",
      "rows": [
        "                        ",
        "                        ",
        "                        ",
        "                        ",
        "       #################",
        "       #DÖÖÖ+D|qq~~Z|qq#",
        "       ###ÖÖ+D|~~~~W|..#",
        "       ###ÖÖ|||+|||||+|#",
        "       #D...+...ÖÖÖÖÖÖÖ#",
        "       #||+||...ÖÖÖÖÖÖÖ#",
        "       #t...|...ÖÖÖÖÖÖÖ#",
        "       #....+..|||||||##",
        "       #988S|........q# ",
        "       ######........q# ",
        "            #..<|....s# ",
        "            #...|....s# ",
        "            #..||ÖÖ.qR# ",
        "            #..R####### ",
        "            #+||#       ",
        "            #~~a#       ",
        "            #q~w#       ",
        "            #####       ",
        "                        ",
        "                        "
      ],
      "palettes": [ "parametrized_linoleum_palette", "domestic_general_and_variant_palette", "standard_domestic_basement_palette" ],
      "place_loot": [
        { "group": "religious_books", "x": 15, "y": 17 },
        { "group": "bed", "x": [ 8, 9 ], "y": [ 6, 7 ], "chance": 90, "repeat": [ 1, 3 ] },
        { "group": "dresser", "x": 8, "y": 5, "chance": 85, "repeat": [ 2, 5 ] },
        { "group": "costume_all", "x": 8, "y": 5, "chance": 15, "repeat": [ 2, 5 ] },
        { "group": "dresser", "x": 8, "y": 8, "chance": 85, "repeat": [ 2, 5 ] },
        { "group": "costume_all", "x": 8, "y": 8, "chance": 15, "repeat": [ 2, 5 ] },
        { "group": "dresser", "x": 13, "y": [ 5, 6 ], "chance": 85, "repeat": [ 2, 5 ] },
        { "group": "costume_all", "x": 13, "y": [ 5, 6 ], "chance": 15, "repeat": [ 2, 5 ] },
        { "group": "laundry", "x": 19, "y": 5, "chance": 50, "repeat": [ 1, 10 ] },
        { "group": "laundry", "x": 19, "y": 6, "chance": 50, "repeat": [ 1, 10 ] },
        { "group": "softdrugs", "x": [ 9, 10 ], "y": 12, "chance": 75, "repeat": [ 1, 3 ] },
        { "group": "softdrugs", "x": 3, "y": 16, "chance": 75, "repeat": [ 1, 3 ] },
        { "group": "cleaning", "x": 11, "y": 10, "chance": 90, "repeat": [ 1, 3 ] },
        { "group": "cleaning", "x": [ 17, 18 ], "y": 16, "chance": 90 },
        { "group": "cleaning", "x": [ 15, 16 ], "y": 5, "chance": 90, "repeat": [ 1, 3 ] },
        { "group": "home_hw", "x": 13, "y": 20, "chance": 40, "repeat": [ 1, 3 ] },
        { "group": "home_hw", "x": 21, "y": [ 12, 13 ], "chance": 40, "repeat": [ 1, 3 ] },
        { "group": "home_hw", "x": [ 21, 22 ], "y": 5, "chance": 40, "repeat": [ 1, 3 ] },
        { "group": "guns_shotgun_common", "x": 21, "y": 14, "chance": 10 }
      ],
      "place_item": [ { "x": 11, "y": 10, "item": "towel" }, { "x": 21, "y": 14, "item": "wrench" } ],
      "place_monster": [ { "monster": "mon_zombie", "x": [ 13, 14 ], "y": [ 11, 17 ], "chance": 90, "repeat": [ 1, 3 ] } ]
    }
  }
]
