[
  {
    "id": "weed_farm",
    "type": "item_group",
    "items": [
      { "item": "weed", "prob": 70, "count": [ 0, 20 ] },
      { "item": "seed_weed", "prob": 60, "count": 2 },
      { "item": "cannabis", "prob": 50 },
      { "item": "withered", "prob": 70 }
    ]
  },
  {
    "type": "mapgen",
    "method": "json",
    "nested_mapgen_id": "cannabis_extraction_equipment_nested_1x1",
    "object": {
      "mapgensize": [ 1, 1 ],
      "rotation": [ 0, 3 ],
      "place_items": [
        {
          "item": { "subtype": "distribution", "entries": [ { "group": "cannabis_extraction_equipment", "prob": 100 } ] },
          "x": 0,
          "y": 0,
          "chance": 10
        }
      ]
    }
  },
  {
    "type": "mapgen",
    "method": "json",
    "om_terrain": [ "basement_weed" ],
    "//": "matches house_28",
    "object": {
      "fill_ter": "t_soil",
      "rows": [
        "                        ",
        "                        ",
        "       |||||||||        ",
        "       |R__Gccc|        ",
        "       |R____hc|        ",
        "       |R_____R|        ",
        "   ||||||||+||||||||    ",
        "   |QQQQQQ,,,QQQQQQ|    ",
        "   |T,,,,,,,,,,,,,T|    ",
        "   |QQQQQQT,TQQQQQQ|    ",
        "   |A,,,,,,,,,,,,,A|    ",
        "   |QQQQQQ,,,QQQQQQ|    ",
        "   ||||||||++|||||||    ",
        "   |C_____+__XXX|       ",
        "   |C_U|WH|__XXX|       ",
        "   ||||||||__||||       ",
        "          |++|          ",
        "          |..|          ",
        "          |.<|          ",
        "          ||||          ",
        "                        ",
        "                        ",
        "                        ",
        "                        "
      ],
      "palettes": [ "parametrized_linoleum_palette" ],
      "terrain": {
        "|": "t_wall",
        "<": "t_stairs_up",
        "+": "t_door_c",
        ".": "t_floor",
        "_": { "param": "linoleum_color", "fallback": "t_linoleum_gray" },
        "C": { "param": "linoleum_color", "fallback": "t_linoleum_gray" },
        "X": { "param": "linoleum_color", "fallback": "t_linoleum_gray" },
        "W": { "param": "linoleum_color", "fallback": "t_linoleum_gray" },
        "G": { "param": "linoleum_color", "fallback": "t_linoleum_gray" },
        "R": { "param": "linoleum_color", "fallback": "t_linoleum_gray" },
        "H": { "param": "linoleum_color", "fallback": "t_linoleum_gray" },
        "c": { "param": "linoleum_color", "fallback": "t_linoleum_gray" },
        "h": { "param": "linoleum_color", "fallback": "t_linoleum_gray" },
        "U": { "param": "linoleum_color", "fallback": "t_linoleum_gray" },
        ",": { "param": "linoleum_color", "fallback": "t_linoleum_white" },
        "A": { "param": "linoleum_color", "fallback": "t_linoleum_white" },
        "Q": { "param": "linoleum_color", "fallback": "t_linoleum_white" },
        "T": { "param": "linoleum_color", "fallback": "t_linoleum_white" }
      },
      "liquids": { "H": { "liquid": "water_clean", "amount": [ 0, 100 ] } },
      "sealed_item": { "Q": { "item": { "item": "seed_weed" }, "furniture": "f_planter_mature" } },
      "furniture": {
        "T": "f_workbench",
        "G": "f_glass_cabinet",
        "c": "f_table",
        "h": "f_chair",
        "R": "f_rack",
        "A": "f_air_filter",
        "C": "f_air_conditioner",
        "H": [ "f_water_heater", "f_water_heater_family" ],
        "W": [ "f_water_purifier", "f_home_furnace" ],
        "X": [ "f_crate_c", "f_crate_o", "f_cardboard_box" ],
        "U": "f_utility_shelf"
      },
      "items": {
        "T": [ { "item": "supplies_farming", "chance": 70 }, { "item": "weed_farm", "chance": 50 } ],
        "R": [ { "item": "weed_farm", "chance": 70 } ],
        "c": [
          { "item": "stoner", "chance": 70 },
          { "item": "office_breakroom", "chance": 30 },
          { "item": "homeguns", "chance": 5 }
        ],
        "G": [ { "item": "SUS_office_desk", "chance": 40 }, { "item": "dollar_books", "chance": 40 } ],
        "U": [ { "item": "home_hw", "chance": 50 } ],
        "X": [
          { "item": "supplies_farming", "chance": 50 },
          { "item": "cleaning", "chance": 50 },
          { "item": "chem_home", "chance": 50 }
        ]
      },
      "place_nested": [ { "chunks": [ "cannabis_extraction_equipment_nested_1x1" ], "x": 6, "y": 14 } ],
      "place_monsters": [ { "monster": "GROUP_ZOMBIE", "x": [ 6, 23 ], "y": [ 6, 12 ] } ]
    }
  }
]
